"";"Data";"0";"1";"3";"4";"5";"sum"
"1";"360050001001";0;0;0;0;1;1
"2";"360050002001";32;19;100;40;25;216
"3";"360050002002";58;23;86;66;21;254
"4";"360050002003";34;4;11;37;12;98
"5";"360050004001";5;12;54;39;14;124
"6";"360050004002";24;13;103;45;23;208
"7";"360050004003";37;88;23;5;13;166
"8";"360050004004";6;3;17;10;3;39
"9";"360050016001";21;4;0;0;1;26
"10";"360050016002";24;5;42;14;9;94
"11";"360050016003";6;2;2;0;1;11
"12";"360050016004";37;5;38;36;8;124
"13";"360050019001";33;32;55;15;44;179
"14";"360050019002";1;9;6;23;12;51
"15";"360050019003";7;12;62;28;27;136
"16";"360050019004";14;6;16;5;5;46
"17";"360050020001";28;5;58;22;16;129
"18";"360050020002";28;11;45;9;18;111
"19";"360050020003";62;14;3;1;6;86
"20";"360050020004";6;0;1;0;1;8
"21";"360050020005";48;1;0;0;1;50
"22";"360050020006";53;2;72;7;8;142
"23";"360050023001";374;60;14;0;9;457
"24";"360050023002";5;1;4;0;1;11
"25";"360050023003";18;7;1;0;1;27
"26";"360050024000";3;0;6;0;0;9
"27";"360050024001";24;11;4;2;0;41
"28";"360050025001";18;16;1;1;4;40
"29";"360050025002";24;8;1;1;0;34
"30";"360050025003";22;2;8;4;8;44
"31";"360050025004";49;8;4;1;5;67
"32";"360050025005";17;8;6;3;1;35
"33";"360050027011";74;0;7;6;3;90
"34";"360050027012";46;11;17;2;10;86
"35";"360050027021";11;1;14;32;4;62
"36";"360050027022";11;3;7;1;2;24
"37";"360050027023";38;43;10;3;12;106
"38";"360050027024";114;2;6;0;1;123
"39";"360050028001";19;36;74;11;17;157
"40";"360050028002";32;13;15;3;4;67
"41";"360050028003";0;3;1;1;0;5
"42";"360050028004";8;49;9;3;0;69
"43";"360050031001";84;42;30;5;9;170
"44";"360050033001";5;0;18;5;7;35
"45";"360050033002";56;2;11;5;2;76
"46";"360050033003";18;12;12;0;20;62
"47";"360050035001";19;5;13;7;39;83
"48";"360050035002";130;97;0;0;9;236
"49";"360050035003";27;19;24;2;14;86
"50";"360050037001";9;10;8;0;2;29
"51";"360050038001";59;1;24;46;20;150
"52";"360050039001";26;22;7;2;16;73
"53";"360050039002";23;19;15;6;16;79
"54";"360050039003";32;19;6;1;15;73
"55";"360050039004";36;7;30;10;6;89
"56";"360050039005";72;9;26;1;6;114
"57";"360050040011";20;8;75;9;15;127
"58";"360050041001";69;7;3;0;7;86
"59";"360050041002";69;2;75;1;18;165
"60";"360050041003";0;0;1;0;0;1
"61";"360050041004";68;104;7;8;1;188
"62";"360050042001";14;0;2;0;2;18
"63";"360050042002";179;3;1;1;2;186
"64";"360050042003";18;1;9;0;5;33
"65";"360050042004";6;1;4;4;3;18
"66";"360050042005";61;2;12;4;3;82
"67";"360050042006";1;4;10;2;2;19
"68";"360050042007";11;1;0;0;1;13
"69";"360050043001";47;23;23;3;22;118
"70";"360050043002";9;12;25;4;17;67
"71";"360050043003";68;4;8;3;9;92
"72";"360050043004";58;139;41;2;5;245
"73";"360050044001";25;3;0;3;3;34
"74";"360050044002";5;2;0;0;2;9
"75";"360050044003";35;5;42;2;10;94
"76";"360050044004";57;19;8;4;6;94
"77";"360050046001";32;8;12;13;11;76
"78";"360050048001";229;15;21;2;6;273
"79";"360050048002";31;8;70;0;11;120
"80";"360050050011";39;42;66;4;18;169
"81";"360050050012";388;43;24;0;354;809
"82";"360050050013";70;20;9;1;16;116
"83";"360050050014";21;12;7;0;7;47
"84";"360050050021";57;20;25;0;15;117
"85";"360050050022";20;12;13;0;3;48
"86";"360050050023";13;16;6;0;7;42
"87";"360050050024";50;8;7;0;2;67
"88";"360050051001";1;2;30;13;14;60
"89";"360050051002";120;15;66;7;18;226
"90";"360050051003";111;5;5;1;15;137
"91";"360050052001";9;5;96;10;12;132
"92";"360050052002";93;21;2;1;8;125
"93";"360050053001";190;5;5;0;14;214
"94";"360050053002";0;0;2;0;0;2
"95";"360050054001";21;1;27;0;9;58
"96";"360050054002";67;28;79;0;24;198
"97";"360050054003";54;35;55;3;21;168
"98";"360050054004";92;11;4;0;9;116
"99";"360050056001";144;4;21;2;5;176
"100";"360050056002";4;2;10;1;1;18
"101";"360050056003";22;13;44;4;17;100
"102";"360050059021";8;5;7;0;10;30
"103";"360050059022";0;3;19;0;4;26
"104";"360050060001";40;58;28;11;22;159
"105";"360050061001";0;1;10;0;1;12
"106";"360050061002";26;7;5;1;7;46
"107";"360050061003";0;2;21;1;0;24
"108";"360050062001";175;21;36;1;10;243
"109";"360050062002";13;7;4;2;5;31
"110";"360050062003";61;17;6;0;9;93
"111";"360050062004";45;37;30;1;14;127
"112";"360050062005";0;1;11;1;2;15
"113";"360050063001";25;75;18;1;5;124
"114";"360050063002";21;24;76;17;47;185
"115";"360050063003";117;72;24;0;14;227
"116";"360050063004";67;108;0;0;5;180
"117";"360050063005";38;31;3;0;10;82
"118";"360050063006";153;172;23;0;48;396
"119";"360050064001";41;4;53;3;19;120
"120";"360050064002";14;2;5;2;3;26
"121";"360050064003";10;0;23;2;4;39
"122";"360050064004";22;3;106;3;6;140
"123";"360050065001";37;24;41;1;43;146
"124";"360050065002";52;15;10;1;4;82
"125";"360050065003";46;2;10;0;20;78
"126";"360050065004";9;27;15;2;63;116
"127";"360050067001";49;22;30;1;26;128
"128";"360050067002";30;15;12;1;9;67
"129";"360050067003";59;8;4;0;3;74
"130";"360050067004";29;26;3;3;1;62
"131";"360050067005";5;2;0;0;5;12
"132";"360050067006";32;3;18;4;6;63
"133";"360050068001";14;7;22;4;8;55
"134";"360050068002";10;2;22;5;8;47
"135";"360050068003";47;27;38;4;12;128
"136";"360050069001";51;19;24;4;7;105
"137";"360050069002";122;10;85;16;8;241
"138";"360050069003";5;2;1;0;2;10
"139";"360050069004";5;0;1;0;1;7
"140";"360050070001";52;6;96;0;23;177
"141";"360050070002";35;1314;53;2;11;1415
"142";"360050070003";299;803;72;1;5;1180
"143";"360050071001";20;3;18;0;4;45
"144";"360050071002";202;46;24;2;39;313
"145";"360050072001";48;19;44;3;24;138
"146";"360050072002";49;21;52;3;21;146
"147";"360050072003";5;4;27;1;16;53
"148";"360050072004";16;3;18;4;10;51
"149";"360050073001";29;8;17;1;2;57
"150";"360050073002";43;11;5;6;6;71
"151";"360050073003";56;7;26;8;16;113
"152";"360050074001";18;7;34;19;9;87
"153";"360050074002";30;9;18;18;20;95
"154";"360050074003";11;2;4;2;1;20
"155";"360050075001";132;9;87;6;34;268
"156";"360050075002";66;18;36;2;11;133
"157";"360050075003";42;2;7;1;1;53
"158";"360050075004";5;2;1;2;1;11
"159";"360050076001";6;1;1;2;2;12
"160";"360050076002";58;9;31;4;12;114
"161";"360050076003";7;4;20;1;7;39
"162";"360050076004";51;38;76;5;17;187
"163";"360050076005";4;6;78;6;7;101
"164";"360050077001";34;20;53;1;11;119
"165";"360050078001";33;3;63;10;12;121
"166";"360050078002";39;7;124;15;41;226
"167";"360050078003";26;12;6;0;0;44
"168";"360050078004";45;8;33;0;1;87
"169";"360050079001";74;3;13;2;13;105
"170";"360050079002";45;15;6;0;9;75
"171";"360050079003";13;5;7;0;13;38
"172";"360050079004";38;9;18;1;3;69
"173";"360050079005";7;0;2;0;0;9
"174";"360050079006";6;2;2;0;3;13
"175";"360050083001";44;1;26;3;5;79
"176";"360050083002";5;3;8;6;10;32
"177";"360050083003";32;8;8;0;4;52
"178";"360050083004";52;32;17;2;15;118
"179";"360050083005";21;18;52;0;3;94
"180";"360050083006";22;33;188;2;12;257
"181";"360050084001";13;1;16;11;2;43
"182";"360050084002";37;4;70;34;16;161
"183";"360050085001";49;31;29;2;5;116
"184";"360050085002";47;14;71;3;13;148
"185";"360050085003";9;4;13;0;13;39
"186";"360050085004";7;7;3;0;3;20
"187";"360050085005";10;29;1;0;2;42
"188";"360050086001";10;6;22;18;15;71
"189";"360050086002";21;3;2;1;0;27
"190";"360050086003";51;1;4;3;2;61
"191";"360050087001";20;54;7;3;10;94
"192";"360050087002";60;19;10;1;6;96
"193";"360050087003";24;2;26;0;5;57
"194";"360050087004";68;10;0;4;2;84
"195";"360050087005";101;19;4;4;18;146
"196";"360050089001";52;5;6;0;5;68
"197";"360050089002";20;7;82;0;9;118
"198";"360050090001";1;0;11;9;4;25
"199";"360050090002";12;39;31;16;3;101
"200";"360050090003";14;0;0;0;5;19
"201";"360050090004";7;6;50;15;6;84
"202";"360050090005";20;2;2;0;2;26
"203";"360050092001";47;6;14;1;12;80
"204";"360050092002";100;9;42;1;12;164
"205";"360050092003";72;39;59;9;12;191
"206";"360050092004";13;8;62;1;12;96
"207";"360050092005";29;8;58;3;17;115
"208";"360050093001";3;15;68;22;17;125
"209";"360050093002";50;34;30;3;33;150
"210";"360050093003";19;9;25;0;11;64
"211";"360050093004";48;6;17;4;13;88
"212";"360050093005";47;17;53;62;15;194
"213";"360050093006";1;20;114;46;11;192
"214";"360050096001";45;6;75;18;13;157
"215";"360050096002";4;13;89;51;24;181
"216";"360050098001";56;20;53;11;10;150
"217";"360050098002";41;24;21;1;13;100
"218";"360050098003";14;5;32;8;13;72
"219";"360050098004";21;2;37;3;5;68
"220";"360050098005";21;1;6;0;12;40
"221";"360050110000";0;1;0;0;0;1
"222";"360050110001";44;11;23;33;6;117
"223";"360050115021";184;26;63;6;28;307
"224";"360050115022";268;10;13;1;14;306
"225";"360050115023";29;47;16;0;4;96
"226";"360050117001";108;15;7;5;6;141
"227";"360050117002";1;2;12;5;3;23
"228";"360050118001";6;3;84;31;15;139
"229";"360050118002";5;15;71;3;7;101
"230";"360050118003";18;7;97;16;15;153
"231";"360050119001";51;24;3;0;44;122
"232";"360050119002";42;18;9;0;19;88
"233";"360050119003";6;2;14;0;1;23
"234";"360050119004";42;4;2;2;14;64
"235";"360050119005";90;4;9;3;2;108
"236";"360050121011";231;16;32;3;3;285
"237";"360050121012";82;26;66;7;14;195
"238";"360050121021";21;32;14;5;11;83
"239";"360050123001";94;23;28;0;16;161
"240";"360050123002";94;4;33;5;25;161
"241";"360050123003";32;16;13;2;8;71
"242";"360050125001";45;15;70;9;35;174
"243";"360050125002";71;78;37;9;7;202
"244";"360050127011";32;7;28;5;8;80
"245";"360050127012";17;4;10;1;19;51
"246";"360050129011";19;24;23;3;20;89
"247";"360050129012";94;32;25;0;23;174
"248";"360050130001";20;0;30;17;5;72
"249";"360050131001";38;12;10;0;1;61
"250";"360050131002";20;1;55;4;6;86
"251";"360050131003";63;12;23;3;21;122
"252";"360050132001";52;6;48;19;22;147
"253";"360050132002";162;11;28;3;7;211
"254";"360050132003";20;4;138;20;22;204
"255";"360050132004";43;19;49;29;23;163
"256";"360050132005";18;5;58;21;5;107
"257";"360050133001";70;7;0;1;3;81
"258";"360050133002";61;29;12;0;16;118
"259";"360050133003";10;1;0;0;0;11
"260";"360050133004";104;1;2;1;1;109
"261";"360050135001";55;14;25;1;17;112
"262";"360050135002";15;9;12;1;2;39
"263";"360050135003";115;15;57;0;11;198
"264";"360050138001";18;23;38;38;12;129
"265";"360050138002";66;2;61;30;3;162
"266";"360050141001";41;25;29;8;5;108
"267";"360050141002";112;36;6;2;11;167
"268";"360050141003";51;15;39;2;10;117
"269";"360050143001";49;18;61;22;18;168
"270";"360050144001";3;0;0;0;0;3
"271";"360050144002";25;1;5;1;2;34
"272";"360050144003";10;6;1;0;6;23
"273";"360050144004";14;0;1;0;1;16
"274";"360050144005";65;11;44;16;5;141
"275";"360050144006";63;2;25;10;16;116
"276";"360050145001";74;13;21;1;9;118
"277";"360050145002";41;2;6;1;2;52
"278";"360050145003";18;0;28;8;1;55
"279";"360050145004";109;5;30;21;29;194
"280";"360050147011";24;9;1;0;0;34
"281";"360050147012";85;18;32;0;6;141
"282";"360050147013";83;20;2;0;1;106
"283";"360050147021";65;30;2;0;1;98
"284";"360050147022";42;8;4;0;0;54
"285";"360050147023";19;3;2;1;2;27
"286";"360050147024";17;8;3;2;2;32
"287";"360050149001";31;6;55;6;12;110
"288";"360050149002";20;26;90;0;5;141
"289";"360050149003";46;9;18;1;17;91
"290";"360050151001";55;7;12;2;0;76
"291";"360050151002";51;53;11;0;19;134
"292";"360050151003";39;18;36;2;11;106
"293";"360050151004";276;27;33;0;21;357
"294";"360050152001";63;8;85;36;21;213
"295";"360050152002";31;26;75;40;63;235
"296";"360050153001";122;29;75;32;24;282
"297";"360050153002";6;4;11;2;6;29
"298";"360050153003";23;4;52;4;9;92
"299";"360050155001";74;16;9;2;9;110
"300";"360050155002";17;2;20;5;10;54
"301";"360050157001";81;34;66;5;17;203
"302";"360050157002";82;11;19;9;9;130
"303";"360050157003";54;17;36;1;7;115
"304";"360050158001";55;1;65;74;11;206
"305";"360050159001";50;13;12;1;8;84
"306";"360050159002";116;16;4;0;1;137
"307";"360050160001";36;6;79;22;16;159
"308";"360050160002";6;2;17;6;2;33
"309";"360050160003";11;0;27;5;8;51
"310";"360050160004";7;1;27;9;7;51
"311";"360050161001";32;23;14;1;10;80
"312";"360050161002";26;65;15;12;5;123
"313";"360050161003";53;13;1;22;5;94
"314";"360050161004";30;45;10;0;7;92
"315";"360050162001";17;1;14;4;5;41
"316";"360050162002";19;18;40;16;4;97
"317";"360050163001";32;9;5;0;7;53
"318";"360050164001";7;9;38;18;16;88
"319";"360050165001";40;17;41;3;11;112
"320";"360050166001";37;12;61;16;9;135
"321";"360050166002";28;3;32;16;6;85
"322";"360050167001";14;46;16;0;2;78
"323";"360050167002";26;37;47;17;15;142
"324";"360050169001";29;12;22;4;2;69
"325";"360050171001";20;30;8;5;3;66
"326";"360050173001";16;4;16;2;8;46
"327";"360050173002";30;10;26;0;5;71
"328";"360050173003";25;36;42;4;8;115
"329";"360050173004";33;21;12;1;3;70
"330";"360050175001";24;9;7;3;6;49
"331";"360050175002";25;4;5;1;6;41
"332";"360050175003";37;17;4;0;12;70
"333";"360050175004";155;12;12;1;6;186
"334";"360050175005";53;7;2;0;3;65
"335";"360050175006";30;6;3;1;4;44
"336";"360050177011";247;103;85;1;7;443
"337";"360050177012";514;6;3;0;10;533
"338";"360050177013";31;8;14;1;8;62
"339";"360050177021";26;1;25;0;2;54
"340";"360050177022";42;2;40;3;20;107
"341";"360050177023";54;96;114;0;16;280
"342";"360050177024";67;37;7;0;2;113
"343";"360050179011";519;706;39;1;18;1283
"344";"360050179012";0;1;1;0;1;3
"345";"360050179013";70;40;7;2;7;126
"346";"360050179021";52;77;32;1;5;167
"347";"360050179022";47;31;9;0;4;91
"348";"360050179023";66;123;1;0;5;195
"349";"360050181011";168;19;113;6;8;314
"350";"360050181012";51;11;25;0;4;91
"351";"360050181013";17;16;21;0;2;56
"352";"360050181021";94;19;5;1;5;124
"353";"360050181022";46;19;4;1;7;77
"354";"360050181023";43;74;3;1;5;126
"355";"360050181024";75;10;1;5;1;92
"356";"360050183011";56;72;27;5;3;163
"357";"360050183012";47;47;7;2;6;109
"358";"360050183013";78;25;2;0;1;106
"359";"360050183021";105;46;20;0;5;176
"360";"360050183022";17;26;7;1;6;57
"361";"360050183023";12;16;103;0;3;134
"362";"360050184001";10;1;25;21;23;80
"363";"360050184002";11;3;129;32;49;224
"364";"360050184003";4;2;41;29;15;91
"365";"360050184004";26;28;73;27;7;161
"366";"360050185001";192;25;113;10;37;377
"367";"360050185002";23;4;36;1;7;71
"368";"360050185003";83;10;43;9;13;158
"369";"360050185004";9;17;8;1;3;38
"370";"360050185005";22;8;28;2;5;65
"371";"360050189001";46;52;8;2;4;112
"372";"360050189002";20;1;4;0;3;28
"373";"360050189003";513;162;44;4;153;876
"374";"360050189004";131;26;128;3;8;296
"375";"360050193001";227;58;12;1;15;313
"376";"360050193002";21;2;3;0;3;29
"377";"360050193003";32;11;2;2;1;48
"378";"360050193004";57;13;61;0;5;136
"379";"360050194001";50;74;130;43;23;320
"380";"360050195001";93;47;16;3;21;180
"381";"360050195002";107;167;29;3;46;352
"382";"360050195003";136;15;13;19;11;194
"383";"360050195004";33;22;9;1;2;67
"384";"360050197001";38;39;5;1;7;90
"385";"360050197002";240;31;15;0;14;300
"386";"360050197003";81;67;17;2;27;194
"387";"360050197004";24;2;3;0;6;35
"388";"360050197005";68;18;2;0;5;93
"389";"360050199001";40;25;2;2;5;74
"390";"360050199002";42;23;3;0;6;74
"391";"360050199003";4;18;45;1;1;69
"392";"360050199004";69;8;18;2;4;101
"393";"360050199005";45;12;8;0;1;66
"394";"360050199006";84;78;36;0;11;209
"395";"360050200001";26;8;28;6;18;86
"396";"360050200002";3;6;36;14;4;63
"397";"360050200003";62;10;77;10;29;188
"398";"360050200004";21;11;6;0;18;56
"399";"360050201001";44;35;73;2;2;156
"400";"360050201002";6;10;17;6;7;46
"401";"360050201003";63;12;9;1;4;89
"402";"360050202001";24;3;34;1;15;77
"403";"360050202002";38;7;58;4;28;135
"404";"360050204001";23;5;26;1;11;66
"405";"360050204002";2;4;53;0;9;68
"406";"360050204003";6;21;55;1;7;90
"407";"360050205011";69;38;5;1;1;114
"408";"360050205012";57;16;13;3;5;94
"409";"360050205013";38;18;49;1;5;111
"410";"360050205014";58;40;116;3;6;223
"411";"360050205021";23;17;48;1;2;91
"412";"360050205022";32;5;74;2;4;117
"413";"360050205023";6;4;44;4;24;82
"414";"360050206011";58;10;31;0;11;110
"415";"360050206012";5;3;116;11;20;155
"416";"360050209001";16;9;17;1;5;48
"417";"360050209002";46;9;5;0;5;65
"418";"360050209003";20;6;13;0;5;44
"419";"360050209004";187;9;29;1;3;229
"420";"360050210011";3;0;9;0;0;12
"421";"360050210012";7;0;2;0;4;13
"422";"360050210013";3;1;1;0;0;5
"423";"360050210014";4;0;7;0;4;15
"424";"360050210015";9;0;1;1;2;13
"425";"360050210016";39;0;4;0;3;46
"426";"360050210021";2;0;2;0;0;4
"427";"360050210022";37;2;3;0;0;42
"428";"360050210023";1;0;0;0;0;1
"429";"360050210024";0;0;1;0;0;1
"430";"360050210025";24;0;4;0;8;36
"431";"360050210026";10;1;0;0;2;13
"432";"360050210027";3;1;0;0;0;4
"433";"360050211001";162;2;65;1;8;238
"434";"360050211002";21;14;27;6;4;72
"435";"360050211003";38;8;12;2;2;62
"436";"360050211004";6;9;2;0;1;18
"437";"360050212001";2;0;3;0;0;5
"438";"360050212002";1;2;0;0;2;5
"439";"360050212004";0;9;3;0;0;12
"440";"360050213011";3;1;7;0;0;11
"441";"360050213012";10;23;29;1;5;68
"442";"360050213021";36;30;36;6;11;119
"443";"360050213022";3;8;16;1;4;32
"444";"360050213023";12;6;30;0;7;55
"445";"360050213024";127;40;79;2;6;254
"446";"360050215011";16;15;15;3;3;52
"447";"360050215012";130;32;91;4;16;273
"448";"360050215013";42;29;50;1;3;125
"449";"360050215021";109;86;37;3;7;242
"450";"360050215022";79;14;59;0;4;156
"451";"360050215023";35;7;133;1;5;181
"452";"360050215024";47;9;67;1;2;126
"453";"360050215025";30;4;17;1;6;58
"454";"360050216011";71;20;57;0;16;164
"455";"360050216012";44;10;70;2;13;139
"456";"360050216013";26;7;2;5;4;44
"457";"360050216014";25;2;12;1;3;43
"458";"360050216021";9;2;31;1;2;45
"459";"360050216022";1;5;3;0;1;10
"460";"360050216023";96;2;0;0;0;98
"461";"360050216024";11;4;24;0;5;44
"462";"360050216025";9;5;15;1;4;34
"463";"360050217001";52;25;102;8;18;205
"464";"360050217002";153;31;5;5;10;204
"465";"360050217003";0;4;21;9;5;39
"466";"360050217004";88;17;33;2;4;144
"467";"360050218001";71;7;4;27;6;115
"468";"360050218002";61;23;60;1;9;154
"469";"360050218003";112;9;138;4;11;274
"470";"360050218004";26;2;65;16;14;123
"471";"360050218005";34;7;16;18;20;95
"472";"360050219001";129;203;99;41;22;494
"473";"360050220001";154;21;87;14;29;305
"474";"360050221011";36;3;3;0;4;46
"475";"360050221012";30;16;6;0;6;58
"476";"360050221013";43;15;12;1;5;76
"477";"360050221021";49;71;14;1;14;149
"478";"360050221022";27;26;3;0;2;58
"479";"360050221023";74;21;14;0;13;122
"480";"360050222001";37;6;35;2;19;99
"481";"360050222002";4;2;31;0;11;48
"482";"360050222003";16;19;40;1;11;87
"483";"360050222004";11;8;12;0;9;40
"484";"360050223001";13;147;27;0;19;206
"485";"360050223002";31;90;13;0;13;147
"486";"360050223003";52;101;3;0;4;160
"487";"360050223004";10;18;0;0;1;29
"488";"360050224011";14;5;1;0;3;23
"489";"360050224012";115;13;24;1;12;165
"490";"360050224031";38;21;7;6;6;78
"491";"360050224032";53;32;25;3;36;149
"492";"360050224041";19;3;7;1;2;32
"493";"360050224042";139;10;6;0;14;169
"494";"360050224043";104;11;8;0;5;128
"495";"360050225001";115;87;10;0;11;223
"496";"360050225002";32;44;48;3;7;134
"497";"360050225003";39;69;2;0;12;122
"498";"360050225004";27;25;11;0;2;65
"499";"360050225005";66;18;16;2;6;108
"500";"360050225006";127;10;5;0;2;144
"501";"360050227011";9;7;13;1;1;31
"502";"360050227012";69;26;12;0;9;116
"503";"360050227013";85;18;74;3;4;184
"504";"360050227021";102;48;36;4;11;201
"505";"360050227031";24;47;18;4;11;104
"506";"360050228001";24;17;106;4;12;163
"507";"360050228002";98;4;25;1;7;135
"508";"360050228003";124;10;6;3;7;150
"509";"360050228004";75;7;5;0;4;91
"510";"360050229011";149;16;19;0;7;191
"511";"360050229012";54;10;26;1;10;101
"512";"360050229013";110;50;4;3;7;174
"513";"360050229014";44;47;41;4;2;138
"514";"360050229015";36;65;59;0;11;171
"515";"360050229021";25;43;17;1;2;88
"516";"360050229022";22;156;24;3;8;213
"517";"360050229023";58;57;11;1;4;131
"518";"360050230001";37;9;72;7;14;139
"519";"360050230002";26;3;113;8;33;183
"520";"360050231001";66;23;57;9;21;176
"521";"360050232001";29;16;31;0;24;100
"522";"360050232002";26;11;53;3;14;107
"523";"360050233011";38;11;17;1;8;75
"524";"360050233012";83;224;25;1;18;351
"525";"360050233013";7;10;24;1;7;49
"526";"360050233014";32;10;10;0;0;52
"527";"360050233021";72;78;7;6;12;175
"528";"360050233022";28;48;15;0;12;103
"529";"360050235011";79;29;8;3;21;140
"530";"360050235012";12;4;0;0;7;23
"531";"360050235013";55;2;0;0;4;61
"532";"360050235021";37;37;18;0;2;94
"533";"360050235022";17;5;3;1;1;27
"534";"360050235023";31;1;44;1;5;82
"535";"360050235024";99;8;1;5;11;124
"536";"360050236001";15;10;31;2;10;68
"537";"360050236002";11;5;30;6;10;62
"538";"360050237021";31;7;1;1;18;58
"539";"360050237031";47;29;54;1;37;168
"540";"360050237032";96;131;0;1;109;337
"541";"360050237033";30;14;51;5;6;106
"542";"360050237041";120;8;2;0;4;134
"543";"360050237042";108;10;11;2;14;145
"544";"360050237043";153;24;6;2;2;187
"545";"360050238001";0;6;24;17;1;48
"546";"360050238002";16;5;85;3;14;123
"547";"360050238003";44;3;57;6;21;131
"548";"360050239001";92;116;19;0;17;244
"549";"360050239002";33;160;15;3;16;227
"550";"360050239003";52;14;42;2;10;120
"551";"360050239004";247;35;21;9;15;327
"552";"360050239005";50;33;3;4;6;96
"553";"360050239006";52;10;13;1;10;86
"554";"360050240001";79;16;229;44;37;405
"555";"360050240002";21;7;31;2;8;69
"556";"360050240003";24;5;43;5;21;98
"557";"360050241001";85;18;4;1;16;124
"558";"360050241002";23;6;42;0;9;80
"559";"360050241003";19;8;10;1;8;46
"560";"360050241004";21;9;18;1;10;59
"561";"360050241005";38;16;6;2;11;73
"562";"360050243001";30;17;3;0;24;74
"563";"360050243002";44;12;52;3;9;120
"564";"360050243003";48;0;12;0;2;62
"565";"360050243004";68;26;130;3;11;238
"566";"360050244001";17;11;35;5;6;74
"567";"360050244002";11;2;119;44;12;188
"568";"360050245011";27;34;25;3;3;92
"569";"360050245012";59;36;54;3;3;155
"570";"360050245013";11;8;6;0;0;25
"571";"360050245014";20;9;16;0;4;49
"572";"360050245021";22;28;74;2;10;136
"573";"360050245022";3;0;0;0;2;5
"574";"360050245023";69;73;59;2;9;212
"575";"360050246001";82;3;48;5;10;148
"576";"360050246002";14;3;46;8;4;75
"577";"360050247001";0;0;0;1;0;1
"578";"360050247002";25;1;9;3;6;44
"579";"360050248001";41;3;56;10;11;121
"580";"360050248002";9;3;56;14;4;86
"581";"360050248003";19;0;52;21;10;102
"582";"360050249001";23;3;30;7;0;63
"583";"360050250001";93;2;90;23;22;230
"584";"360050250002";10;2;27;21;7;67
"585";"360050251001";99;28;30;2;14;173
"586";"360050251002";64;16;32;10;3;125
"587";"360050251003";35;13;85;18;21;172
"588";"360050251004";18;1;16;0;4;39
"589";"360050251005";70;18;25;3;11;127
"590";"360050251006";37;24;27;0;3;91
"591";"360050251007";5;0;4;0;1;10
"592";"360050252001";44;4;148;11;11;218
"593";"360050252002";13;1;45;32;7;98
"594";"360050253001";209;8;9;0;8;234
"595";"360050253002";110;27;41;0;9;187
"596";"360050253003";62;4;13;0;4;83
"597";"360050253004";28;13;9;2;1;53
"598";"360050254001";6;7;37;8;25;83
"599";"360050254002";8;13;110;11;9;151
"600";"360050255001";124;40;46;5;110;325
"601";"360050255002";141;130;57;1;12;341
"602";"360050255003";61;71;44;3;13;192
"603";"360050256001";26;4;31;67;18;146
"604";"360050256002";21;8;46;47;22;144
"605";"360050257001";50;9;160;7;10;236
"606";"360050261001";51;74;43;2;8;178
"607";"360050263001";107;58;10;1;23;199
"608";"360050263002";79;52;9;1;4;145
"609";"360050263003";74;49;15;2;14;154
"610";"360050263004";7;29;14;0;0;50
"611";"360050263005";26;6;20;21;5;78
"612";"360050264001";15;6;46;8;43;118
"613";"360050264002";14;0;49;20;11;94
"614";"360050264003";46;8;62;24;31;171
"615";"360050264004";12;0;56;21;13;102
"616";"360050265001";39;27;37;30;13;146
"617";"360050265002";64;25;32;30;9;160
"618";"360050265003";133;12;9;0;10;164
"619";"360050265004";44;9;46;5;7;111
"620";"360050266011";7;8;17;16;2;50
"621";"360050266012";17;20;16;3;6;62
"622";"360050266013";6;2;16;9;5;38
"623";"360050266021";26;3;42;20;7;98
"624";"360050266022";35;21;48;9;25;138
"625";"360050266023";25;4;79;15;18;141
"626";"360050266024";11;0;12;0;9;32
"627";"360050266025";17;1;23;4;4;49
"628";"360050267011";68;3;48;0;11;130
"629";"360050267012";51;14;5;1;5;76
"630";"360050267013";22;23;35;26;12;118
"631";"360050267021";144;11;45;3;37;240
"632";"360050267022";47;0;19;3;7;76
"633";"360050267023";52;9;11;1;1;74
"634";"360050267024";6;3;8;0;11;28
"635";"360050267025";18;3;7;2;4;34
"636";"360050267026";62;5;17;4;23;111
"637";"360050269001";66;20;189;12;20;307
"638";"360050269002";193;4;38;1;3;239
"639";"360050269003";29;1;46;0;3;79
"640";"360050273001";21;11;12;0;4;48
"641";"360050273002";32;71;50;1;11;165
"642";"360050273003";86;11;104;2;18;221
"643";"360050273004";156;40;110;1;9;316
"644";"360050274011";2;3;5;13;1;24
"645";"360050274012";16;6;62;15;15;114
"646";"360050274013";34;3;33;16;165;251
"647";"360050274014";28;2;49;30;23;132
"648";"360050274021";6;189;40;11;4;250
"649";"360050274022";0;3;4;5;2;14
"650";"360050274023";9;16;41;13;10;89
"651";"360050276001";39;20;41;27;14;141
"652";"360050277001";92;21;15;1;8;137
"653";"360050277002";9;3;10;1;5;28
"654";"360050277003";40;4;37;15;8;104
"655";"360050277004";39;17;9;0;6;71
"656";"360050279001";30;67;23;1;4;125
"657";"360050279002";11;5;25;1;14;56
"658";"360050279003";56;13;55;0;44;168
"659";"360050279004";32;10;82;1;14;139
"660";"360050279005";7;2;11;0;1;21
"661";"360050279006";149;12;29;4;5;199
"662";"360050281001";40;4;75;0;2;121
"663";"360050281002";38;0;4;0;1;43
"664";"360050281003";0;0;6;0;2;8
"665";"360050283001";22;23;43;3;11;102
"666";"360050283002";118;13;19;2;4;156
"667";"360050284001";18;1;35;14;14;82
"668";"360050285001";60;17;31;1;15;124
"669";"360050285002";8;3;8;0;1;20
"670";"360050285003";19;80;3;0;1;103
"671";"360050285004";106;8;55;13;10;192
"672";"360050286001";5;0;50;13;10;78
"673";"360050286002";20;20;42;4;9;95
"674";"360050287001";14;9;84;17;19;143
"675";"360050287002";43;0;1;0;2;46
"676";"360050287003";25;12;4;3;4;48
"677";"360050288001";8;2;25;40;2;77
"678";"360050288002";5;0;27;11;21;64
"679";"360050288003";11;0;8;0;1;20
"680";"360050288004";10;0;35;3;16;64
"681";"360050289001";118;32;30;3;19;202
"682";"360050289002";15;2;0;0;0;17
"683";"360050289003";16;15;15;4;15;65
"684";"360050289004";20;7;0;0;1;28
"685";"360050293011";5;1;8;5;1;20
"686";"360050293012";31;3;5;0;4;43
"687";"360050293021";14;2;5;0;1;22
"688";"360050293022";1;0;13;5;3;22
"689";"360050293023";40;18;12;1;10;81
"690";"360050293024";49;4;66;4;10;133
"691";"360050295001";25;28;29;1;3;86
"692";"360050295002";97;60;31;1;8;197
"693";"360050295003";10;4;50;1;1;66
"694";"360050295004";54;13;51;1;11;130
"695";"360050296001";366;12;94;29;15;516
"696";"360050296002";0;0;8;2;12;22
"697";"360050297001";6;3;18;0;7;34
"698";"360050297002";18;2;9;0;4;33
"699";"360050297003";58;0;9;0;0;67
"700";"360050300001";83;7;36;6;21;153
"701";"360050300002";16;6;60;15;13;110
"702";"360050300003";17;264;48;1;8;338
"703";"360050300004";51;4;25;3;7;90
"704";"360050300005";6;0;17;13;4;40
"705";"360050300006";21;2;69;17;9;118
"706";"360050301001";0;2;5;7;0;14
"707";"360050301002";0;1;4;0;0;5
"708";"360050302001";2;0;2;2;1;7
"709";"360050302002";2;0;1;0;1;4
"710";"360050302003";3;2;98;1;2;106
"711";"360050302005";20;1;14;0;3;38
"712";"360050307011";10;1;6;10;3;30
"713";"360050307012";5;0;15;1;2;23
"714";"360050307013";10;8;19;2;3;42
"715";"360050307014";1;0;6;0;1;8
"716";"360050309001";0;0;1;0;0;1
"717";"360050309002";0;5;12;4;1;22
"718";"360050309003";8;4;0;2;0;14
"719";"360050309004";5;11;11;0;1;28
"720";"360050310001";3;1;15;20;2;41
"721";"360050310002";11;5;23;20;6;65
"722";"360050310003";7;2;27;18;15;69
"723";"360050312001";1;0;20;22;47;90
"724";"360050312002";7;2;29;11;12;61
"725";"360050314001";17;0;22;22;9;70
"726";"360050314002";1;0;28;17;9;55
"727";"360050316001";15;5;85;14;11;130
"728";"360050316002";6;0;7;3;25;41
"729";"360050318001";9;2;34;6;9;60
"730";"360050318002";2;2;24;11;8;47
"731";"360050323001";4;1;4;1;0;10
"732";"360050323002";6;1;3;3;1;14
"733";"360050323003";0;0;5;7;12;24
"734";"360050323004";7;7;45;14;5;78
"735";"360050324001";165;6;10;1;7;189
"736";"360050324002";47;15;37;2;12;113
"737";"360050326001";103;14;51;5;16;189
"738";"360050326002";29;1;55;62;24;171
"739";"360050326003";4;0;28;4;10;46
"740";"360050328001";52;74;18;3;10;157
"741";"360050328002";57;12;0;1;1;71
"742";"360050328003";4;3;34;6;2;49
"743";"360050328004";77;0;25;7;14;123
"744";"360050330001";17;5;19;8;13;62
"745";"360050330002";612;4;18;0;6;640
"746";"360050330003";113;1;6;3;15;138
"747";"360050330004";12;1;19;5;1;38
"748";"360050332011";56;1;2;0;6;65
"749";"360050332012";37;1;22;2;9;71
"750";"360050332013";80;7;15;1;10;113
"751";"360050332021";27;1;16;1;3;48
"752";"360050332022";20;0;25;1;7;53
"753";"360050332023";19;2;13;1;8;43
"754";"360050332024";13;1;6;4;3;27
"755";"360050334001";21;41;18;7;9;96
"756";"360050335001";0;0;1;1;1;3
"757";"360050335002";17;28;29;24;9;107
"758";"360050335003";41;36;19;0;2;98
"759";"360050336001";21;0;30;27;12;90
"760";"360050336002";76;50;2;1;5;134
"761";"360050336003";27;6;1;0;3;37
"762";"360050336004";21;0;3;0;4;28
"763";"360050336005";52;5;2;0;6;65
"764";"360050336006";16;12;20;4;17;69
"765";"360050337001";2;2;14;5;4;27
"766";"360050337002";4;0;31;27;4;66
"767";"360050337003";13;5;31;12;17;78
"768";"360050338001";22;7;21;7;10;67
"769";"360050338002";57;5;10;0;1;73
"770";"360050338003";14;2;87;1;4;108
"771";"360050338004";75;29;57;6;14;181
"772";"360050340001";35;0;63;1;11;110
"773";"360050340002";84;6;49;6;7;152
"774";"360050340003";46;6;15;0;5;72
"775";"360050340004";21;5;28;2;1;57
"776";"360050342001";8;0;18;11;2;39
"777";"360050342002";15;6;54;17;16;108
"778";"360050343001";17;1;38;10;8;74
"779";"360050343002";37;7;52;20;3;119
"780";"360050344001";7;0;14;5;5;31
"781";"360050344002";3;4;19;35;13;74
"782";"360050345001";16;3;62;9;2;92
"783";"360050345002";25;0;48;18;26;117
"784";"360050345003";5;1;8;12;4;30
"785";"360050348001";9;4;60;63;4;140
"786";"360050348002";161;24;2;7;23;217
"787";"360050348003";29;2;119;34;17;201
"788";"360050348004";8;5;50;34;9;106
"789";"360050350001";53;5;40;21;14;133
"790";"360050350002";8;6;10;20;17;61
"791";"360050351001";5;5;20;14;0;44
"792";"360050351002";78;0;34;25;5;142
"793";"360050351003";163;13;30;12;1;219
"794";"360050356001";11;1;25;26;7;70
"795";"360050356002";23;17;49;46;12;147
"796";"360050358001";25;15;38;17;5;100
"797";"360050358002";7;0;50;29;10;96
"798";"360050358003";20;1;46;4;1;72
"799";"360050358004";20;0;18;29;3;70
"800";"360050358005";19;0;41;35;3;98
"801";"360050358006";8;3;36;9;34;90
"802";"360050358007";33;10;35;6;22;106
"803";"360050359001";35;9;23;13;11;91
"804";"360050360001";2;22;26;18;7;75
"805";"360050360002";12;2;46;14;8;82
"806";"360050360003";3;0;17;10;5;35
"807";"360050361001";26;15;11;2;6;60
"808";"360050361002";80;8;62;0;6;156
"809";"360050361003";18;3;4;3;5;33
"810";"360050361004";19;2;2;0;1;24
"811";"360050361005";131;16;19;7;2;175
"812";"360050363001";58;5;17;2;2;84
"813";"360050363002";11;5;9;1;2;28
"814";"360050363003";19;20;30;5;17;91
"815";"360050363004";138;10;54;12;14;228
"816";"360050363005";63;14;5;4;4;90
"817";"360050363006";74;13;28;5;19;139
"818";"360050364001";25;5;45;11;10;96
"819";"360050364002";7;0;25;1;9;42
"820";"360050364003";10;4;32;9;6;61
"821";"360050365011";54;4;13;9;6;86
"822";"360050365012";14;9;28;2;11;64
"823";"360050365013";41;11;11;4;4;71
"824";"360050365021";45;47;15;2;3;112
"825";"360050365022";113;4;28;0;12;157
"826";"360050367001";19;6;22;15;18;80
"827";"360050367002";261;10;15;7;8;301
"828";"360050368001";33;6;41;17;14;111
"829";"360050368002";2;1;23;10;7;43
"830";"360050369011";99;139;10;18;66;332
"831";"360050369012";39;43;13;1;5;101
"832";"360050369021";40;9;2;1;4;56
"833";"360050369022";29;5;17;15;7;73
"834";"360050370001";8;3;27;20;3;61
"835";"360050370002";7;1;30;2;2;42
"836";"360050370003";9;0;32;1;7;49
"837";"360050371001";20;4;81;1;12;118
"838";"360050371002";31;4;12;11;30;88
"839";"360050371003";89;4;14;6;12;125
"840";"360050371004";15;7;21;2;4;49
"841";"360050372001";15;5;27;4;5;56
"842";"360050372002";33;7;46;6;8;100
"843";"360050373001";79;12;10;5;6;112
"844";"360050373002";33;101;53;13;12;212
"845";"360050373003";64;15;20;2;29;130
"846";"360050373004";127;22;5;4;17;175
"847";"360050374001";21;2;39;2;7;71
"848";"360050374002";51;23;56;9;5;144
"849";"360050374003";28;22;3;0;1;54
"850";"360050374004";1;0;0;0;3;4
"851";"360050375041";11;1;9;33;9;63
"852";"360050375042";179;12;12;9;2;214
"853";"360050375043";76;57;30;18;10;191
"854";"360050376001";127;3;11;1;1;143
"855";"360050376002";9;3;15;4;6;37
"856";"360050378001";25;7;35;3;15;85
"857";"360050378002";7;15;9;0;3;34
"858";"360050378003";27;4;28;10;8;77
"859";"360050379001";7;21;61;65;9;163
"860";"360050379002";14;3;4;0;5;26
"861";"360050379003";35;3;3;0;0;41
"862";"360050379004";21;6;31;1;2;61
"863";"360050379005";82;13;5;7;7;114
"864";"360050380001";38;1;5;0;1;45
"865";"360050380002";43;2;41;5;7;98
"866";"360050380003";85;7;18;4;13;127
"867";"360050380004";46;6;30;7;5;94
"868";"360050381001";24;3;1;1;4;33
"869";"360050381002";98;14;11;1;2;126
"870";"360050381003";31;28;2;0;3;64
"871";"360050381004";18;9;23;0;5;55
"872";"360050381005";4;0;33;1;6;44
"873";"360050381006";128;26;7;0;16;177
"874";"360050382001";16;2;65;1;16;100
"875";"360050382002";23;3;23;5;7;61
"876";"360050383011";37;19;9;0;8;73
"877";"360050383012";101;10;39;2;2;154
"878";"360050383013";40;7;14;0;8;69
"879";"360050383021";51;25;36;25;5;142
"880";"360050383022";88;34;19;3;2;146
"881";"360050383023";220;31;9;3;9;272
"882";"360050385001";24;12;26;1;11;74
"883";"360050385002";23;14;7;3;1;48
"884";"360050385003";20;46;8;5;5;84
"885";"360050385004";82;11;31;25;10;159
"886";"360050386001";22;5;84;12;8;131
"887";"360050386002";8;11;43;6;6;74
"888";"360050386003";9;19;3;0;3;34
"889";"360050386004";29;3;70;4;6;112
"890";"360050386005";20;6;22;4;1;53
"891";"360050386006";5;23;25;1;8;62
"892";"360050386007";5;0;1;1;2;9
"893";"360050386008";19;27;9;6;1;62
"894";"360050387001";35;4;7;0;24;70
"895";"360050387002";95;20;24;18;15;172
"896";"360050387003";33;22;8;0;5;68
"897";"360050388001";24;1;78;2;3;108
"898";"360050388002";36;7;140;7;13;203
"899";"360050389001";116;11;29;4;6;166
"900";"360050389002";18;10;2;0;13;43
"901";"360050389003";69;54;16;1;25;165
"902";"360050389004";33;50;15;2;10;110
"903";"360050389005";26;14;14;7;15;76
"904";"360050390001";19;4;107;10;14;154
"905";"360050390002";24;33;55;15;8;135
"906";"360050391001";268;11;31;1;5;316
"907";"360050391002";98;9;33;5;11;156
"908";"360050391003";34;39;15;37;11;136
"909";"360050391004";33;98;9;0;21;161
"910";"360050391005";23;2;2;1;10;38
"911";"360050391006";33;9;3;0;13;58
"912";"360050392001";4;4;24;3;8;43
"913";"360050392002";15;28;46;3;13;105
"914";"360050393001";138;19;12;0;15;184
"915";"360050393002";152;35;5;14;6;212
"916";"360050393003";13;6;6;2;4;31
"917";"360050393004";43;5;13;4;9;74
"918";"360050393005";5;5;9;0;2;21
"919";"360050393006";60;34;35;12;3;144
"920";"360050394001";75;2;7;0;4;88
"921";"360050394002";71;3;87;0;13;174
"922";"360050394003";0;2;5;3;1;11
"923";"360050394004";55;0;58;6;4;123
"924";"360050395001";31;12;51;44;12;150
"925";"360050395002";38;21;33;22;7;121
"926";"360050395003";11;5;65;27;13;121
"927";"360050395004";51;21;57;50;21;200
"928";"360050396001";81;3;73;3;14;174
"929";"360050396002";44;5;33;2;6;90
"930";"360050396003";66;11;67;2;12;158
"931";"360050396004";47;6;67;2;10;132
"932";"360050397001";32;29;11;14;34;120
"933";"360050397002";96;25;6;1;50;178
"934";"360050398001";30;3;43;3;11;90
"935";"360050398002";15;3;21;15;12;66
"936";"360050398003";27;2;26;0;5;60
"937";"360050399011";40;26;3;0;7;76
"938";"360050399012";22;9;11;1;7;50
"939";"360050399013";36;7;21;2;5;71
"940";"360050399014";35;13;2;1;7;58
"941";"360050399015";50;22;19;8;11;110
"942";"360050399021";53;5;25;0;22;105
"943";"360050399022";26;28;1;0;4;59
"944";"360050399023";61;51;8;3;14;137
"945";"360050399024";27;3;0;0;3;33
"946";"360050399025";36;3;13;1;5;58
"947";"360050401001";83;12;0;0;9;104
"948";"360050401002";47;33;14;0;14;108
"949";"360050401003";134;8;8;0;10;160
"950";"360050401004";22;1;2;0;4;29
"951";"360050401005";110;71;1;0;14;196
"952";"360050403021";326;35;2;0;17;380
"953";"360050403022";3;6;2;0;4;15
"954";"360050403023";33;11;13;0;2;59
"955";"360050403031";120;44;45;8;5;222
"956";"360050403032";107;11;128;2;5;253
"957";"360050403033";37;13;8;0;3;61
"958";"360050403041";27;121;8;3;6;165
"959";"360050403042";148;67;5;0;7;227
"960";"360050403043";52;4;14;0;12;82
"961";"360050404001";22;3;88;2;10;125
"962";"360050404002";8;8;40;2;1;59
"963";"360050404003";9;0;35;4;3;51
"964";"360050405011";147;28;11;3;10;199
"965";"360050405012";5;1;10;3;4;23
"966";"360050405013";64;10;16;3;15;108
"967";"360050405021";33;27;10;0;4;74
"968";"360050405022";10;10;11;0;6;37
"969";"360050405023";27;23;41;0;5;96
"970";"360050405024";38;16;15;2;7;78
"971";"360050405025";18;5;9;1;4;37
"972";"360050405026";26;3;49;2;5;85
"973";"360050406001";232;42;44;13;8;339
"974";"360050406002";38;8;37;2;12;97
"975";"360050406003";20;5;19;4;13;61
"976";"360050407011";29;16;16;4;8;73
"977";"360050407012";583;8;3;0;3;597
"978";"360050407013";158;28;6;0;4;196
"979";"360050407021";28;7;3;0;5;43
"980";"360050407022";48;60;69;0;14;191
"981";"360050407023";62;15;11;2;11;101
"982";"360050407024";38;3;28;1;14;84
"983";"360050407025";15;2;20;3;2;42
"984";"360050408001";69;7;20;4;3;103
"985";"360050408002";178;31;27;2;3;241
"986";"360050408003";64;10;16;0;3;93
"987";"360050408004";31;11;71;2;10;125
"988";"360050409001";25;27;77;7;62;198
"989";"360050409002";20;24;14;13;7;78
"990";"360050411001";67;6;17;6;2;98
"991";"360050411002";81;4;20;0;12;117
"992";"360050411003";62;11;28;6;15;122
"993";"360050413001";89;39;82;1;20;231
"994";"360050413002";24;42;6;1;5;78
"995";"360050413003";66;31;23;0;4;124
"996";"360050413004";72;1;6;2;2;83
"997";"360050413005";51;10;14;0;3;78
"998";"360050413006";37;12;50;1;6;106
"999";"360050413007";97;10;16;4;6;133
"1000";"360050414001";30;5;50;28;12;125
"1001";"360050414002";28;12;80;19;17;156
"1002";"360050414003";54;2;44;9;13;122
"1003";"360050414004";99;36;64;44;42;285
"1004";"360050415001";60;7;75;1;2;145
"1005";"360050415002";91;4;58;1;1;155
"1006";"360050415003";27;3;24;0;4;58
"1007";"360050415004";20;2;15;1;2;40
"1008";"360050415005";26;5;18;1;1;51
"1009";"360050415006";98;6;23;1;6;134
"1010";"360050418001";23;23;35;12;18;111
"1011";"360050418002";20;11;45;16;20;112
"1012";"360050418003";39;5;22;7;9;82
"1013";"360050418004";8;0;25;2;12;47
"1014";"360050419001";17;8;70;1;4;100
"1015";"360050419002";41;9;22;1;14;87
"1016";"360050419003";43;3;7;0;14;67
"1017";"360050419004";73;10;27;2;10;122
"1018";"360050419005";16;14;14;0;5;49
"1019";"360050419006";31;6;7;0;5;49
"1020";"360050419007";46;9;55;0;1;111
"1021";"360050420001";31;3;22;1;6;63
"1022";"360050420002";99;10;48;1;5;163
"1023";"360050420003";39;3;55;0;9;106
"1024";"360050421001";5;1;9;1;5;21
"1025";"360050421002";197;24;4;1;4;230
"1026";"360050421003";25;8;4;0;8;45
"1027";"360050421004";67;29;26;0;5;127
"1028";"360050421005";60;10;2;0;1;73
"1029";"360050422001";42;7;134;19;22;224
"1030";"360050422002";32;5;41;3;8;89
"1031";"360050423001";66;35;8;1;2;112
"1032";"360050423002";30;9;140;2;12;193
"1033";"360050423003";49;11;31;0;6;97
"1034";"360050424001";16;0;43;5;4;68
"1035";"360050424002";16;3;63;5;6;93
"1036";"360050425001";10;5;10;0;5;30
"1037";"360050425002";72;17;56;2;5;152
"1038";"360050425003";78;39;61;1;20;199
"1039";"360050425004";27;1;34;0;4;66
"1040";"360050425005";31;16;18;5;21;91
"1041";"360050425006";12;8;14;1;4;39
"1042";"360050425007";145;132;36;2;12;327
"1043";"360050426001";39;39;90;15;25;208
"1044";"360050426002";57;5;80;13;10;165
"1045";"360050426003";18;10;48;39;3;118
"1046";"360050426004";12;2;33;16;0;63
"1047";"360050426005";16;2;26;3;4;51
"1048";"360050426006";9;2;49;7;5;72
"1049";"360050428001";11;10;29;17;4;71
"1050";"360050428002";14;2;19;42;3;80
"1051";"360050429011";236;19;139;1;12;407
"1052";"360050429012";51;7;66;1;7;132
"1053";"360050429013";17;14;51;0;1;83
"1054";"360050429021";242;26;124;1;21;414
"1055";"360050429022";49;14;61;2;7;133
"1056";"360050429023";33;2;80;3;1;119
"1057";"360050430001";20;0;16;5;8;49
"1058";"360050430002";5;0;14;11;14;44
"1059";"360050430003";27;0;53;20;2;102
"1060";"360050431001";17;3;0;0;0;20
"1061";"360050431002";33;8;4;0;3;48
"1062";"360050431003";64;0;5;1;3;73
"1063";"360050431004";51;17;20;1;6;95
"1064";"360050431005";298;19;21;0;14;352
"1065";"360050431006";91;26;13;0;6;136
"1066";"360050431007";107;16;12;1;18;154
"1067";"360050431008";36;7;25;1;10;79
"1068";"360050434001";31;42;70;35;23;201
"1069";"360050434002";51;7;41;6;16;121
"1070";"360050434003";47;1;25;3;10;86
"1071";"360050434004";67;15;62;10;20;174
"1072";"360050435001";106;45;70;16;87;324
"1073";"360050436001";68;6;29;23;5;131
"1074";"360050436002";26;13;94;6;12;151
"1075";"360050442001";113;8;3;9;9;142
"1076";"360050442002";22;0;23;9;3;57
"1077";"360050442003";12;0;19;30;0;61
"1078";"360050442004";24;4;69;39;8;144
"1079";"360050442005";9;6;23;7;7;52
"1080";"360050444001";10;6;40;8;11;75
"1081";"360050444002";13;4;19;6;4;46
"1082";"360050444003";41;1;41;15;2;100
"1083";"360050444004";15;4;47;19;2;87
"1084";"360050448001";16;2;39;33;7;97
"1085";"360050448002";5;1;20;5;3;34
"1086";"360050449011";4;0;41;9;0;54
"1087";"360050449012";3;0;71;22;4;100
"1088";"360050449021";17;10;75;10;9;121
"1089";"360050449022";16;7;61;8;10;102
"1090";"360050451011";15;6;178;5;21;225
"1091";"360050451012";22;1;51;4;16;94
"1092";"360050451021";16;4;62;15;8;105
"1093";"360050451022";37;8;75;7;16;143
"1094";"360050456001";27;6;35;26;8;102
"1095";"360050456002";24;3;68;28;17;140
"1096";"360050456003";11;0;15;12;4;42
"1097";"360050458001";15;2;1;2;5;25
"1098";"360050458002";152;15;0;0;3;170
"1099";"360050458003";5;2;0;0;0;7
"1100";"360050458004";260;12;8;2;6;288
"1101";"360050460001";64;6;59;2;10;141
"1102";"360050460002";10;6;22;10;5;53
"1103";"360050462011";5;3;35;11;5;59
"1104";"360050462012";1;0;1;0;0;2
"1105";"360050462013";9;9;34;3;3;58
"1106";"360050462014";5;0;15;1;0;21
"1107";"360050462015";12;0;4;0;1;17
"1108";"360050462016";14;1;11;5;1;32
"1109";"360050462017";0;1;3;0;0;4
"1110";"360050462018";1;0;23;0;0;24
"1111";"360050462019";0;0;8;1;0;9
"1112";"360050462021";20;10;72;117;14;233
"1113";"360050462022";12;8;105;39;8;172
"1114";"360050462023";31;19;57;29;8;144
"1115";"360050462024";4;2;28;15;5;54
"1116";"360050462025";15;2;38;20;10;85
"1117";"360050462026";7;1;10;7;0;25
"1118";"360050484001";5;4;33;7;3;52
"1119";"360050484002";20;47;159;153;43;422
"1120";"360050484003";19;0;18;8;5;50
"1121";"360050484004";19;2;53;14;0;88
"1122";"360050504001";0;2;4;1;0;7
"1123";"360050516001";14;75;103;21;16;229
"1124";"360050516002";28;11;84;31;16;170
"1125";"360050516003";8;21;64;30;27;150
"1126";"360050516004";36;50;132;26;19;263
"1127";"360470001001";2;15;30;2;2;51
"1128";"360470001002";6;8;5;1;0;20
"1129";"360470001003";16;19;29;6;24;94
"1130";"360470001004";5;15;9;0;1;30
"1131";"360470002001";3;39;102;33;49;226
"1132";"360470003011";2;2;4;0;2;10
"1133";"360470003012";5;9;6;0;2;22
"1134";"360470003013";6;20;5;1;4;36
"1135";"360470003014";2;8;29;0;3;42
"1136";"360470003015";7;26;4;0;1;38
"1137";"360470005011";20;16;41;3;9;89
"1138";"360470005012";8;9;10;1;0;28
"1139";"360470005013";6;11;10;2;6;35
"1140";"360470005021";16;6;8;5;5;40
"1141";"360470005022";12;45;12;4;12;85
"1142";"360470007001";5;22;48;4;8;87
"1143";"360470007002";15;8;20;3;1;47
"1144";"360470007003";11;6;12;9;8;46
"1145";"360470009001";25;85;61;15;26;212
"1146";"360470009002";4;14;16;7;7;48
"1147";"360470011001";2;59;97;1;39;198
"1148";"360470013001";11;91;79;5;20;206
"1149";"360470013002";3;1;5;1;1;11
"1150";"360470015001";39;53;46;3;17;158
"1151";"360470015002";148;6;13;1;21;189
"1152";"360470015003";16;50;104;2;21;193
"1153";"360470018001";20;11;158;50;28;267
"1154";"360470020001";5;10;48;6;12;81
"1155";"360470020002";5;5;80;8;11;109
"1156";"360470021001";12;71;104;3;11;201
"1157";"360470021002";5;23;116;4;19;167
"1158";"360470021003";44;79;112;4;25;264
"1159";"360470022001";37;11;203;8;27;286
"1160";"360470022002";20;11;27;3;10;71
"1161";"360470022003";31;16;126;36;12;221
"1162";"360470023001";30;6;3;0;2;41
"1163";"360470023002";87;6;4;0;8;105
"1164";"360470023003";391;27;16;2;8;444
"1165";"360470029011";4042;4;7;0;1;4054
"1166";"360470029012";84;4;12;0;6;106
"1167";"360470030001";14;3;93;14;14;138
"1168";"360470030002";22;0;39;1;8;70
"1169";"360470031001";13;17;19;1;1;51
"1170";"360470031002";1;3;7;0;0;11
"1171";"360470031003";0;2;6;0;1;9
"1172";"360470033001";4;11;16;6;5;42
"1173";"360470033002";64;48;81;4;45;242
"1174";"360470034001";15;7;30;10;15;77
"1175";"360470034002";9;9;102;7;17;144
"1176";"360470034003";5;3;119;1;5;133
"1177";"360470035001";3;23;46;3;24;99
"1178";"360470035002";11;26;17;0;4;58
"1179";"360470036001";18;2;157;1;11;189
"1180";"360470036002";49;8;174;1;6;238
"1181";"360470036003";3;0;278;10;6;297
"1182";"360470037001";26;138;147;2;35;348
"1183";"360470038001";5;6;447;7;16;481
"1184";"360470039001";14;20;47;7;26;114
"1185";"360470039002";41;19;40;0;19;119
"1186";"360470039003";12;20;67;5;40;144
"1187";"360470041001";40;57;123;3;26;249
"1188";"360470041002";8;15;23;9;12;67
"1189";"360470041003";7;9;48;7;9;80
"1190";"360470043001";0;2;2;2;0;6
"1191";"360470043002";0;5;64;4;1;74
"1192";"360470043003";16;18;24;4;9;71
"1193";"360470043004";21;31;83;9;24;168
"1194";"360470044001";6;23;70;10;13;122
"1195";"360470044002";20;2;82;4;2;110
"1196";"360470045001";1;15;45;5;11;77
"1197";"360470045002";4;3;19;2;0;28
"1198";"360470045003";8;4;17;5;1;35
"1199";"360470045004";3;5;39;3;1;51
"1200";"360470046001";7;7;88;17;7;126
"1201";"360470047001";14;20;41;8;35;118
"1202";"360470049001";13;6;121;6;6;152
"1203";"360470049002";13;1;9;8;2;33
"1204";"360470049003";3;2;13;0;5;23
"1205";"360470050001";15;2;41;3;1;62
"1206";"360470050002";3;3;44;2;4;56
"1207";"360470050003";9;1;52;5;12;79
"1208";"360470051001";0;18;30;6;5;59
"1209";"360470051002";1;6;36;10;8;61
"1210";"360470051003";15;3;71;11;23;123
"1211";"360470052011";6;2;47;4;5;64
"1212";"360470052021";13;3;9;0;7;32
"1213";"360470052022";31;2;57;6;5;101
"1214";"360470053001";18;66;159;43;31;317
"1215";"360470053002";22;11;39;12;23;107
"1216";"360470053003";31;8;47;12;12;110
"1217";"360470053004";12;11;34;5;17;79
"1218";"360470054001";22;5;61;3;6;97
"1219";"360470054002";8;2;61;4;3;78
"1220";"360470054003";10;21;45;7;20;103
"1221";"360470056011";3;3;36;26;18;86
"1222";"360470056012";22;13;114;5;13;167
"1223";"360470056021";32;31;178;6;9;256
"1224";"360470058001";27;35;36;4;16;118
"1225";"360470058002";13;20;137;11;29;210
"1226";"360470058003";9;1;10;1;1;22
"1227";"360470059001";155;91;31;5;7;289
"1228";"360470059002";12;9;80;50;24;175
"1229";"360470060001";44;10;24;3;21;102
"1230";"360470060002";8;23;39;7;11;88
"1231";"360470060003";9;11;24;3;41;88
"1232";"360470062001";22;37;13;1;17;90
"1233";"360470062002";28;156;11;3;13;211
"1234";"360470062003";22;35;33;3;3;96
"1235";"360470063001";7;1;16;2;7;33
"1236";"360470063002";2;3;5;1;6;17
"1237";"360470064001";32;24;75;2;15;148
"1238";"360470064002";8;1;55;8;15;87
"1239";"360470064003";17;48;55;3;20;143
"1240";"360470065001";3;4;9;3;10;29
"1241";"360470065002";2;3;12;3;6;26
"1242";"360470065003";7;1;14;1;4;27
"1243";"360470065004";5;4;8;14;9;40
"1244";"360470065005";5;1;4;1;4;15
"1245";"360470065006";10;4;36;10;6;66
"1246";"360470065007";3;2;5;7;10;27
"1247";"360470066001";3;53;95;13;14;178
"1248";"360470066002";45;56;46;2;9;158
"1249";"360470066003";56;23;254;8;24;365
"1250";"360470067001";2;5;2;8;5;22
"1251";"360470067002";2;12;5;0;2;21
"1252";"360470067003";2;2;11;2;7;24
"1253";"360470067004";20;12;65;1;3;101
"1254";"360470067005";6;4;6;0;14;30
"1255";"360470068001";13;7;19;4;18;61
"1256";"360470068002";117;12;28;3;15;175
"1257";"360470068003";0;5;76;1;11;93
"1258";"360470068004";18;12;30;2;14;76
"1259";"360470069001";10;14;7;4;6;41
"1260";"360470069002";12;11;25;6;9;63
"1261";"360470069003";10;31;33;6;5;85
"1262";"360470069004";11;17;14;3;10;55
"1263";"360470070001";1;0;41;8;12;62
"1264";"360470070002";9;4;43;0;7;63
"1265";"360470071001";4;5;13;1;0;23
"1266";"360470071002";10;9;30;4;10;63
"1267";"360470071003";38;11;7;2;2;60
"1268";"360470071004";120;11;4;3;4;142
"1269";"360470072001";67;4;46;15;26;158
"1270";"360470074001";21;15;86;1;18;141
"1271";"360470074002";73;2;7;1;15;98
"1272";"360470074003";29;42;17;1;19;108
"1273";"360470074004";9;2;15;2;6;34
"1274";"360470075001";5;19;13;4;12;53
"1275";"360470075002";4;26;14;4;1;49
"1276";"360470075003";5;13;52;6;12;88
"1277";"360470075004";11;3;7;5;5;31
"1278";"360470075005";3;15;35;4;3;60
"1279";"360470076001";36;60;12;0;35;143
"1280";"360470076002";34;12;11;1;24;82
"1281";"360470076003";30;8;33;1;19;91
"1282";"360470077001";4;4;35;5;9;57
"1283";"360470077002";7;15;161;11;13;207
"1284";"360470077003";19;31;29;8;15;102
"1285";"360470077004";6;21;13;12;23;75
"1286";"360470078001";25;16;23;1;14;79
"1287";"360470078002";24;10;5;2;17;58
"1288";"360470078003";47;25;18;3;20;113
"1289";"360470078004";34;8;6;2;18;68
"1290";"360470080001";79;36;24;0;23;162
"1291";"360470080002";54;23;15;1;24;117
"1292";"360470080003";16;0;9;4;16;45
"1293";"360470082001";21;18;8;6;21;74
"1294";"360470082002";27;8;19;4;3;61
"1295";"360470082003";27;11;6;9;8;61
"1296";"360470084001";7;36;50;1;13;107
"1297";"360470084002";14;21;17;0;14;66
"1298";"360470084003";6;15;25;3;16;65
"1299";"360470085001";137;39;2;2;15;195
"1300";"360470085002";32;10;4;3;3;52
"1301";"360470085003";46;20;4;3;2;75
"1302";"360470086001";9;277;14;2;22;324
"1303";"360470088001";50;62;32;11;22;177
"1304";"360470088002";33;13;34;6;16;102
"1305";"360470090001";14;14;63;5;24;120
"1306";"360470090002";32;6;125;3;21;187
"1307";"360470092001";95;13;22;1;23;154
"1308";"360470092002";141;7;54;0;38;240
"1309";"360470092003";16;8;7;3;16;50
"1310";"360470094001";11;1;33;0;21;66
"1311";"360470094002";9;11;63;1;13;97
"1312";"360470094003";26;15;33;6;24;104
"1313";"360470096001";27;5;40;4;37;113
"1314";"360470096002";18;6;26;0;13;63
"1315";"360470096003";42;7;103;7;10;169
"1316";"360470096004";21;47;33;2;34;137
"1317";"360470098001";11;13;29;3;13;69
"1318";"360470098002";9;23;77;2;28;139
"1319";"360470098003";27;2;49;0;26;104
"1320";"360470098004";15;53;25;3;29;125
"1321";"360470100001";11;9;8;1;26;55
"1322";"360470100002";12;4;18;1;21;56
"1323";"360470100003";5;7;14;0;16;42
"1324";"360470100004";38;59;11;2;47;157
"1325";"360470101001";40;37;40;14;38;169
"1326";"360470101002";13;17;76;13;13;132
"1327";"360470101003";20;24;39;11;10;104
"1328";"360470102001";9;10;56;4;53;132
"1329";"360470102002";8;12;17;1;20;58
"1330";"360470102003";19;44;18;3;17;101
"1331";"360470104001";10;13;121;0;31;175
"1332";"360470104002";28;2;36;6;11;83
"1333";"360470104003";15;6;68;0;29;118
"1334";"360470106001";8;6;96;4;46;160
"1335";"360470106002";12;4;41;2;16;75
"1336";"360470106003";36;1;46;0;35;118
"1337";"360470108001";18;13;46;8;21;106
"1338";"360470108002";12;1;86;7;10;116
"1339";"360470108003";12;5;82;7;37;143
"1340";"360470110001";6;8;130;23;17;184
"1341";"360470110002";55;11;240;9;27;342
"1342";"360470112001";41;8;141;16;15;221
"1343";"360470112002";10;3;17;1;5;36
"1344";"360470112003";3;3;39;0;5;50
"1345";"360470112004";58;6;29;1;17;111
"1346";"360470114001";1;5;39;0;10;55
"1347";"360470114002";9;75;92;7;7;190
"1348";"360470114003";2;3;50;0;10;65
"1349";"360470116001";5;12;76;3;12;108
"1350";"360470116002";15;3;40;1;19;78
"1351";"360470116003";6;9;39;3;15;72
"1352";"360470117001";13;4;53;12;13;95
"1353";"360470117002";4;9;37;8;22;80
"1354";"360470117003";26;27;56;6;18;133
"1355";"360470118001";12;7;28;1;20;68
"1356";"360470118002";1;2;88;5;26;122
"1357";"360470119001";11;53;94;10;21;189
"1358";"360470119002";16;1013;85;29;38;1181
"1359";"360470119003";10;17;100;6;32;165
"1360";"360470120001";13;10;164;10;51;248
"1361";"360470121001";17;16;81;37;35;186
"1362";"360470121002";8;7;40;21;44;120
"1363";"360470122001";39;9;26;4;38;116
"1364";"360470122002";19;20;61;2;17;119
"1365";"360470122003";26;74;198;5;38;341
"1366";"360470126001";44;10;30;1;19;104
"1367";"360470126002";3;11;27;5;6;52
"1368";"360470126003";8;13;71;2;16;110
"1369";"360470127001";63;35;65;8;19;190
"1370";"360470127002";47;26;56;18;16;163
"1371";"360470127003";83;13;11;1;1;109
"1372";"360470128011";51;94;105;3;26;279
"1373";"360470129011";20;14;85;12;13;144
"1374";"360470129012";48;92;45;2;14;201
"1375";"360470129013";4;6;31;6;6;53
"1376";"360470129021";2;28;52;3;10;95
"1377";"360470129022";17;231;136;4;8;396
"1378";"360470129023";19;16;16;4;7;62
"1379";"360470130001";4;4;28;5;8;49
"1380";"360470130002";15;2;26;10;17;70
"1381";"360470130003";6;7;27;8;24;72
"1382";"360470130004";22;6;73;4;24;129
"1383";"360470131001";10;22;36;5;10;83
"1384";"360470131002";22;11;14;1;6;54
"1385";"360470131003";8;20;6;9;7;50
"1386";"360470131004";28;19;12;1;8;68
"1387";"360470132001";6;0;22;0;13;41
"1388";"360470132002";5;3;100;7;37;152
"1389";"360470133001";16;17;20;2;2;57
"1390";"360470133002";8;16;28;2;13;67
"1391";"360470133003";6;6;22;3;6;43
"1392";"360470133004";8;1;25;2;11;47
"1393";"360470134001";40;66;124;14;23;267
"1394";"360470134002";46;9;57;4;17;133
"1395";"360470134003";10;17;47;4;11;89
"1396";"360470135001";27;25;19;1;3;75
"1397";"360470135002";6;56;37;18;19;136
"1398";"360470135003";14;32;54;4;17;121
"1399";"360470136001";5;7;59;7;23;101
"1400";"360470136002";22;2;56;5;16;101
"1401";"360470136003";27;8;34;1;8;78
"1402";"360470136004";9;4;39;3;13;68
"1403";"360470137001";5;40;10;3;11;69
"1404";"360470137002";12;62;26;8;11;119
"1405";"360470137003";20;35;77;6;46;184
"1406";"360470138001";17;16;66;4;25;128
"1407";"360470138002";6;5;9;3;11;34
"1408";"360470138003";13;7;25;1;13;59
"1409";"360470139001";21;5;16;2;8;52
"1410";"360470139002";100;12;15;2;8;137
"1411";"360470139003";4;4;0;5;13;26
"1412";"360470139004";4;4;11;4;40;63
"1413";"360470140001";6;0;39;5;6;56
"1414";"360470140002";6;6;49;3;17;81
"1415";"360470141001";17;16;41;4;6;84
"1416";"360470141002";15;7;35;11;15;83
"1417";"360470141003";41;10;29;10;7;97
"1418";"360470142001";40;13;52;7;22;134
"1419";"360470142002";9;6;18;0;8;41
"1420";"360470142003";74;38;21;0;12;145
"1421";"360470143001";13;17;37;5;26;98
"1422";"360470143002";22;13;44;8;24;111
"1423";"360470143003";13;8;34;2;14;71
"1424";"360470145001";44;36;87;7;13;187
"1425";"360470145002";27;12;21;7;19;86
"1426";"360470145003";31;25;53;14;10;133
"1427";"360470145004";27;13;19;4;12;75
"1428";"360470147001";10;17;39;4;11;81
"1429";"360470147002";45;11;45;2;11;114
"1430";"360470148001";2;3;13;1;7;26
"1431";"360470148002";1;2;22;2;6;33
"1432";"360470149001";10;2;19;4;7;42
"1433";"360470149002";23;16;32;13;3;87
"1434";"360470149003";4;4;9;2;3;22
"1435";"360470149004";9;16;29;3;5;62
"1436";"360470149005";7;13;25;1;5;51
"1437";"360470150001";5;0;20;4;10;39
"1438";"360470150002";13;8;28;10;4;63
"1439";"360470151001";3;0;16;4;10;33
"1440";"360470151002";24;4;8;4;3;43
"1441";"360470151003";19;7;21;1;8;56
"1442";"360470151004";7;6;7;1;5;26
"1443";"360470152001";7;2;19;10;6;44
"1444";"360470152002";6;0;11;10;2;29
"1445";"360470152003";6;4;31;9;11;61
"1446";"360470153001";3;2;76;0;4;85
"1447";"360470153002";8;8;10;2;22;50
"1448";"360470153003";13;3;14;14;16;60
"1449";"360470153004";0;1;16;1;11;29
"1450";"360470154001";1;14;15;4;1;35
"1451";"360470155001";6;10;9;1;5;31
"1452";"360470155002";8;1;6;1;2;18
"1453";"360470155003";7;30;49;0;5;91
"1454";"360470155004";4;9;21;5;2;41
"1455";"360470157001";4;7;28;6;3;48
"1456";"360470157002";11;5;7;3;6;32
"1457";"360470157003";4;8;33;3;3;51
"1458";"360470157004";2;11;4;1;4;22
"1459";"360470159001";12;17;33;4;17;83
"1460";"360470159002";4;3;16;3;5;31
"1461";"360470159003";7;12;20;3;6;48
"1462";"360470159004";6;4;23;1;5;39
"1463";"360470159005";5;6;4;0;7;22
"1464";"360470160001";12;0;15;10;10;47
"1465";"360470160002";26;15;33;2;9;85
"1466";"360470160003";10;5;34;14;8;71
"1467";"360470160004";27;63;56;13;25;184
"1468";"360470161001";66;57;118;9;5;255
"1469";"360470161002";8;31;66;4;3;112
"1470";"360470161003";42;122;81;18;17;280
"1471";"360470162001";15;3;25;4;11;58
"1472";"360470162002";5;2;99;10;33;149
"1473";"360470163001";24;14;34;8;12;92
"1474";"360470163002";9;13;33;6;9;70
"1475";"360470163003";81;6;37;3;13;140
"1476";"360470164001";0;1;8;2;4;15
"1477";"360470165001";8;3;21;2;4;38
"1478";"360470165002";13;4;15;3;11;46
"1479";"360470165003";11;11;22;6;1;51
"1480";"360470165004";14;9;7;3;4;37
"1481";"360470166001";11;3;15;7;4;40
"1482";"360470166002";3;7;14;6;7;37
"1483";"360470167001";9;2;21;5;5;42
"1484";"360470167002";4;5;22;4;7;42
"1485";"360470167003";28;6;19;2;7;62
"1486";"360470167004";16;13;96;7;13;145
"1487";"360470168001";58;3;273;9;16;359
"1488";"360470169001";1;4;6;0;9;20
"1489";"360470169002";16;23;8;1;6;54
"1490";"360470169003";12;20;10;3;8;53
"1491";"360470169004";17;15;13;1;8;54
"1492";"360470169005";19;16;22;2;4;63
"1493";"360470170001";3;1;19;4;8;35
"1494";"360470170002";4;15;116;3;14;152
"1495";"360470170003";3;1;111;5;7;127
"1496";"360470171001";3;3;34;7;4;51
"1497";"360470171002";4;0;11;1;0;16
"1498";"360470171003";4;2;9;0;5;20
"1499";"360470171004";5;2;16;2;5;30
"1500";"360470172001";16;1;78;4;13;112
"1501";"360470172002";33;9;56;16;25;139
"1502";"360470174001";5;41;57;12;13;128
"1503";"360470174002";11;2;38;5;7;63
"1504";"360470175001";8;5;12;5;3;33
"1505";"360470176001";4;0;59;5;6;74
"1506";"360470176002";21;2;64;16;8;111
"1507";"360470177001";31;183;81;28;56;379
"1508";"360470178001";8;36;32;4;13;93
"1509";"360470178002";22;2;184;10;18;236
"1510";"360470179001";7;0;10;1;0;18
"1511";"360470179002";282;40;83;3;3;411
"1512";"360470179003";24;33;35;2;2;96
"1513";"360470180001";14;2;63;6;12;97
"1514";"360470180002";20;7;64;8;7;106
"1515";"360470181001";27;23;12;0;8;70
"1516";"360470181002";2;2;8;2;0;14
"1517";"360470181003";19;31;28;3;15;96
"1518";"360470181004";11;18;23;7;2;61
"1519";"360470182001";12;10;48;8;20;98
"1520";"360470182002";9;4;65;6;22;106
"1521";"360470183001";11;50;24;7;13;105
"1522";"360470183002";95;51;13;9;8;176
"1523";"360470183003";16;10;38;2;15;81
"1524";"360470184001";3;0;83;10;7;103
"1525";"360470184002";1;0;51;9;9;70
"1526";"360470185011";6;60;13;1;3;83
"1527";"360470185012";54;5;39;1;4;103
"1528";"360470185013";71;4;8;0;6;89
"1529";"360470185014";29;6;0;0;1;36
"1530";"360470186001";2;0;53;1;20;76
"1531";"360470186002";15;0;33;3;6;57
"1532";"360470187001";29;50;57;4;21;161
"1533";"360470188001";5;6;54;6;19;90
"1534";"360470188002";9;3;160;4;35;211
"1535";"360470190001";7;1;134;5;16;163
"1536";"360470190002";27;4;78;2;18;129
"1537";"360470190003";3;10;107;4;23;147
"1538";"360470191001";67;88;90;6;23;274
"1539";"360470191002";16;14;36;6;9;81
"1540";"360470191003";25;46;36;2;10;119
"1541";"360470192001";8;0;61;1;6;76
"1542";"360470192002";10;103;72;19;135;339
"1543";"360470193001";30;47;40;6;14;137
"1544";"360470193002";28;8;19;4;9;68
"1545";"360470193003";5;4;8;0;1;18
"1546";"360470193004";13;28;5;0;1;47
"1547";"360470194001";9;6;61;20;16;112
"1548";"360470194002";67;0;98;10;10;185
"1549";"360470194003";5;1;47;28;10;91
"1550";"360470195001";12;51;38;0;5;106
"1551";"360470195002";31;46;24;4;4;109
"1552";"360470195003";5;10;8;4;1;28
"1553";"360470195004";9;11;22;5;1;48
"1554";"360470196001";15;2;95;9;14;135
"1555";"360470196002";2;2;37;5;25;71
"1556";"360470196003";12;2;24;0;22;60
"1557";"360470197001";7;12;46;5;1;71
"1558";"360470197002";23;34;19;8;8;92
"1559";"360470197003";12;13;33;1;7;66
"1560";"360470197004";2;33;15;5;10;65
"1561";"360470198001";4;4;28;2;13;51
"1562";"360470198002";10;1;68;10;12;101
"1563";"360470199001";12;12;25;6;9;64
"1564";"360470199002";83;35;13;0;12;143
"1565";"360470199003";32;114;33;2;18;199
"1566";"360470199004";48;2;19;3;3;75
"1567";"360470200001";4;2;47;3;9;65
"1568";"360470200002";3;9;67;1;25;105
"1569";"360470201001";17;22;17;2;9;67
"1570";"360470201002";45;113;20;6;15;199
"1571";"360470201003";83;27;10;2;21;143
"1572";"360470201004";44;13;18;3;4;82
"1573";"360470202001";1;4;41;5;19;70
"1574";"360470202002";4;3;92;2;15;116
"1575";"360470203001";56;164;159;22;21;422
"1576";"360470203002";11;10;19;2;7;49
"1577";"360470204001";21;15;100;5;22;163
"1578";"360470204002";1;3;76;7;12;99
"1579";"360470205001";20;23;108;4;9;164
"1580";"360470205002";51;93;54;8;9;215
"1581";"360470205003";16;31;16;11;11;85
"1582";"360470206001";12;2;23;2;23;62
"1583";"360470206002";10;1;66;3;37;117
"1584";"360470207001";56;74;22;9;5;166
"1585";"360470207002";22;74;29;1;7;133
"1586";"360470207003";2;4;25;5;4;40
"1587";"360470208001";1;0;87;0;7;95
"1588";"360470208002";2;1;93;3;15;114
"1589";"360470208003";9;4;64;2;29;108
"1590";"360470210001";7;2;97;5;19;130
"1591";"360470210002";0;1;62;3;27;93
"1592";"360470210003";6;3;22;1;15;47
"1593";"360470211001";1;5;36;1;2;45
"1594";"360470211002";23;17;163;23;23;249
"1595";"360470212001";25;9;77;5;23;139
"1596";"360470212002";15;1;25;0;14;55
"1597";"360470212003";10;5;99;3;11;128
"1598";"360470213001";28;30;4;1;5;68
"1599";"360470213002";72;15;8;2;7;104
"1600";"360470213003";39;6;6;4;2;57
"1601";"360470214001";3;4;51;35;8;101
"1602";"360470214002";7;13;53;5;4;82
"1603";"360470215001";36;100;32;3;3;174
"1604";"360470215002";41;38;15;0;11;105
"1605";"360470215003";55;29;12;0;13;109
"1606";"360470215004";23;39;10;1;9;82
"1607";"360470216001";3;0;50;1;0;54
"1608";"360470216002";0;0;49;6;3;58
"1609";"360470216003";15;8;51;7;14;95
"1610";"360470217001";100;27;36;2;11;176
"1611";"360470217002";81;138;25;1;12;257
"1612";"360470218001";4;3;19;2;5;33
"1613";"360470218002";0;0;19;5;2;26
"1614";"360470218003";7;5;48;2;9;71
"1615";"360470219001";19;30;3;2;10;64
"1616";"360470219002";31;8;17;0;6;62
"1617";"360470219003";25;30;41;5;10;111
"1618";"360470220001";1;2;11;3;6;23
"1619";"360470220002";8;15;24;0;5;52
"1620";"360470220003";5;1;12;0;3;21
"1621";"360470220004";2;1;74;6;10;93
"1622";"360470221001";50;21;12;11;13;107
"1623";"360470221002";119;97;45;8;40;309
"1624";"360470221003";15;14;8;2;7;46
"1625";"360470222001";5;4;14;4;6;33
"1626";"360470222002";1;8;17;4;3;33
"1627";"360470222003";12;7;56;3;11;89
"1628";"360470224001";5;2;50;1;8;66
"1629";"360470224002";6;2;19;2;2;31
"1630";"360470224003";43;7;123;0;6;179
"1631";"360470224004";12;5;184;1;10;212
"1632";"360470226001";33;16;78;37;30;194
"1633";"360470226002";18;12;94;8;18;150
"1634";"360470227001";58;82;19;2;32;193
"1635";"360470227002";26;210;66;13;17;332
"1636";"360470227003";91;65;28;11;14;209
"1637";"360470227004";77;49;44;3;21;194
"1638";"360470228001";17;13;56;5;17;108
"1639";"360470228002";0;29;34;10;0;73
"1640";"360470228003";1;6;45;10;5;67
"1641";"360470229001";81;27;22;3;10;143
"1642";"360470229002";50;8;26;2;12;98
"1643";"360470229003";14;38;52;3;10;117
"1644";"360470229004";64;13;12;6;5;100
"1645";"360470230001";3;4;18;5;1;31
"1646";"360470230002";2;1;15;0;3;21
"1647";"360470230003";2;6;40;29;7;84
"1648";"360470231001";70;57;68;1;15;211
"1649";"360470231002";94;38;74;12;21;239
"1650";"360470231003";38;38;14;10;15;115
"1651";"360470232001";1;2;62;3;5;73
"1652";"360470232002";4;1;31;0;4;40
"1653";"360470232003";1;0;9;1;8;19
"1654";"360470232004";0;2;10;1;6;19
"1655";"360470232005";3;5;84;0;4;96
"1656";"360470233001";42;63;42;2;17;166
"1657";"360470233002";325;31;19;4;3;382
"1658";"360470233003";89;76;66;8;43;282
"1659";"360470234001";0;3;37;0;3;43
"1660";"360470234002";13;3;38;1;3;58
"1661";"360470234003";8;2;37;4;4;55
"1662";"360470235001";97;81;159;12;28;377
"1663";"360470235002";29;8;56;56;13;162
"1664";"360470236001";0;2;48;0;8;58
"1665";"360470236002";7;9;14;2;3;35
"1666";"360470236003";3;0;26;0;4;33
"1667";"360470236004";7;7;66;2;4;86
"1668";"360470238001";0;2;22;2;1;27
"1669";"360470238002";15;1;42;20;5;83
"1670";"360470238003";1;1;19;7;7;35
"1671";"360470240001";2;1;29;3;2;37
"1672";"360470240002";3;2;29;2;12;48
"1673";"360470240003";23;1;13;28;6;71
"1674";"360470241001";67;174;371;30;64;706
"1675";"360470241002";25;16;35;6;17;99
"1676";"360470242001";6;0;51;34;2;93
"1677";"360470242002";0;1;39;7;7;54
"1678";"360470243001";75;36;26;11;16;164
"1679";"360470243002";138;15;26;1;11;191
"1680";"360470243003";54;14;20;3;12;103
"1681";"360470244001";11;5;58;3;17;94
"1682";"360470244002";4;5;125;5;5;144
"1683";"360470244003";2;5;73;17;11;108
"1684";"360470245001";24;4;30;34;13;105
"1685";"360470245002";95;38;14;3;14;164
"1686";"360470245003";53;7;9;0;3;72
"1687";"360470245004";24;16;19;0;5;64
"1688";"360470246001";7;4;35;3;4;53
"1689";"360470246002";6;2;91;2;10;111
"1690";"360470246003";6;12;121;6;5;150
"1691";"360470247001";41;56;20;3;12;132
"1692";"360470247002";58;29;27;7;34;155
"1693";"360470248001";3;2;37;1;11;54
"1694";"360470248002";21;32;91;10;48;202
"1695";"360470249001";46;24;9;12;9;100
"1696";"360470249002";76;8;18;3;10;115
"1697";"360470249003";35;1059;19;4;6;1123
"1698";"360470249004";8;4;8;2;6;28
"1699";"360470250001";2;6;102;25;29;164
"1700";"360470250002";2;17;80;4;3;106
"1701";"360470251001";53;42;29;10;14;148
"1702";"360470251002";98;22;14;1;5;140
"1703";"360470251003";75;46;15;1;14;151
"1704";"360470252001";6;1;34;0;6;47
"1705";"360470252002";64;5;48;2;6;125
"1706";"360470252003";20;3;154;1;2;180
"1707";"360470252004";15;2;61;3;5;86
"1708";"360470253001";28;8;35;4;8;83
"1709";"360470253002";46;11;29;1;10;97
"1710";"360470253003";86;12;23;6;15;142
"1711";"360470254001";3;2;17;2;4;28
"1712";"360470254002";7;2;49;1;6;65
"1713";"360470254003";42;0;66;0;14;122
"1714";"360470255001";74;6;5;1;4;90
"1715";"360470255002";147;4;3;0;14;168
"1716";"360470256001";8;1;76;2;18;105
"1717";"360470256002";9;3;40;1;11;64
"1718";"360470257001";23;8;44;3;12;90
"1719";"360470257002";22;14;67;5;9;117
"1720";"360470257003";10;16;36;11;15;88
"1721";"360470258001";10;0;146;13;18;187
"1722";"360470258002";26;3;57;3;12;101
"1723";"360470258003";19;1;49;12;12;93
"1724";"360470259011";166;111;74;11;16;378
"1725";"360470259021";129;3;13;6;2;153
"1726";"360470260001";16;1;23;0;8;48
"1727";"360470260002";3;3;30;3;5;44
"1728";"360470260003";160;1;29;0;5;195
"1729";"360470261001";81;85;64;2;11;243
"1730";"360470261002";50;9;12;4;10;85
"1731";"360470261003";86;31;16;12;10;155
"1732";"360470261004";52;8;23;4;7;94
"1733";"360470261005";24;13;16;7;9;69
"1734";"360470262001";27;11;86;6;23;153
"1735";"360470262002";5;10;89;4;17;125
"1736";"360470263001";104;96;30;10;14;254
"1737";"360470264001";4;14;34;6;12;70
"1738";"360470264002";11;0;163;24;30;228
"1739";"360470264003";12;11;72;1;14;110
"1740";"360470264004";7;9;16;3;16;51
"1741";"360470265001";104;3;21;5;3;136
"1742";"360470265002";142;26;31;4;22;225
"1743";"360470265003";18;13;43;8;6;88
"1744";"360470265004";35;9;10;4;9;67
"1745";"360470266001";4;4;47;10;7;72
"1746";"360470266002";15;2;48;1;4;70
"1747";"360470266003";15;1;29;0;9;54
"1748";"360470267001";19;23;8;1;6;57
"1749";"360470267002";16;44;8;0;17;85
"1750";"360470267003";10;23;30;0;9;72
"1751";"360470267004";21;26;9;3;9;68
"1752";"360470268001";18;2;13;1;5;39
"1753";"360470268002";10;0;20;3;10;43
"1754";"360470268003";2;1;64;0;8;75
"1755";"360470268004";5;0;13;1;2;21
"1756";"360470269001";42;57;12;2;18;131
"1757";"360470269002";13;2;8;13;10;46
"1758";"360470269003";48;25;25;2;13;113
"1759";"360470270001";1;2;64;2;4;73
"1760";"360470270002";26;4;106;2;7;145
"1761";"360470271001";49;15;71;31;22;188
"1762";"360470271002";16;18;51;9;7;101
"1763";"360470272001";2;0;37;0;1;40
"1764";"360470272002";27;5;11;6;5;54
"1765";"360470272003";8;1;33;4;1;47
"1766";"360470273001";11;15;10;4;5;45
"1767";"360470273002";36;8;64;3;3;114
"1768";"360470273003";33;17;11;6;14;81
"1769";"360470274001";13;0;58;7;5;83
"1770";"360470274002";5;16;80;6;9;116
"1771";"360470275001";21;13;19;4;17;74
"1772";"360470275002";29;10;14;4;7;64
"1773";"360470275003";60;245;14;0;8;327
"1774";"360470275004";75;66;28;1;10;180
"1775";"360470276001";76;5;20;0;4;105
"1776";"360470276002";2;2;39;3;28;74
"1777";"360470276003";20;7;62;30;15;134
"1778";"360470277001";39;9;5;2;1;56
"1779";"360470277002";43;8;12;6;13;82
"1780";"360470277003";38;20;23;5;5;91
"1781";"360470277004";73;5;8;1;15;102
"1782";"360470278001";56;9;46;2;10;123
"1783";"360470278002";37;6;48;4;17;112
"1784";"360470279001";42;27;15;4;9;97
"1785";"360470279002";15;21;22;1;4;63
"1786";"360470279003";61;18;48;4;12;143
"1787";"360470279004";63;32;18;6;8;127
"1788";"360470280001";15;0;53;12;5;85
"1789";"360470280002";17;12;69;4;11;113
"1790";"360470281001";49;11;33;6;5;104
"1791";"360470281002";19;6;28;6;7;66
"1792";"360470281003";72;70;65;7;19;233
"1793";"360470282001";4;1;46;5;6;62
"1794";"360470282002";29;2;53;11;12;107
"1795";"360470282003";0;0;24;3;3;30
"1796";"360470283001";30;9;37;2;10;88
"1797";"360470283002";34;4;84;2;2;126
"1798";"360470283003";29;20;19;8;7;83
"1799";"360470284001";20;0;87;0;9;116
"1800";"360470284002";22;8;127;2;10;169
"1801";"360470284003";28;0;40;1;10;79
"1802";"360470285011";11;9;43;0;15;78
"1803";"360470285021";97;21;38;1;4;161
"1804";"360470286001";34;5;1;2;2;44
"1805";"360470286002";29;3;27;9;3;71
"1806";"360470286003";5;1;0;0;2;8
"1807";"360470286004";5;1;78;0;13;97
"1808";"360470286005";10;0;34;4;5;53
"1809";"360470287001";33;125;25;13;44;240
"1810";"360470287002";22;6;40;9;9;86
"1811";"360470287003";72;11;8;8;12;111
"1812";"360470288001";20;0;27;4;10;61
"1813";"360470288002";5;5;12;13;20;55
"1814";"360470288003";12;1;26;0;10;49
"1815";"360470289001";22;64;18;5;19;128
"1816";"360470289002";48;13;17;7;14;99
"1817";"360470289003";32;47;11;4;5;99
"1818";"360470289004";79;18;26;10;10;143
"1819";"360470290001";42;2;25;1;0;70
"1820";"360470290002";41;2;33;2;7;85
"1821";"360470290003";23;5;64;1;34;127
"1822";"360470291001";53;56;32;6;18;165
"1823";"360470291002";45;20;43;5;9;122
"1824";"360470291003";111;14;14;5;4;148
"1825";"360470292001";5;2;46;8;6;67
"1826";"360470292002";10;1;99;0;16;126
"1827";"360470293001";55;8;2;2;3;70
"1828";"360470293002";34;9;2;0;4;49
"1829";"360470293003";23;8;21;5;12;69
"1830";"360470293004";7;5;20;1;10;43
"1831";"360470294001";17;8;41;1;15;82
"1832";"360470295001";53;13;31;0;7;104
"1833";"360470295002";39;15;5;1;10;70
"1834";"360470295003";18;13;5;6;8;50
"1835";"360470295004";62;3;20;2;1;88
"1836";"360470296001";24;0;66;8;13;111
"1837";"360470296002";23;8;67;2;18;118
"1838";"360470296003";6;3;97;5;12;123
"1839";"360470296004";9;3;95;0;7;114
"1840";"360470297001";7;27;39;1;15;89
"1841";"360470297002";85;72;33;7;6;203
"1842";"360470297003";13;4;27;10;8;62
"1843";"360470298001";7;4;80;3;13;107
"1844";"360470298002";8;40;79;0;7;134
"1845";"360470298003";2;3;27;8;6;46
"1846";"360470299001";6;0;24;5;10;45
"1847";"360470299002";40;27;15;13;9;104
"1848";"360470300001";5;38;134;0;16;193
"1849";"360470300002";6;17;63;11;12;109
"1850";"360470301001";9;4;21;14;11;59
"1851";"360470301002";14;3;16;1;9;43
"1852";"360470301003";14;17;41;19;15;106
"1853";"360470302001";0;0;90;2;5;97
"1854";"360470302002";23;3;42;2;3;73
"1855";"360470302003";6;11;52;1;9;79
"1856";"360470303001";122;9;47;4;8;190
"1857";"360470303002";34;8;29;17;8;96
"1858";"360470303003";129;17;32;8;21;207
"1859";"360470304001";3;2;119;25;13;162
"1860";"360470304002";21;11;135;0;4;171
"1861";"360470304003";22;2;32;23;2;81
"1862";"360470305001";92;511;316;142;45;1106
"1863";"360470305002";151;96;46;6;23;322
"1864";"360470305003";40;72;28;15;10;165
"1865";"360470305004";96;44;14;8;16;178
"1866";"360470306001";6;10;120;10;19;165
"1867";"360470307001";57;2;9;2;1;71
"1868";"360470307002";50;5;11;3;2;71
"1869";"360470307003";99;42;108;34;39;322
"1870";"360470308001";68;21;99;10;17;215
"1871";"360470309001";37;10;27;2;9;85
"1872";"360470309002";12;1;50;15;7;85
"1873";"360470311001";34;10;41;6;19;110
"1874";"360470311002";44;96;38;8;11;197
"1875";"360470311003";45;17;18;1;8;89
"1876";"360470313001";26;7;9;11;14;67
"1877";"360470313002";32;3;7;6;10;58
"1878";"360470313003";95;51;16;3;21;186
"1879";"360470313004";11;12;42;0;6;71
"1880";"360470314001";16;6;40;3;6;71
"1881";"360470314002";7;4;78;22;4;115
"1882";"360470314003";13;12;10;1;1;37
"1883";"360470314004";82;2;68;14;14;180
"1884";"360470315001";85;150;76;1;20;332
"1885";"360470315002";99;31;18;2;11;161
"1886";"360470315003";95;78;23;1;20;217
"1887";"360470315004";88;144;15;6;22;275
"1888";"360470317011";88;38;66;4;20;216
"1889";"360470317012";43;121;18;5;8;195
"1890";"360470317013";33;15;44;5;21;118
"1891";"360470317021";41;8;9;1;4;63
"1892";"360470317022";40;20;5;1;10;76
"1893";"360470317023";120;28;44;4;9;205
"1894";"360470319001";97;19;35;5;7;163
"1895";"360470319002";5;26;11;0;8;50
"1896";"360470319003";91;9;26;36;11;173
"1897";"360470321001";21;28;8;3;18;78
"1898";"360470321002";45;41;11;0;9;106
"1899";"360470321003";137;72;9;6;4;228
"1900";"360470321004";82;21;16;3;12;134
"1901";"360470323001";73;34;16;0;8;131
"1902";"360470323002";77;12;14;1;9;113
"1903";"360470323003";23;11;23;3;12;72
"1904";"360470325001";32;69;7;0;71;179
"1905";"360470325002";77;14;18;1;9;119
"1906";"360470325003";27;4;13;15;12;71
"1907";"360470326001";9;11;41;6;27;94
"1908";"360470326002";65;23;10;0;21;119
"1909";"360470326003";79;68;4;0;4;155
"1910";"360470326004";16;15;5;7;5;48
"1911";"360470326005";12;2;53;10;5;82
"1912";"360470327001";32;33;9;5;8;87
"1913";"360470327002";110;12;22;18;17;179
"1914";"360470327003";27;16;8;0;7;58
"1915";"360470328001";19;1;23;2;10;55
"1916";"360470328002";2;2;11;2;2;19
"1917";"360470328003";51;3;0;3;7;64
"1918";"360470328004";65;3;10;2;7;87
"1919";"360470329001";52;12;14;4;2;84
"1920";"360470329002";67;21;11;3;2;104
"1921";"360470329003";56;149;9;0;9;223
"1922";"360470329004";52;45;9;4;8;118
"1923";"360470330001";35;0;0;6;4;45
"1924";"360470330002";3;0;3;2;0;8
"1925";"360470330003";61;22;6;9;0;98
"1926";"360470331001";112;14;15;3;5;149
"1927";"360470331002";62;15;10;2;2;91
"1928";"360470331003";11;1;56;1;1;70
"1929";"360470333001";42;4;13;0;4;63
"1930";"360470333002";22;4;48;4;1;79
"1931";"360470333003";43;5;15;10;3;76
"1932";"360470335001";12;7;52;1;3;75
"1933";"360470335002";8;5;26;4;1;44
"1934";"360470335003";9;8;65;27;2;111
"1935";"360470336001";4;2;7;3;9;25
"1936";"360470336002";2;3;1;0;7;13
"1937";"360470336003";0;1;1;0;0;2
"1938";"360470336004";21;1;0;1;4;27
"1939";"360470336005";17;6;0;0;5;28
"1940";"360470337001";32;7;13;15;3;70
"1941";"360470337002";29;11;20;5;9;74
"1942";"360470337003";37;15;55;2;19;128
"1943";"360470339001";65;9;31;3;9;117
"1944";"360470339002";67;86;29;12;7;201
"1945";"360470339003";14;17;11;1;3;46
"1946";"360470339004";20;8;12;6;4;50
"1947";"360470340001";31;5;12;0;6;54
"1948";"360470340002";0;11;1;2;0;14
"1949";"360470341001";27;16;9;5;2;59
"1950";"360470341002";89;13;12;3;6;123
"1951";"360470341003";70;11;11;4;7;103
"1952";"360470342001";65;17;5;2;4;93
"1953";"360470342002";109;10;12;0;7;138
"1954";"360470342003";70;4;13;0;12;99
"1955";"360470342004";4;4;0;0;0;8
"1956";"360470343001";150;5;6;3;11;175
"1957";"360470343002";9;8;36;4;9;66
"1958";"360470343003";89;125;18;31;14;277
"1959";"360470345001";49;14;28;4;9;104
"1960";"360470345002";18;52;61;19;5;155
"1961";"360470347001";20;8;15;0;1;44
"1962";"360470347002";51;6;27;3;2;89
"1963";"360470347003";90;30;35;5;11;171
"1964";"360470348001";15;11;259;121;25;431
"1965";"360470348002";31;3;64;20;65;183
"1966";"360470349001";52;77;8;2;7;146
"1967";"360470349002";41;7;11;0;7;66
"1968";"360470349003";43;41;135;3;13;235
"1969";"360470349004";28;8;8;0;2;46
"1970";"360470350001";1;8;0;2;2;13
"1971";"360470350002";3;24;23;5;30;85
"1972";"360470351001";73;141;41;2;6;263
"1973";"360470351002";82;21;13;1;14;131
"1974";"360470351003";51;20;29;6;12;118
"1975";"360470352001";6;51;15;2;25;99
"1976";"360470353001";49;17;69;3;5;143
"1977";"360470353002";76;37;13;5;8;139
"1978";"360470353003";129;28;23;2;16;198
"1979";"360470354001";3;1;38;12;16;70
"1980";"360470354002";31;1;20;5;4;61
"1981";"360470354003";4;6;2;1;5;18
"1982";"360470355001";168;16;52;5;18;259
"1983";"360470355002";23;9;24;0;5;61
"1984";"360470355003";62;17;15;0;16;110
"1985";"360470356011";0;2;19;14;1;36
"1986";"360470356021";15;1;15;1;2;34
"1987";"360470356022";10;1;23;6;3;43
"1988";"360470356023";29;3;18;2;3;55
"1989";"360470357001";112;38;33;6;14;203
"1990";"360470359001";27;18;59;10;18;132
"1991";"360470359002";29;5;18;5;4;61
"1992";"360470359003";66;17;30;8;16;137
"1993";"360470359004";218;40;20;0;8;286
"1994";"360470360011";5;18;1;0;12;36
"1995";"360470360012";9;4;22;0;9;44
"1996";"360470360013";5;3;15;1;8;32
"1997";"360470360021";54;19;15;1;8;97
"1998";"360470360022";22;20;5;0;31;78
"1999";"360470361001";19;7;36;3;4;69
"2000";"360470361002";9;7;23;20;9;68
"2001";"360470361003";22;8;11;11;3;55
"2002";"360470362001";60;95;141;4;48;348
"2003";"360470362002";23;7;70;3;16;119
"2004";"360470362003";5;5;55;1;16;82
"2005";"360470363001";32;2;10;4;13;61
"2006";"360470363002";16;13;54;7;13;103
"2007";"360470363003";33;13;31;9;12;98
"2008";"360470363004";27;5;17;4;0;53
"2009";"360470364001";9;6;117;7;35;174
"2010";"360470364002";19;13;109;18;26;185
"2011";"360470365011";44;5;19;4;5;77
"2012";"360470365012";33;4;62;11;11;121
"2013";"360470365021";20;24;105;67;33;249
"2014";"360470366001";16;12;40;42;18;128
"2015";"360470366002";20;4;43;2;18;87
"2016";"360470366003";39;1;67;3;7;117
"2017";"360470367001";19;14;53;31;8;125
"2018";"360470367002";2;1;18;14;5;40
"2019";"360470369001";69;25;34;17;6;151
"2020";"360470369002";37;25;27;17;13;119
"2021";"360470369003";87;27;20;15;15;164
"2022";"360470369004";128;5;71;6;23;233
"2023";"360470370001";9;5;48;11;9;82
"2024";"360470370002";5;7;29;8;4;53
"2025";"360470370003";3;2;88;2;4;99
"2026";"360470370004";2;0;18;3;8;31
"2027";"360470371001";8;5;26;2;12;53
"2028";"360470371002";19;8;15;5;5;52
"2029";"360470371003";30;0;36;5;5;76
"2030";"360470371004";28;4;49;3;8;92
"2031";"360470371005";7;11;14;2;6;40
"2032";"360470373001";19;5;8;3;9;44
"2033";"360470373002";17;7;18;6;5;53
"2034";"360470373003";30;49;8;8;8;103
"2035";"360470373004";42;26;22;5;20;115
"2036";"360470374011";25;1;79;9;20;134
"2037";"360470374012";18;1;46;5;12;82
"2038";"360470374013";28;4;24;2;7;65
"2039";"360470374021";9;14;73;12;13;121
"2040";"360470374022";18;46;13;8;6;91
"2041";"360470374023";18;7;2;0;1;28
"2042";"360470374024";0;1;70;14;4;89
"2043";"360470375001";21;15;6;2;4;48
"2044";"360470375002";23;10;30;1;20;84
"2045";"360470375003";36;18;11;5;12;82
"2046";"360470377001";16;8;27;23;9;83
"2047";"360470377002";39;31;17;21;8;116
"2048";"360470377003";38;4;11;3;0;56
"2049";"360470377004";82;4;38;8;7;139
"2050";"360470379001";35;33;23;3;5;99
"2051";"360470379002";26;17;102;7;8;160
"2052";"360470379003";32;12;40;29;21;134
"2053";"360470381001";31;8;20;3;9;71
"2054";"360470381002";60;7;0;0;5;72
"2055";"360470381003";25;34;21;7;7;94
"2056";"360470381004";27;22;8;5;8;70
"2057";"360470382001";54;3;44;2;7;110
"2058";"360470382002";83;4;19;0;9;115
"2059";"360470382003";39;1;1;0;2;43
"2060";"360470383001";91;22;18;8;13;152
"2061";"360470383002";52;13;13;5;14;97
"2062";"360470383003";30;8;17;0;10;65
"2063";"360470383004";18;6;8;3;6;41
"2064";"360470385001";14;17;21;2;12;66
"2065";"360470385002";16;12;21;5;2;56
"2066";"360470385003";54;28;28;3;8;121
"2067";"360470385004";27;13;63;7;7;117
"2068";"360470386001";28;4;119;89;28;268
"2069";"360470386002";6;9;54;17;33;119
"2070";"360470387001";23;20;26;6;14;89
"2071";"360470387002";16;3;17;1;5;42
"2072";"360470387003";33;6;45;1;5;90
"2073";"360470387004";22;13;24;2;16;77
"2074";"360470388001";6;2;25;3;5;41
"2075";"360470388002";6;0;40;7;6;59
"2076";"360470388003";17;3;57;8;11;96
"2077";"360470388004";6;0;30;9;7;52
"2078";"360470389001";42;40;29;22;17;150
"2079";"360470389002";36;27;23;2;16;104
"2080";"360470389003";22;119;22;2;17;182
"2081";"360470390001";17;2;74;14;16;123
"2082";"360470390002";6;0;15;4;9;34
"2083";"360470391001";54;11;30;15;12;122
"2084";"360470391002";210;36;61;13;36;356
"2085";"360470392001";10;2;31;14;7;64
"2086";"360470392002";73;1;33;11;4;122
"2087";"360470393001";51;11;51;10;23;146
"2088";"360470393002";34;11;55;7;24;131
"2089";"360470393003";60;27;39;3;36;165
"2090";"360470394001";23;10;32;1;4;70
"2091";"360470394002";2;3;44;5;3;57
"2092";"360470394003";0;3;30;6;7;46
"2093";"360470395001";56;12;30;10;12;120
"2094";"360470395002";57;18;25;3;17;120
"2095";"360470395003";16;85;39;6;14;160
"2096";"360470396001";4;5;34;25;3;71
"2097";"360470396002";7;5;27;8;9;56
"2098";"360470397001";67;14;51;2;10;144
"2099";"360470397002";25;280;43;6;13;367
"2100";"360470397003";70;20;41;0;13;144
"2101";"360470398001";10;19;88;51;23;191
"2102";"360470398002";12;3;22;37;7;81
"2103";"360470399001";74;12;88;3;14;191
"2104";"360470399002";86;27;40;2;30;185
"2105";"360470399003";25;7;21;1;13;67
"2106";"360470400001";16;2;45;31;17;111
"2107";"360470400002";4;2;31;1;6;44
"2108";"360470400003";3;5;25;6;10;49
"2109";"360470401001";28;6;13;2;7;56
"2110";"360470401002";148;18;24;4;7;201
"2111";"360470401003";79;8;63;10;14;174
"2112";"360470402001";11;8;72;27;7;125
"2113";"360470402002";4;8;76;8;20;116
"2114";"360470403001";46;9;35;11;13;114
"2115";"360470403002";46;11;26;2;18;103
"2116";"360470403003";25;15;12;2;11;65
"2117";"360470404001";0;3;115;9;7;134
"2118";"360470404002";4;9;27;16;8;64
"2119";"360470405001";17;19;93;61;18;208
"2120";"360470405002";11;9;12;4;11;47
"2121";"360470406001";45;11;72;9;7;144
"2122";"360470406002";6;0;38;3;2;49
"2123";"360470406003";60;3;34;5;5;107
"2124";"360470407001";0;0;3;6;0;9
"2125";"360470408001";5;1;23;2;12;43
"2126";"360470408002";8;6;33;2;8;57
"2127";"360470408003";2;8;27;4;7;48
"2128";"360470409001";114;24;38;14;13;203
"2129";"360470409002";55;115;145;94;16;425
"2130";"360470409003";31;12;51;0;12;106
"2131";"360470410001";12;2;104;4;20;142
"2132";"360470410002";1;1;60;18;5;85
"2133";"360470411001";40;23;25;4;10;102
"2134";"360470411002";39;6;37;9;13;104
"2135";"360470411003";23;3;36;2;4;68
"2136";"360470412001";7;11;69;6;14;107
"2137";"360470412002";11;4;315;15;17;362
"2138";"360470413001";44;7;21;7;5;84
"2139";"360470413002";59;22;30;8;13;132
"2140";"360470413003";40;26;34;3;16;119
"2141";"360470414011";7;2;12;3;5;29
"2142";"360470414012";0;1;29;7;6;43
"2143";"360470414021";224;6;15;5;2;252
"2144";"360470414022";17;0;19;4;2;42
"2145";"360470415001";68;20;78;1;9;176
"2146";"360470415002";86;18;53;19;19;195
"2147";"360470415003";121;0;34;0;7;162
"2148";"360470416001";8;2;70;4;9;93
"2149";"360470416002";13;1;19;3;5;41
"2150";"360470417001";7;5;14;0;3;29
"2151";"360470417002";29;11;22;3;1;66
"2152";"360470417003";88;11;50;4;7;160
"2153";"360470417004";26;31;28;4;6;95
"2154";"360470418001";17;40;33;2;4;96
"2155";"360470418002";14;3;38;7;6;68
"2156";"360470419001";110;20;38;9;12;189
"2157";"360470419002";44;9;32;0;2;87
"2158";"360470419003";39;11;12;8;7;77
"2159";"360470420001";5;6;41;1;14;67
"2160";"360470420002";4;7;34;14;3;62
"2161";"360470421001";56;38;26;16;5;141
"2162";"360470421002";59;47;30;5;17;158
"2163";"360470421003";28;68;12;9;13;130
"2164";"360470421004";29;31;36;15;14;125
"2165";"360470422001";51;4;97;1;4;157
"2166";"360470422002";2;1;88;12;14;117
"2167";"360470422003";12;1;39;4;10;66
"2168";"360470423001";37;39;85;27;18;206
"2169";"360470423002";78;68;91;10;17;264
"2170";"360470423003";106;18;20;5;5;154
"2171";"360470424001";12;43;36;9;10;110
"2172";"360470424002";31;4;50;14;8;107
"2173";"360470424003";22;2;86;3;2;115
"2174";"360470425001";36;37;21;1;11;106
"2175";"360470425002";28;15;19;13;26;101
"2176";"360470425003";26;120;29;18;8;201
"2177";"360470426001";13;5;47;1;2;68
"2178";"360470426002";4;1;97;6;9;117
"2179";"360470426003";3;3;20;9;5;40
"2180";"360470427001";167;84;9;4;24;288
"2181";"360470427002";91;33;51;0;24;199
"2182";"360470427003";130;64;34;4;13;245
"2183";"360470427004";27;30;16;2;16;91
"2184";"360470428001";3;2;78;3;6;92
"2185";"360470428002";15;4;80;0;5;104
"2186";"360470428003";5;3;53;1;6;68
"2187";"360470429001";85;83;32;7;7;214
"2188";"360470429002";177;56;8;1;20;262
"2189";"360470429003";69;133;7;4;28;241
"2190";"360470429004";140;67;12;0;21;240
"2191";"360470430001";8;2;31;0;3;44
"2192";"360470430002";9;6;43;3;1;62
"2193";"360470430003";23;14;75;11;6;129
"2194";"360470431001";52;102;74;2;24;254
"2195";"360470431002";57;58;24;4;16;159
"2196";"360470431003";64;20;19;7;14;124
"2197";"360470431004";66;72;19;4;28;189
"2198";"360470432001";16;3;125;11;9;164
"2199";"360470432002";11;2;59;0;28;100
"2200";"360470432003";2;2;46;1;8;59
"2201";"360470433001";18;18;6;6;4;52
"2202";"360470433002";112;137;20;6;26;301
"2203";"360470433003";66;44;6;13;17;146
"2204";"360470434001";26;5;31;18;13;93
"2205";"360470434002";18;3;58;7;10;96
"2206";"360470434003";24;3;45;2;13;87
"2207";"360470435001";45;34;19;4;16;118
"2208";"360470435002";83;48;37;3;17;188
"2209";"360470435003";36;13;20;10;8;87
"2210";"360470436001";13;5;80;10;3;111
"2211";"360470436002";8;26;19;3;13;69
"2212";"360470436003";19;1;54;6;5;85
"2213";"360470437001";46;5;41;2;6;100
"2214";"360470437002";95;56;20;7;35;213
"2215";"360470437003";95;113;31;3;10;252
"2216";"360470437004";214;76;31;3;9;333
"2217";"360470438001";14;3;31;5;11;64
"2218";"360470438002";17;8;96;17;24;162
"2219";"360470439001";30;45;85;11;24;195
"2220";"360470439002";17;16;91;18;17;159
"2221";"360470439003";31;47;244;14;20;356
"2222";"360470440001";17;1;43;4;3;68
"2223";"360470440002";7;9;129;23;4;172
"2224";"360470440003";7;0;104;19;41;171
"2225";"360470441001";108;157;43;5;26;339
"2226";"360470441002";65;44;75;0;13;197
"2227";"360470441003";331;57;23;2;13;426
"2228";"360470442001";45;3;23;13;7;91
"2229";"360470442002";3;4;32;4;4;47
"2230";"360470443001";25;0;6;4;8;43
"2231";"360470443002";82;46;31;5;17;181
"2232";"360470443003";97;24;29;5;14;169
"2233";"360470443004";36;7;14;1;16;74
"2234";"360470444001";6;1;38;7;6;58
"2235";"360470444002";0;2;61;11;13;87
"2236";"360470444003";27;13;32;10;11;93
"2237";"360470445001";43;17;61;3;17;141
"2238";"360470445002";77;70;52;13;14;226
"2239";"360470445003";53;158;38;5;11;265
"2240";"360470446001";3;3;43;17;12;78
"2241";"360470446002";12;11;83;3;3;112
"2242";"360470447001";81;130;50;6;25;292
"2243";"360470447002";31;78;75;10;40;234
"2244";"360470448001";4;33;35;11;17;100
"2245";"360470448002";16;6;63;6;16;107
"2246";"360470449001";20;44;6;10;5;85
"2247";"360470449002";126;101;5;7;2;241
"2248";"360470449003";60;37;130;20;21;268
"2249";"360470449004";4;350;148;111;33;646
"2250";"360470450001";13;15;80;22;5;135
"2251";"360470452001";6;4;46;6;9;71
"2252";"360470452002";14;0;21;6;14;55
"2253";"360470453001";47;62;87;21;58;275
"2254";"360470453002";75;254;43;18;44;434
"2255";"360470454001";2;6;38;10;11;67
"2256";"360470454002";1;0;29;14;1;45
"2257";"360470456001";5;35;59;11;43;153
"2258";"360470456002";9;1;19;13;10;52
"2259";"360470458001";65;1;68;3;1;138
"2260";"360470458002";2;0;17;12;1;32
"2261";"360470460001";15;5;86;2;4;112
"2262";"360470460002";7;0;49;3;22;81
"2263";"360470460003";2;1;44;16;43;106
"2264";"360470462011";17;1;113;8;6;145
"2265";"360470462012";10;23;267;15;18;333
"2266";"360470462021";0;1;58;10;7;76
"2267";"360470462022";10;8;79;9;21;127
"2268";"360470464001";2;4;40;26;10;82
"2269";"360470464002";12;2;47;2;24;87
"2270";"360470468001";8;23;123;9;17;180
"2271";"360470470001";6;7;50;12;7;82
"2272";"360470470002";0;3;52;3;1;59
"2273";"360470472001";0;0;2;5;0;7
"2274";"360470472002";1;5;13;5;4;28
"2275";"360470472003";2;0;17;1;2;22
"2276";"360470474001";1;3;65;9;5;83
"2277";"360470474002";2;4;22;13;1;42
"2278";"360470476001";4;47;50;27;4;132
"2279";"360470476002";4;1;21;9;0;35
"2280";"360470476003";0;1;68;18;2;89
"2281";"360470477001";65;29;86;20;34;234
"2282";"360470477002";64;96;77;8;25;270
"2283";"360470478001";9;20;57;11;22;119
"2284";"360470478002";2;2;14;6;3;27
"2285";"360470478003";12;9;228;22;25;296
"2286";"360470480001";3;2;64;4;7;80
"2287";"360470480002";5;5;122;41;8;181
"2288";"360470481001";17;7;14;8;16;62
"2289";"360470481002";4;4;34;14;7;63
"2290";"360470481003";55;23;34;2;25;139
"2291";"360470482001";7;4;111;10;17;149
"2292";"360470482002";3;2;82;3;5;95
"2293";"360470482003";40;6;79;22;9;156
"2294";"360470482004";43;5;138;5;78;269
"2295";"360470484001";12;22;94;6;27;161
"2296";"360470484002";10;67;347;3;16;443
"2297";"360470484003";10;5;17;3;5;40
"2298";"360470485001";148;135;140;33;63;519
"2299";"360470485002";166;249;140;12;34;601
"2300";"360470486001";9;38;93;4;16;160
"2301";"360470486002";213;12;33;6;28;292
"2302";"360470486003";10;21;45;8;12;96
"2303";"360470488001";23;8;67;1;18;117
"2304";"360470488002";5;3;131;5;6;150
"2305";"360470488003";11;25;70;18;3;127
"2306";"360470489001";58;4;2;0;2;66
"2307";"360470489002";23;2;3;0;3;31
"2308";"360470489003";69;17;2;0;0;88
"2309";"360470490001";85;23;51;7;4;170
"2310";"360470490002";27;15;90;4;10;146
"2311";"360470490003";23;1;68;2;10;104
"2312";"360470491001";9;31;1;0;3;44
"2313";"360470491002";37;109;10;1;26;183
"2314";"360470491003";121;121;14;2;21;279
"2315";"360470491004";21;7;5;0;2;35
"2316";"360470492001";0;7;53;23;7;90
"2317";"360470492002";18;12;57;15;19;121
"2318";"360470492003";8;11;57;13;4;93
"2319";"360470493001";39;19;4;1;2;65
"2320";"360470493002";105;50;10;5;26;196
"2321";"360470493003";54;36;16;16;15;137
"2322";"360470493004";29;13;6;2;10;60
"2323";"360470493005";23;51;7;8;29;118
"2324";"360470494001";51;37;43;12;6;149
"2325";"360470494002";29;2;45;8;9;93
"2326";"360470494003";17;5;23;1;3;49
"2327";"360470494004";4;0;10;0;3;17
"2328";"360470495001";11;11;11;0;14;47
"2329";"360470495002";26;21;19;4;18;88
"2330";"360470495003";23;46;25;13;15;122
"2331";"360470496001";26;11;57;7;26;127
"2332";"360470496002";6;6;28;10;15;65
"2333";"360470496003";12;5;39;16;12;84
"2334";"360470497001";9;10;24;6;10;59
"2335";"360470497002";14;10;44;9;26;103
"2336";"360470497003";40;4;35;5;16;100
"2337";"360470498001";71;13;62;8;7;161
"2338";"360470498002";23;6;55;12;16;112
"2339";"360470498003";16;7;85;23;17;148
"2340";"360470499001";7;14;12;2;18;53
"2341";"360470499002";38;1;33;6;26;104
"2342";"360470500001";6;0;28;4;4;42
"2343";"360470500002";24;5;17;5;16;67
"2344";"360470500003";22;3;29;3;5;62
"2345";"360470501001";27;4;16;7;7;61
"2346";"360470501002";43;10;21;5;11;90
"2347";"360470501003";23;102;48;17;36;226
"2348";"360470502021";9;5;13;3;7;37
"2349";"360470502022";15;25;63;5;26;134
"2350";"360470503001";17;56;41;11;19;144
"2351";"360470503002";68;23;19;12;48;170
"2352";"360470503003";26;29;19;7;14;95
"2353";"360470504001";5;4;11;3;2;25
"2354";"360470504002";41;23;39;10;11;124
"2355";"360470504003";34;18;79;8;22;161
"2356";"360470505001";58;18;3;2;5;86
"2357";"360470505002";63;47;18;1;18;147
"2358";"360470505003";35;99;12;1;15;162
"2359";"360470506001";83;30;18;0;13;144
"2360";"360470506002";34;17;42;3;21;117
"2361";"360470506003";40;14;7;9;10;80
"2362";"360470506004";47;16;18;7;12;100
"2363";"360470507001";24;5;70;19;46;164
"2364";"360470508011";58;16;4;4;6;88
"2365";"360470508012";94;30;17;0;22;163
"2366";"360470508031";109;47;19;11;19;205
"2367";"360470508041";73;35;39;24;2;173
"2368";"360470508042";94;61;53;26;6;240
"2369";"360470508043";121;24;31;1;10;187
"2370";"360470509001";95;357;40;24;14;530
"2371";"360470509002";1;3;11;6;8;29
"2372";"360470510011";77;5;4;11;3;100
"2373";"360470510012";420;101;14;1;16;552
"2374";"360470510021";61;45;27;2;14;149
"2375";"360470510022";116;63;6;0;4;189
"2376";"360470510023";66;22;8;0;7;103
"2377";"360470511001";70;16;11;4;5;106
"2378";"360470511002";81;104;31;4;15;235
"2379";"360470511003";34;125;34;4;4;201
"2380";"360470512001";47;64;20;11;9;151
"2381";"360470512002";87;26;1;2;4;120
"2382";"360470512003";50;34;17;12;4;117
"2383";"360470512004";31;23;29;8;10;101
"2384";"360470513001";29;206;58;12;31;336
"2385";"360470513002";17;20;9;1;5;52
"2386";"360470513003";95;271;74;4;55;499
"2387";"360470513004";34;82;7;8;9;140
"2388";"360470514001";14;13;59;9;5;100
"2389";"360470514002";93;22;13;16;11;155
"2390";"360470514003";72;36;17;1;13;139
"2391";"360470514004";110;9;24;4;7;154
"2392";"360470515001";40;64;57;10;38;209
"2393";"360470516011";64;11;29;1;7;112
"2394";"360470516012";85;20;33;0;6;144
"2395";"360470516013";165;87;118;3;37;410
"2396";"360470516021";68;45;18;4;7;142
"2397";"360470516022";105;173;50;6;27;361
"2398";"360470517001";33;78;12;1;23;147
"2399";"360470517002";32;134;30;6;58;260
"2400";"360470518001";56;1;36;0;1;94
"2401";"360470518002";25;10;35;6;3;79
"2402";"360470518003";20;11;19;8;4;62
"2403";"360470519001";58;45;46;6;52;207
"2404";"360470519002";44;30;60;8;21;163
"2405";"360470519003";70;75;58;1;34;238
"2406";"360470520001";64;23;46;20;9;162
"2407";"360470520002";19;10;56;6;10;101
"2408";"360470520003";12;2;8;0;7;29
"2409";"360470523001";70;178;11;1;15;275
"2410";"360470523002";41;142;14;4;20;221
"2411";"360470523003";77;47;15;1;12;152
"2412";"360470523004";14;19;3;0;9;45
"2413";"360470523005";25;71;10;0;16;122
"2414";"360470525001";189;64;16;4;31;304
"2415";"360470525002";7;30;13;2;8;60
"2416";"360470526001";15;22;29;22;8;96
"2417";"360470526002";130;12;94;5;18;259
"2418";"360470526003";4;3;35;1;4;47
"2419";"360470527001";37;13;32;4;11;97
"2420";"360470527002";18;28;2;0;10;58
"2421";"360470527003";28;49;14;6;30;127
"2422";"360470527004";13;20;3;0;12;48
"2423";"360470527005";51;42;18;1;4;116
"2424";"360470527006";58;274;20;5;10;367
"2425";"360470527007";7;31;11;0;5;54
"2426";"360470528001";5;4;54;6;1;70
"2427";"360470528002";9;5;64;6;24;108
"2428";"360470529001";0;4;32;9;2;47
"2429";"360470529002";3;15;15;9;8;50
"2430";"360470529003";10;18;20;6;9;63
"2431";"360470530001";40;4;29;2;9;84
"2432";"360470530002";44;6;43;7;18;118
"2433";"360470530003";14;5;61;30;10;120
"2434";"360470531001";11;4;56;10;13;94
"2435";"360470531002";10;3;44;0;3;60
"2436";"360470531003";1;2;6;0;6;15
"2437";"360470531004";0;0;8;0;1;9
"2438";"360470532001";18;9;37;1;5;70
"2439";"360470532002";3;7;65;1;7;83
"2440";"360470533001";0;0;4;3;2;9
"2441";"360470533002";0;0;3;0;4;7
"2442";"360470533003";1;2;41;1;1;46
"2443";"360470533004";12;4;2;0;0;18
"2444";"360470533005";1;11;19;10;0;41
"2445";"360470534001";23;1;47;1;8;80
"2446";"360470534002";18;1;13;3;1;36
"2447";"360470534003";3;12;24;2;5;46
"2448";"360470534004";8;10;27;0;3;48
"2449";"360470535001";4;4;5;2;0;15
"2450";"360470535002";0;2;10;0;2;14
"2451";"360470535003";2;2;25;4;0;33
"2452";"360470535004";3;45;53;4;6;111
"2453";"360470537001";0;0;17;0;0;17
"2454";"360470537002";1;1;36;9;3;50
"2455";"360470538001";15;1;21;1;6;44
"2456";"360470538002";126;4;28;5;10;173
"2457";"360470538003";8;20;77;4;10;119
"2458";"360470539001";0;0;6;0;3;9
"2459";"360470539002";3;1;11;0;1;16
"2460";"360470542001";24;2;65;4;12;107
"2461";"360470542002";35;21;62;9;9;136
"2462";"360470542003";1;2;42;10;3;58
"2463";"360470543001";0;9;36;8;4;57
"2464";"360470543002";25;29;146;56;23;279
"2465";"360470544001";9;3;52;8;3;75
"2466";"360470544002";8;0;117;3;7;135
"2467";"360470544003";2;4;50;2;7;65
"2468";"360470545001";1;1;4;8;1;15
"2469";"360470545002";0;7;2;3;2;14
"2470";"360470545003";66;6;0;0;3;75
"2471";"360470545004";0;0;1;0;0;1
"2472";"360470545005";119;58;11;2;7;197
"2473";"360470545006";57;21;9;0;1;88
"2474";"360470546001";4;16;53;3;1;77
"2475";"360470546002";19;4;94;1;4;122
"2476";"360470546003";13;0;28;15;6;62
"2477";"360470547001";19;31;17;8;5;80
"2478";"360470547002";6;1;72;0;0;79
"2479";"360470547003";21;16;93;3;7;140
"2480";"360470548001";17;3;45;12;3;80
"2481";"360470548002";2;1;43;52;0;98
"2482";"360470549001";22;12;52;0;14;100
"2483";"360470549002";92;233;80;5;29;439
"2484";"360470550001";11;2;89;18;1;121
"2485";"360470550002";8;3;123;89;15;238
"2486";"360470550003";21;4;30;3;11;69
"2487";"360470551001";71;122;77;3;18;291
"2488";"360470551002";29;37;30;4;18;118
"2489";"360470551003";103;100;21;4;14;242
"2490";"360470551004";37;13;4;4;8;66
"2491";"360470552001";14;3;40;1;5;63
"2492";"360470552002";6;17;31;2;8;64
"2493";"360470552003";11;21;50;12;18;112
"2494";"360470553001";71;191;21;10;48;341
"2495";"360470553002";9;30;49;1;20;109
"2496";"360470553003";85;235;55;5;41;421
"2497";"360470554001";11;6;27;2;5;51
"2498";"360470554002";31;5;9;1;8;54
"2499";"360470554003";7;10;47;6;5;75
"2500";"360470555001";286;411;183;23;110;1013
"2501";"360470556001";8;7;58;4;6;83
"2502";"360470556002";4;3;34;2;2;45
"2503";"360470556003";8;1;42;4;6;61
"2504";"360470557001";41;18;49;2;16;126
"2505";"360470557002";63;105;108;33;36;345
"2506";"360470558001";6;0;32;11;13;62
"2507";"360470558002";20;106;70;3;9;208
"2508";"360470560001";3;2;69;25;8;107
"2509";"360470560002";10;2;35;0;4;51
"2510";"360470560003";14;1;14;16;1;46
"2511";"360470561001";54;19;57;15;25;170
"2512";"360470561002";8;1;15;1;12;37
"2513";"360470561003";5;31;40;1;42;119
"2514";"360470561004";13;23;49;8;23;116
"2515";"360470562001";0;1;38;20;3;62
"2516";"360470562002";2;0;77;37;1;117
"2517";"360470563001";43;81;32;9;25;190
"2518";"360470563002";79;249;54;9;30;421
"2519";"360470563003";18;12;54;0;13;97
"2520";"360470563004";28;28;129;6;21;212
"2521";"360470564001";11;1;16;0;1;29
"2522";"360470564002";5;0;37;9;8;59
"2523";"360470564003";6;0;10;19;2;37
"2524";"360470565001";34;87;76;8;39;244
"2525";"360470565002";12;4;20;8;18;62
"2526";"360470565003";32;28;8;4;32;104
"2527";"360470566001";17;3;25;11;23;79
"2528";"360470566002";5;4;27;7;8;51
"2529";"360470568001";0;1;16;5;10;32
"2530";"360470568002";0;1;5;11;2;19
"2531";"360470569001";24;83;14;4;56;181
"2532";"360470569002";7;19;27;2;41;96
"2533";"360470570001";4;4;7;1;1;17
"2534";"360470570002";3;0;2;4;3;12
"2535";"360470570003";0;0;3;0;2;5
"2536";"360470570004";6;8;21;54;13;102
"2537";"360470571001";26;45;19;2;19;111
"2538";"360470571002";7;5;13;0;15;40
"2539";"360470571003";15;5;15;5;35;75
"2540";"360470571004";18;12;21;3;25;79
"2541";"360470572001";116;12;2;8;6;144
"2542";"360470572002";151;7;14;18;12;202
"2543";"360470573001";8;16;36;4;7;71
"2544";"360470573002";16;6;26;4;7;59
"2545";"360470573003";18;5;16;1;12;52
"2546";"360470574001";7;0;40;16;9;72
"2547";"360470574002";1;5;41;13;17;77
"2548";"360470575001";26;7;18;2;18;71
"2549";"360470575002";17;10;21;1;18;67
"2550";"360470575003";11;5;37;11;20;84
"2551";"360470575004";24;28;37;5;22;116
"2552";"360470576001";1;3;37;13;21;75
"2553";"360470576002";6;9;74;14;8;111
"2554";"360470578001";3;4;84;13;17;121
"2555";"360470578002";23;9;39;2;29;102
"2556";"360470579001";28;16;25;0;7;76
"2557";"360470579002";11;11;159;21;25;227
"2558";"360470580001";56;6;42;9;11;124
"2559";"360470580002";19;3;46;3;4;75
"2560";"360470582001";3;1;40;3;4;51
"2561";"360470582002";0;18;57;4;1;80
"2562";"360470582003";56;2;29;2;20;109
"2563";"360470584001";14;2;43;1;3;63
"2564";"360470584002";42;5;60;5;14;126
"2565";"360470586001";6;1;31;4;9;51
"2566";"360470586002";2;2;50;8;6;68
"2567";"360470588001";15;0;58;6;19;98
"2568";"360470588002";23;27;18;4;5;77
"2569";"360470589001";7;2;16;9;13;47
"2570";"360470589002";20;9;45;2;9;85
"2571";"360470590001";10;46;173;7;21;257
"2572";"360470591001";11;0;9;1;17;38
"2573";"360470591002";11;40;21;8;15;95
"2574";"360470591003";3;10;78;11;16;118
"2575";"360470591004";19;44;15;3;25;106
"2576";"360470592001";17;0;34;5;7;63
"2577";"360470592002";11;5;110;32;8;166
"2578";"360470592003";20;1;27;3;10;61
"2579";"360470593001";15;3;30;3;7;58
"2580";"360470593002";56;8;19;3;15;101
"2581";"360470594011";0;1;14;18;4;37
"2582";"360470594012";1;1;90;31;14;137
"2583";"360470594013";6;15;51;32;12;116
"2584";"360470594014";6;7;35;27;20;95
"2585";"360470594015";30;1;22;6;22;81
"2586";"360470594016";130;0;55;7;11;203
"2587";"360470594021";5;25;19;12;11;72
"2588";"360470594022";13;3;70;56;8;150
"2589";"360470594023";0;1;58;16;2;77
"2590";"360470594024";3;0;56;23;2;84
"2591";"360470596001";5;12;13;7;1;38
"2592";"360470596002";1;1;4;3;1;10
"2593";"360470596003";14;3;63;24;12;116
"2594";"360470598001";36;6;37;37;5;121
"2595";"360470598002";15;2;42;12;10;81
"2596";"360470600001";3;3;50;9;18;83
"2597";"360470600002";4;1;110;27;7;149
"2598";"360470600003";5;2;139;180;22;348
"2599";"360470600004";0;2;30;8;14;54
"2600";"360470600005";22;5;40;7;10;84
"2601";"360470606001";76;14;17;2;29;138
"2602";"360470606002";15;0;33;14;16;78
"2603";"360470608001";17;11;42;16;19;105
"2604";"360470608002";22;6;55;24;11;118
"2605";"360470608003";172;9;48;4;15;248
"2606";"360470610021";31;8;57;5;6;107
"2607";"360470610022";48;17;10;0;10;85
"2608";"360470610031";2;5;14;0;12;33
"2609";"360470610032";17;19;31;4;44;115
"2610";"360470610041";5;2;32;5;10;54
"2611";"360470610042";11;1;173;1;4;190
"2612";"360470610043";27;2;101;1;6;137
"2613";"360470610044";95;2;12;1;1;111
"2614";"360470610045";45;3;13;1;13;75
"2615";"360470612001";10;18;36;1;9;74
"2616";"360470616001";14;10;67;5;17;113
"2617";"360470620001";7;19;20;2;9;57
"2618";"360470620002";6;11;22;2;11;52
"2619";"360470622001";58;1;75;33;17;184
"2620";"360470622002";70;3;107;48;35;263
"2621";"360470626001";17;1;42;12;5;77
"2622";"360470626002";8;17;41;54;6;126
"2623";"360470628001";11;6;48;59;17;141
"2624";"360470628002";9;7;92;20;24;152
"2625";"360470628003";4;2;26;15;9;56
"2626";"360470628004";27;2;54;28;12;123
"2627";"360470632001";23;4;39;7;9;82
"2628";"360470632002";3;1;14;3;4;25
"2629";"360470636001";9;1;61;11;7;89
"2630";"360470638001";2;1;31;13;3;50
"2631";"360470638002";1;1;24;10;6;42
"2632";"360470640001";19;1;31;12;2;65
"2633";"360470640002";2;0;38;9;7;56
"2634";"360470642001";33;9;40;34;19;135
"2635";"360470642002";15;0;35;22;7;79
"2636";"360470644001";9;4;37;13;12;75
"2637";"360470644002";7;4;27;29;17;84
"2638";"360470646001";3;5;16;7;6;37
"2639";"360470646002";9;3;70;44;13;139
"2640";"360470648001";37;9;131;89;16;282
"2641";"360470648002";2;3;23;30;8;66
"2642";"360470650001";2;3;29;9;15;58
"2643";"360470650002";18;1;75;68;12;174
"2644";"360470652001";8;244;48;39;28;367
"2645";"360470654001";1;2;72;16;2;93
"2646";"360470654002";31;2;16;13;6;68
"2647";"360470656001";1;21;40;16;13;91
"2648";"360470656002";0;1;15;6;0;22
"2649";"360470658001";7;9;22;4;7;49
"2650";"360470658002";2;4;63;11;18;98
"2651";"360470660001";4;1;40;8;3;56
"2652";"360470660002";8;6;20;6;4;44
"2653";"360470662001";3;10;81;54;16;164
"2654";"360470666001";8;34;38;9;9;98
"2655";"360470670001";4;0;55;35;7;101
"2656";"360470670002";38;8;90;82;23;241
"2657";"360470672001";27;11;62;107;18;225
"2658";"360470674001";7;8;20;43;5;83
"2659";"360470674002";18;7;86;60;6;177
"2660";"360470676001";6;2;34;45;0;87
"2661";"360470676002";9;14;41;54;9;127
"2662";"360470678001";15;0;75;55;15;160
"2663";"360470678002";16;2;60;87;7;172
"2664";"360470680001";20;3;49;56;5;133
"2665";"360470680002";32;59;94;38;9;232
"2666";"360470682001";26;41;59;58;4;188
"2667";"360470682002";42;3;30;66;8;149
"2668";"360470686001";11;0;38;29;10;88
"2669";"360470686002";1;1;51;15;1;69
"2670";"360470688001";13;0;43;55;12;123
"2671";"360470688002";4;5;14;15;10;48
"2672";"360470690001";16;4;49;40;8;117
"2673";"360470690002";49;14;62;82;15;222
"2674";"360470692001";23;8;98;186;11;326
"2675";"360470692002";11;1;68;42;1;123
"2676";"360470696011";52;2;102;31;7;194
"2677";"360470696012";23;9;89;94;23;238
"2678";"360470696021";4;13;70;14;12;113
"2679";"360470696022";44;7;68;161;25;305
"2680";"360470696023";38;7;116;28;22;211
"2681";"360470698001";6;1;14;5;11;37
"2682";"360470698002";8;25;98;51;19;201
"2683";"360470700001";3;1;11;5;4;24
"2684";"360470700002";11;2;65;56;7;141
"2685";"360470702011";2;5;18;19;6;50
"2686";"360470702012";2;2;6;11;1;22
"2687";"360470702013";10;1;58;37;1;107
"2688";"360470702014";6;1;112;29;7;155
"2689";"360470702015";25;6;80;40;26;177
"2690";"360470702021";0;3;8;0;1;12
"2691";"360470706001";8;19;170;31;53;281
"2692";"360470706002";7;38;91;23;32;191
"2693";"360470720001";28;6;57;92;20;203
"2694";"360470722001";13;7;79;78;17;194
"2695";"360470722002";26;2;62;158;12;260
"2696";"360470724001";4;0;39;8;3;54
"2697";"360470724002";9;2;41;85;11;148
"2698";"360470726001";17;8;116;107;40;288
"2699";"360470728001";55;8;62;8;8;141
"2700";"360470728002";7;4;24;53;4;92
"2701";"360470730001";12;7;45;25;6;95
"2702";"360470730002";12;3;27;26;15;83
"2703";"360470732001";25;1;31;10;6;73
"2704";"360470732002";30;3;49;21;9;112
"2705";"360470734001";3;1;26;17;3;50
"2706";"360470734002";6;2;50;17;1;76
"2707";"360470736001";95;4;8;36;1;144
"2708";"360470736002";8;5;18;22;4;57
"2709";"360470736003";14;7;34;30;19;104
"2710";"360470738001";33;10;113;34;11;201
"2711";"360470738002";37;1;154;16;0;208
"2712";"360470738003";24;4;292;29;2;351
"2713";"360470740001";59;13;71;26;14;183
"2714";"360470740002";68;15;75;22;22;202
"2715";"360470742001";14;6;143;8;10;181
"2716";"360470742002";35;5;54;16;11;121
"2717";"360470744001";8;8;71;12;2;101
"2718";"360470744002";1;6;49;5;3;64
"2719";"360470746001";28;6;82;6;10;132
"2720";"360470746002";3;2;65;4;14;88
"2721";"360470748001";12;5;68;13;11;109
"2722";"360470748002";0;0;20;19;5;44
"2723";"360470750001";1;1;57;3;16;78
"2724";"360470750002";180;4;24;14;9;231
"2725";"360470752001";0;1;30;22;2;55
"2726";"360470754001";0;1;19;3;1;24
"2727";"360470754002";1;0;13;7;3;24
"2728";"360470756001";5;1;43;9;22;80
"2729";"360470756002";1;0;20;6;8;35
"2730";"360470758001";6;0;103;16;3;128
"2731";"360470758002";44;2;41;14;5;106
"2732";"360470760001";0;0;17;4;2;23
"2733";"360470760002";14;0;21;1;4;40
"2734";"360470760003";25;2;19;1;5;52
"2735";"360470762001";30;2;16;2;0;50
"2736";"360470762002";14;1;85;1;5;106
"2737";"360470762003";63;6;10;0;2;81
"2738";"360470764001";53;9;62;2;2;128
"2739";"360470764002";20;7;27;2;3;59
"2740";"360470764003";16;14;47;0;2;79
"2741";"360470766001";172;8;82;17;6;285
"2742";"360470768001";8;8;67;16;8;107
"2743";"360470768002";7;1;16;5;9;38
"2744";"360470768003";6;1;59;3;10;79
"2745";"360470770001";13;21;43;11;5;93
"2746";"360470770002";82;30;221;54;24;411
"2747";"360470772001";50;14;123;23;11;221
"2748";"360470772002";47;15;89;47;5;203
"2749";"360470774001";17;6;35;6;12;76
"2750";"360470774002";41;9;35;28;27;140
"2751";"360470776001";14;5;12;10;1;42
"2752";"360470776002";11;4;16;3;0;34
"2753";"360470776003";6;4;52;27;6;95
"2754";"360470780001";14;0;25;7;1;47
"2755";"360470780002";37;2;32;10;3;84
"2756";"360470782001";24;0;29;10;3;66
"2757";"360470782002";159;4;46;2;6;217
"2758";"360470784001";28;1;45;10;10;94
"2759";"360470784002";15;18;53;10;9;105
"2760";"360470786001";36;6;44;7;6;99
"2761";"360470786002";10;7;25;11;19;72
"2762";"360470786003";41;5;69;8;10;133
"2763";"360470788001";40;2;72;5;9;128
"2764";"360470788002";14;2;45;7;6;74
"2765";"360470788003";5;11;47;34;11;108
"2766";"360470790001";61;63;27;20;18;189
"2767";"360470790002";46;21;28;12;14;121
"2768";"360470790003";24;6;25;4;6;65
"2769";"360470790004";12;2;20;40;20;94
"2770";"360470792001";46;49;104;44;12;255
"2771";"360470792002";58;6;30;19;9;122
"2772";"360470792003";39;50;58;53;19;219
"2773";"360470794001";20;58;65;31;31;205
"2774";"360470794002";16;7;26;8;28;85
"2775";"360470796011";51;198;50;3;17;319
"2776";"360470796012";217;18;28;1;14;278
"2777";"360470796021";223;105;53;7;24;412
"2778";"360470796022";125;113;23;18;20;299
"2779";"360470798011";55;47;41;5;8;156
"2780";"360470798012";58;35;78;7;26;204
"2781";"360470798021";51;35;21;4;21;132
"2782";"360470798022";124;148;3;0;29;304
"2783";"360470798023";154;124;19;9;33;339
"2784";"360470800001";60;73;20;2;11;166
"2785";"360470800002";48;17;52;3;29;149
"2786";"360470800003";12;7;33;3;4;59
"2787";"360470802001";130;29;44;7;16;226
"2788";"360470802002";56;13;52;4;13;138
"2789";"360470802003";102;16;34;5;6;163
"2790";"360470804001";61;24;49;5;13;152
"2791";"360470804002";59;32;14;3;2;110
"2792";"360470804003";10;11;43;2;19;85
"2793";"360470806001";57;39;70;5;9;180
"2794";"360470806002";31;3;62;10;6;112
"2795";"360470808001";11;3;38;19;8;79
"2796";"360470810001";113;59;73;8;7;260
"2797";"360470810002";3;16;69;2;3;93
"2798";"360470814001";22;3;45;7;10;87
"2799";"360470814002";56;2;95;11;12;176
"2800";"360470816001";21;1;88;16;14;140
"2801";"360470816002";42;20;57;6;7;132
"2802";"360470818001";199;86;79;1;10;375
"2803";"360470818002";35;5;43;1;3;87
"2804";"360470818003";43;54;62;7;4;170
"2805";"360470820001";122;10;104;2;15;253
"2806";"360470820002";92;20;63;3;6;184
"2807";"360470820003";119;19;52;0;15;205
"2808";"360470822001";51;21;20;1;8;101
"2809";"360470822002";158;95;37;5;6;301
"2810";"360470822003";203;144;60;1;11;419
"2811";"360470822004";49;29;55;1;16;150
"2812";"360470824001";30;3;52;5;13;103
"2813";"360470824002";24;22;29;5;10;90
"2814";"360470824003";20;1;83;24;7;135
"2815";"360470824004";22;19;52;3;16;112
"2816";"360470826001";10;1;44;4;6;65
"2817";"360470826002";13;6;77;18;5;119
"2818";"360470826003";133;88;55;5;20;301
"2819";"360470826004";30;16;42;34;5;127
"2820";"360470828001";45;24;12;2;11;94
"2821";"360470828002";80;16;49;12;8;165
"2822";"360470828003";34;41;82;2;11;170
"2823";"360470830001";77;9;94;13;8;201
"2824";"360470830002";4;0;43;4;13;64
"2825";"360470830003";70;2;19;0;7;98
"2826";"360470830004";54;0;4;1;2;61
"2827";"360470832001";11;1;39;13;6;70
"2828";"360470832002";7;2;33;8;13;63
"2829";"360470834001";3;4;18;5;8;38
"2830";"360470834002";1;1;30;9;6;47
"2831";"360470836001";27;0;46;38;12;123
"2832";"360470836002";5;2;32;20;8;67
"2833";"360470838001";15;12;33;14;2;76
"2834";"360470838002";7;4;45;12;4;72
"2835";"360470840001";62;9;79;54;7;211
"2836";"360470840002";15;4;56;50;12;137
"2837";"360470846001";18;8;34;54;13;127
"2838";"360470846002";21;7;64;46;15;153
"2839";"360470848001";11;0;18;24;10;63
"2840";"360470848002";17;3;28;9;4;61
"2841";"360470850001";5;4;64;97;13;183
"2842";"360470852001";0;2;0;1;1;4
"2843";"360470854001";34;2;33;4;4;77
"2844";"360470854002";4;6;53;19;8;90
"2845";"360470856001";23;15;32;6;6;82
"2846";"360470856002";47;18;20;3;2;90
"2847";"360470856003";35;7;65;4;13;124
"2848";"360470858001";12;5;28;20;4;69
"2849";"360470858002";326;103;47;9;24;509
"2850";"360470860001";42;15;20;1;6;84
"2851";"360470860002";36;20;54;4;17;131
"2852";"360470860003";14;10;19;4;9;56
"2853";"360470862001";17;5;39;8;4;73
"2854";"360470862002";21;5;59;8;18;111
"2855";"360470862003";13;3;15;12;4;47
"2856";"360470864001";56;5;76;56;5;198
"2857";"360470864002";9;1;43;22;8;83
"2858";"360470866001";35;26;103;42;10;216
"2859";"360470866002";22;16;46;4;3;91
"2860";"360470866003";32;8;30;18;11;99
"2861";"360470868001";43;8;41;2;8;102
"2862";"360470868002";51;24;43;12;5;135
"2863";"360470868003";30;25;61;20;13;149
"2864";"360470870001";11;4;40;4;8;67
"2865";"360470870002";16;3;40;6;11;76
"2866";"360470870003";8;1;20;2;3;34
"2867";"360470872001";3;7;20;8;4;42
"2868";"360470872002";8;2;18;7;6;41
"2869";"360470872003";13;3;25;7;5;53
"2870";"360470874011";17;33;83;32;8;173
"2871";"360470874012";28;26;23;5;14;96
"2872";"360470876001";12;18;34;18;6;88
"2873";"360470876002";9;4;29;17;2;61
"2874";"360470878001";36;14;28;4;10;92
"2875";"360470878002";0;1;13;0;4;18
"2876";"360470878003";26;38;40;24;10;138
"2877";"360470880001";23;5;53;15;8;104
"2878";"360470880002";13;13;2;0;0;28
"2879";"360470880003";47;22;31;6;3;109
"2880";"360470882001";119;5;56;5;6;191
"2881";"360470882002";25;2;29;1;25;82
"2882";"360470882003";14;5;26;4;4;53
"2883";"360470882004";26;10;55;10;7;108
"2884";"360470884001";93;13;41;3;15;165
"2885";"360470884002";50;6;32;6;6;100
"2886";"360470884003";24;15;55;9;12;115
"2887";"360470886001";58;3;27;8;4;100
"2888";"360470886002";62;17;24;6;7;116
"2889";"360470886003";61;2;111;11;10;195
"2890";"360470888001";38;14;53;4;16;125
"2891";"360470888002";14;3;33;7;3;60
"2892";"360470888003";11;4;46;20;9;90
"2893";"360470890001";40;10;41;8;6;105
"2894";"360470890002";29;4;16;14;3;66
"2895";"360470890003";14;4;12;5;5;40
"2896";"360470890004";69;4;31;2;6;112
"2897";"360470890005";14;3;17;1;4;39
"2898";"360470890006";18;2;11;0;9;40
"2899";"360470892001";89;5;10;2;10;116
"2900";"360470892002";29;17;24;0;12;82
"2901";"360470892003";53;1;6;1;9;70
"2902";"360470892004";13;2;1;4;5;25
"2903";"360470894001";8;5;8;3;8;32
"2904";"360470894002";13;1;24;5;5;48
"2905";"360470894003";20;6;12;0;3;41
"2906";"360470894004";9;3;17;1;10;40
"2907";"360470896001";9;9;10;8;13;49
"2908";"360470896002";86;16;52;11;13;178
"2909";"360470896003";34;2;25;6;14;81
"2910";"360470898001";19;4;25;16;10;74
"2911";"360470898002";40;7;80;15;11;153
"2912";"360470900001";4;7;15;4;0;30
"2913";"360470900002";2;0;2;2;0;6
"2914";"360470900003";18;3;5;8;4;38
"2915";"360470900004";3;3;27;1;3;37
"2916";"360470900005";17;1;18;3;4;43
"2917";"360470900006";91;43;33;2;21;190
"2918";"360470900007";15;1;3;2;3;24
"2919";"360470902001";25;3;1;5;2;36
"2920";"360470902002";1;0;1;1;0;3
"2921";"360470902003";6;1;19;5;0;31
"2922";"360470902004";6;3;27;18;9;63
"2923";"360470902005";5;3;24;2;1;35
"2924";"360470906001";11;2;3;1;2;19
"2925";"360470906002";35;21;18;5;23;102
"2926";"360470906003";64;1;2;4;3;74
"2927";"360470908001";56;12;66;39;16;189
"2928";"360470908002";12;1;2;2;3;20
"2929";"360470908003";37;4;7;1;9;58
"2930";"360470910001";28;1;2;0;2;33
"2931";"360470910002";161;34;0;0;0;195
"2932";"360470910003";31;1;1;0;0;33
"2933";"360470910004";3;3;27;0;3;36
"2934";"360470912001";71;3;4;1;4;83
"2935";"360470912002";59;1;0;0;1;61
"2936";"360470912003";111;1;0;0;3;115
"2937";"360470916001";14;2;10;2;13;41
"2938";"360470916002";40;7;16;10;11;84
"2939";"360470916003";4;3;9;3;14;33
"2940";"360470916004";58;14;27;14;8;121
"2941";"360470918001";39;3;13;5;9;69
"2942";"360470918002";9;0;43;5;6;63
"2943";"360470920001";5;6;7;10;0;28
"2944";"360470920002";189;19;22;3;8;241
"2945";"360470920003";7;7;52;31;10;107
"2946";"360470922001";43;6;31;18;5;103
"2947";"360470922002";9;2;28;28;3;70
"2948";"360470924001";22;16;31;5;13;87
"2949";"360470924002";7;8;41;11;18;85
"2950";"360470924003";12;1;4;10;2;29
"2951";"360470928001";20;6;49;9;5;89
"2952";"360470928002";10;3;65;115;9;202
"2953";"360470930001";4;1;44;6;8;63
"2954";"360470930002";17;4;62;29;10;122
"2955";"360470932001";30;7;82;114;12;245
"2956";"360470934001";13;4;37;5;9;68
"2957";"360470934002";11;3;16;16;9;55
"2958";"360470936001";23;0;16;5;4;48
"2959";"360470936002";30;4;15;10;4;63
"2960";"360470938001";35;2;21;11;9;78
"2961";"360470938002";6;0;37;23;3;69
"2962";"360470944011";13;1;6;31;0;51
"2963";"360470944012";11;11;50;66;11;149
"2964";"360470944013";39;21;42;40;7;149
"2965";"360470944014";2;17;25;11;5;60
"2966";"360470944021";95;18;9;1;3;126
"2967";"360470946001";5;1;32;13;4;55
"2968";"360470946002";1;0;28;5;2;36
"2969";"360470946003";10;2;45;53;5;115
"2970";"360470950001";76;20;68;4;6;174
"2971";"360470950002";6;1;46;21;9;83
"2972";"360470954001";9;8;45;11;4;77
"2973";"360470954002";31;1;31;11;4;78
"2974";"360470954003";27;15;41;8;6;97
"2975";"360470956001";28;2;39;18;8;95
"2976";"360470956002";49;4;127;8;9;197
"2977";"360470958001";28;8;25;34;11;106
"2978";"360470958002";47;3;200;30;31;311
"2979";"360470960001";11;27;79;140;3;260
"2980";"360470962001";36;14;70;30;13;163
"2981";"360470964001";30;3;48;68;18;167
"2982";"360470964002";36;9;91;47;13;196
"2983";"360470966001";24;4;37;20;10;95
"2984";"360470966002";24;1;47;11;6;89
"2985";"360470968001";24;84;67;5;16;196
"2986";"360470968002";9;0;36;14;11;70
"2987";"360470970001";20;2;65;6;6;99
"2988";"360470970002";23;0;84;30;3;140
"2989";"360470974001";63;2;63;20;13;161
"2990";"360470974002";60;22;86;28;11;207
"2991";"360470982001";85;6;6;22;5;124
"2992";"360470982002";66;12;2;6;7;93
"2993";"360470984001";14;0;56;13;14;97
"2994";"360470986001";33;3;39;7;19;101
"2995";"360470986002";84;4;39;10;6;143
"2996";"360470988001";26;3;32;2;10;73
"2997";"360470988002";23;2;20;3;6;54
"2998";"360470990001";26;24;74;39;9;172
"2999";"360470992001";30;24;150;87;8;299
"3000";"360470994001";46;14;92;26;11;189
"3001";"360470996001";31;3;129;13;10;186
"3002";"360470996002";21;3;65;29;14;132
"3003";"360470998001";26;4;93;6;8;137
"3004";"360470998002";42;13;116;8;10;189
"3005";"360471004001";26;0;86;20;8;140
"3006";"360471006001";14;3;55;16;21;109
"3007";"360471006002";15;0;52;26;5;98
"3008";"360471008001";16;20;45;32;2;115
"3009";"360471008002";5;1;51;31;5;93
"3010";"360471010001";28;8;32;8;6;82
"3011";"360471010002";19;3;58;19;11;110
"3012";"360471012001";7;2;51;9;3;72
"3013";"360471012002";11;0;44;32;10;97
"3014";"360471014001";16;1;28;12;10;67
"3015";"360471014002";23;4;6;7;0;40
"3016";"360471016001";33;2;32;24;1;92
"3017";"360471018001";20;3;13;10;3;49
"3018";"360471020001";28;5;68;33;8;142
"3019";"360471022001";35;3;93;51;14;196
"3020";"360471024001";19;3;101;57;11;191
"3021";"360471026001";59;12;142;44;11;268
"3022";"360471028001";15;6;54;14;16;105
"3023";"360471028002";6;5;27;4;3;45
"3024";"360471034001";218;21;26;14;9;288
"3025";"360471058011";1;0;0;1;2;4
"3026";"360471058012";11;1;11;1;1;25
"3027";"360471058013";3;2;12;0;2;19
"3028";"360471058041";1;0;33;1;0;35
"3029";"360471058042";10;0;3;1;0;14
"3030";"360471058043";5;1;9;6;3;24
"3031";"360471058044";7;0;34;10;4;55
"3032";"360471070001";29;11;38;65;3;146
"3033";"360471078001";4;1;47;7;9;68
"3034";"360471078002";6;15;19;6;3;49
"3035";"360471078003";8;4;17;6;7;42
"3036";"360471078004";14;0;4;4;8;30
"3037";"360471098001";72;5;53;36;12;178
"3038";"360471098002";10;8;68;97;8;191
"3039";"360471104001";7;1;140;67;10;225
"3040";"360471104002";35;1;45;52;20;153
"3041";"360471104003";24;1;9;7;0;41
"3042";"360471104004";6;2;32;26;3;69
"3043";"360471106001";91;0;1;1;3;96
"3044";"360471106002";38;0;3;1;3;45
"3045";"360471110001";122;22;11;8;7;170
"3046";"360471110002";117;3;1;4;4;129
"3047";"360471116001";17;5;48;10;6;86
"3048";"360471116002";11;8;57;23;38;137
"3049";"360471118001";51;2;19;23;12;107
"3050";"360471118002";55;9;43;19;38;164
"3051";"360471120001";10;14;10;11;10;55
"3052";"360471120002";15;12;35;23;21;106
"3053";"360471122001";21;10;68;25;15;139
"3054";"360471122002";10;1;58;11;13;93
"3055";"360471124001";17;3;16;9;11;56
"3056";"360471124002";27;6;7;16;18;74
"3057";"360471124003";11;2;37;4;11;65
"3058";"360471126001";33;2;12;8;5;60
"3059";"360471126002";7;2;16;6;5;36
"3060";"360471126003";12;4;50;1;45;112
"3061";"360471128001";21;2;53;11;15;102
"3062";"360471128002";25;1;10;4;11;51
"3063";"360471128003";45;10;38;21;6;120
"3064";"360471130001";4;0;2;1;1;8
"3065";"360471130002";27;5;24;1;5;62
"3066";"360471130003";47;1;17;2;21;88
"3067";"360471130004";6;2;35;31;11;85
"3068";"360471132001";7;0;44;5;10;66
"3069";"360471132002";5;4;54;37;9;109
"3070";"360471134001";20;5;29;6;2;62
"3071";"360471134002";22;6;6;0;2;36
"3072";"360471134003";29;4;3;1;6;43
"3073";"360471142011";23;1;108;53;14;199
"3074";"360471142012";5;6;91;44;10;156
"3075";"360471142021";61;7;252;56;17;393
"3076";"360471142022";72;1;22;12;8;115
"3077";"360471144001";4;1;83;31;40;159
"3078";"360471144002";15;7;7;10;4;43
"3079";"360471144003";4;5;9;19;17;54
"3080";"360471144004";11;1;18;0;1;31
"3081";"360471146001";98;70;104;29;18;319
"3082";"360471146002";21;87;101;58;18;285
"3083";"360471150001";36;7;46;15;16;120
"3084";"360471150002";24;3;54;24;6;111
"3085";"360471150003";16;5;36;15;21;93
"3086";"360471152001";9;1;58;104;17;189
"3087";"360471152002";60;4;36;15;8;123
"3088";"360471152003";63;11;36;5;16;131
"3089";"360471156001";12;2;41;4;7;66
"3090";"360471156002";124;8;8;0;3;143
"3091";"360471156003";47;2;1;5;3;58
"3092";"360471156004";12;4;9;4;7;36
"3093";"360471158001";13;2;25;3;8;51
"3094";"360471158002";20;4;9;1;8;42
"3095";"360471158003";23;4;8;2;3;40
"3096";"360471160001";8;5;15;1;8;37
"3097";"360471160002";27;5;10;4;4;50
"3098";"360471160003";87;6;15;11;3;122
"3099";"360471162001";16;0;5;12;17;50
"3100";"360471162002";8;2;19;15;6;50
"3101";"360471162003";5;1;37;10;2;55
"3102";"360471164001";8;5;35;8;7;63
"3103";"360471164002";4;0;25;6;4;39
"3104";"360471164003";5;1;20;4;6;36
"3105";"360471166001";29;1;19;3;21;73
"3106";"360471166002";36;2;27;16;7;88
"3107";"360471166003";24;7;41;14;15;101
"3108";"360471168001";37;39;51;21;15;163
"3109";"360471168002";7;4;77;19;12;119
"3110";"360471170001";31;75;57;17;14;194
"3111";"360471170002";44;40;43;12;19;158
"3112";"360471172011";51;13;88;34;15;201
"3113";"360471172012";178;31;35;2;13;259
"3114";"360471172021";19;8;85;8;9;129
"3115";"360471172022";108;31;99;9;28;275
"3116";"360471174001";110;80;100;42;21;353
"3117";"360471174002";25;66;128;27;34;280
"3118";"360471176011";19;5;95;19;77;215
"3119";"360471176012";48;45;72;6;13;184
"3120";"360471176021";25;9;96;21;19;170
"3121";"360471176022";184;36;127;16;73;436
"3122";"360471178001";33;13;53;45;34;178
"3123";"360471180001";5;22;39;17;8;91
"3124";"360471182011";39;14;151;17;29;250
"3125";"360471182012";53;14;72;12;25;176
"3126";"360471182021";45;20;50;13;18;146
"3127";"360471182022";58;49;52;20;44;223
"3128";"360471184001";74;45;72;20;17;228
"3129";"360471184002";24;20;75;63;30;212
"3130";"360471184003";59;14;39;17;21;150
"3131";"360471186001";14;2;45;16;14;91
"3132";"360471186002";23;11;82;17;15;148
"3133";"360471188001";223;103;96;4;18;444
"3134";"360471188002";30;9;13;10;19;81
"3135";"360471188003";17;8;12;8;15;60
"3136";"360471190001";46;9;85;35;10;185
"3137";"360471190002";11;6;53;5;21;96
"3138";"360471192001";89;10;64;12;20;195
"3139";"360471192002";13;23;35;4;25;100
"3140";"360471192003";26;6;26;11;8;77
"3141";"360471194001";25;4;37;8;8;82
"3142";"360471194002";45;9;87;11;11;163
"3143";"360471194003";57;2;52;15;20;146
"3144";"360471196001";26;16;47;14;9;112
"3145";"360471196002";14;4;48;13;20;99
"3146";"360471196003";23;6;59;10;18;116
"3147";"360471196004";38;6;48;6;13;111
"3148";"360471198001";10;9;59;13;11;102
"3149";"360471198002";19;10;74;33;13;149
"3150";"360471198003";13;11;82;52;42;200
"3151";"360471200001";7;1;34;8;6;56
"3152";"360471200002";46;4;76;4;5;135
"3153";"360471202001";14;12;17;14;18;75
"3154";"360471202002";14;24;14;6;16;74
"3155";"360471208001";25;4;46;7;8;90
"3156";"360471208002";40;19;167;85;31;342
"3157";"360471208003";21;2;6;2;0;31
"3158";"360471208004";8;0;1;3;1;13
"3159";"360471208005";20;7;55;30;18;130
"3160";"360471210001";71;0;2;0;2;75
"3161";"360471210002";30;1;0;1;0;32
"3162";"360471214001";17;0;4;0;3;24
"3163";"360471214002";101;5;1;0;2;109
"3164";"360471220001";98;15;100;130;24;367
"3165";"360471220002";87;9;116;64;25;301
"3166";"360471237001";23;18;159;45;10;255
"3167";"360471237002";15;6;74;7;7;109
"3168";"360471237003";16;22;202;10;19;269
"3169";"360471502001";6;6;43;7;6;68
"3170";"360471502002";8;4;14;0;3;29
"3171";"360471502003";5;8;32;15;13;73
"3172";"360471522001";18;53;81;36;13;201
"3173";"360471522002";11;13;37;12;10;83
"3174";"360471522003";28;15;105;21;7;176
"3175";"360594043002";0;1;1;0;2;4
"3176";"360594043003";3;0;1;0;1;5
"3177";"360594103005";0;0;1;0;0;1
"3178";"360610001001";0;0;0;0;1;1
"3179";"360610002011";51;0;3;3;6;63
"3180";"360610002012";36;19;13;3;9;80
"3181";"360610002021";27;23;9;1;10;70
"3182";"360610002022";39;11;20;5;23;98
"3183";"360610002023";133;35;3;1;7;179
"3184";"360610002024";80;16;6;0;3;105
"3185";"360610002025";14;30;14;3;8;69
"3186";"360610005001";0;1;0;0;0;1
"3187";"360610006001";15;67;59;2;32;175
"3188";"360610006002";53;26;43;0;6;128
"3189";"360610006003";27;34;15;3;23;102
"3190";"360610006004";12;5;5;0;19;41
"3191";"360610006005";22;11;8;0;0;41
"3192";"360610006006";6;8;41;3;1;59
"3193";"360610007001";97;418;79;2;304;900
"3194";"360610008001";15;11;11;2;22;61
"3195";"360610008002";22;6;17;3;10;58
"3196";"360610008003";18;11;11;4;21;65
"3197";"360610008004";8;12;0;0;11;31
"3198";"360610008005";7;8;4;0;14;33
"3199";"360610008006";16;74;265;0;47;402
"3200";"360610009001";37;168;141;3;220;569
"3201";"360610010011";12;2;5;4;2;25
"3202";"360610010020";0;1;0;0;0;1
"3203";"360610010021";51;2;3;0;6;62
"3204";"360610010022";2;1;2;0;1;6
"3205";"360610010023";97;5;20;0;9;131
"3206";"360610012001";53;26;12;3;12;106
"3207";"360610012002";17;5;6;1;5;34
"3208";"360610012003";29;9;10;1;3;52
"3209";"360610013001";4;42;243;1;104;394
"3210";"360610013002";44;82;55;8;246;435
"3211";"360610014011";5;26;31;0;14;76
"3212";"360610014012";5;10;6;2;8;31
"3213";"360610014021";107;118;18;1;39;283
"3214";"360610014022";40;83;18;0;45;186
"3215";"360610015011";24;135;217;2;102;480
"3216";"360610015012";7;9;159;3;15;193
"3217";"360610015013";19;34;32;5;32;122
"3218";"360610015021";55;153;151;0;272;631
"3219";"360610015022";29;131;55;1;54;270
"3220";"360610015023";0;1;0;0;0;1
"3221";"360610016001";19;31;60;2;38;150
"3222";"360610016002";14;17;4;5;15;55
"3223";"360610016003";18;156;135;1;92;402
"3224";"360610016004";101;97;3;3;78;282
"3225";"360610016005";43;438;143;8;123;755
"3226";"360610018001";162;59;4;9;21;255
"3227";"360610018002";58;85;7;10;59;219
"3228";"360610018003";57;220;11;4;61;353
"3229";"360610018004";3;8;3;3;14;31
"3230";"360610018005";17;120;36;2;84;259
"3231";"360610018006";14;80;1;1;22;118
"3232";"360610018007";37;278;1;1;50;367
"3233";"360610020001";26;7;2;0;10;45
"3234";"360610020002";78;11;6;2;5;102
"3235";"360610020003";18;12;24;4;2;60
"3236";"360610021001";133;108;108;8;166;523
"3237";"360610021002";8;46;51;4;69;178
"3238";"360610022011";147;62;20;7;25;261
"3239";"360610022012";74;66;27;0;46;213
"3240";"360610022013";221;14;4;0;4;243
"3241";"360610022014";8;1;1;1;3;14
"3242";"360610022021";134;128;20;7;68;357
"3243";"360610024000";0;2;0;0;0;2
"3244";"360610024001";265;32;7;3;14;321
"3245";"360610024002";33;15;0;0;5;53
"3246";"360610025001";437;11;18;0;15;481
"3247";"360610025002";12;3;5;1;6;27
"3248";"360610025003";35;6;4;0;6;51
"3249";"360610026011";113;112;21;3;45;294
"3250";"360610026012";55;93;26;12;80;266
"3251";"360610026021";86;68;70;33;45;302
"3252";"360610026022";125;207;37;6;69;444
"3253";"360610027001";11;17;162;3;19;212
"3254";"360610028001";17;30;2;7;11;67
"3255";"360610028002";32;38;28;6;5;109
"3256";"360610028003";86;256;33;3;64;442
"3257";"360610028004";26;31;40;43;28;168
"3258";"360610029001";7;21;13;2;25;68
"3259";"360610029002";14;11;9;0;9;43
"3260";"360610029003";13;46;11;4;10;84
"3261";"360610029004";0;10;64;0;30;104
"3262";"360610030011";58;137;21;1;36;253
"3263";"360610030012";60;199;7;4;47;317
"3264";"360610030013";57;20;29;1;34;141
"3265";"360610030014";118;59;3;4;42;226
"3266";"360610030021";112;99;14;5;38;268
"3267";"360610030022";119;208;9;12;97;445
"3268";"360610031001";27;174;159;6;139;505
"3269";"360610032001";90;238;27;11;94;460
"3270";"360610032002";41;78;4;1;61;185
"3271";"360610032003";16;166;12;9;51;254
"3272";"360610032004";12;27;2;8;106;155
"3273";"360610032005";50;73;23;5;20;171
"3274";"360610032006";165;107;10;1;67;350
"3275";"360610032007";37;60;8;1;231;337
"3276";"360610033001";47;88;75;11;46;267
"3277";"360610033002";12;35;31;4;19;101
"3278";"360610033003";5;72;41;4;28;150
"3279";"360610034001";136;138;21;2;38;335
"3280";"360610034002";173;236;25;6;51;491
"3281";"360610034003";133;196;39;8;112;488
"3282";"360610034004";172;71;55;5;112;415
"3283";"360610036011";12;47;7;1;12;79
"3284";"360610036012";39;108;12;1;48;208
"3285";"360610036013";23;39;22;1;109;194
"3286";"360610036021";88;123;29;15;115;370
"3287";"360610036022";21;68;14;3;38;144
"3288";"360610037001";6;104;61;4;38;213
"3289";"360610037002";18;19;95;4;35;171
"3290";"360610037003";9;37;36;5;72;159
"3291";"360610038001";115;272;13;3;430;833
"3292";"360610038002";15;8;12;0;55;90
"3293";"360610038003";43;60;25;4;48;180
"3294";"360610038004";68;104;3;3;22;200
"3295";"360610038005";42;41;3;5;30;121
"3296";"360610038006";61;19;8;5;34;127
"3297";"360610038007";84;58;12;2;115;271
"3298";"360610039001";19;251;38;1;25;334
"3299";"360610039002";23;21;12;0;7;63
"3300";"360610039003";1;2;2;1;2;8
"3301";"360610039004";24;39;48;5;31;147
"3302";"360610040001";92;48;9;2;80;231
"3303";"360610040002";22;13;6;6;12;59
"3304";"360610040003";25;40;6;7;104;182
"3305";"360610040004";85;30;0;3;18;136
"3306";"360610040005";81;67;8;5;81;242
"3307";"360610040006";80;114;3;4;102;303
"3308";"360610041001";27;23;14;3;27;94
"3309";"360610041002";14;182;7;0;40;243
"3310";"360610041003";31;12;5;0;16;64
"3311";"360610041004";27;62;4;2;12;107
"3312";"360610041005";21;29;27;5;53;135
"3313";"360610041006";40;80;5;1;76;202
"3314";"360610042001";23;100;31;2;147;303
"3315";"360610042002";26;43;11;6;97;183
"3316";"360610043001";52;94;48;4;79;277
"3317";"360610043002";16;55;4;1;72;148
"3318";"360610043003";39;101;56;7;128;331
"3319";"360610044001";27;91;21;0;6;145
"3320";"360610044002";19;1;19;0;2;41
"3321";"360610044003";1;1;1;0;5;8
"3322";"360610044004";9;1;2;4;25;41
"3323";"360610044005";4;2;14;2;2;24
"3324";"360610044006";14;0;1;0;4;19
"3325";"360610044007";11;5;23;0;32;71
"3326";"360610044008";5;0;5;1;7;18
"3327";"360610045001";30;82;40;3;285;440
"3328";"360610047001";55;85;60;0;16;216
"3329";"360610047002";77;118;22;3;93;313
"3330";"360610048001";2;3;6;0;23;34
"3331";"360610048002";15;1;3;3;14;36
"3332";"360610048003";3;3;5;0;19;30
"3333";"360610048004";28;68;7;1;77;181
"3334";"360610048005";51;20;30;3;30;134
"3335";"360610048006";44;21;17;4;13;99
"3336";"360610048007";0;1;3;2;12;18
"3337";"360610049001";80;238;26;0;148;492
"3338";"360610049002";44;72;4;5;80;205
"3339";"360610049003";58;84;9;3;24;178
"3340";"360610050001";8;29;17;1;13;68
"3341";"360610050002";18;21;5;1;42;87
"3342";"360610050003";2;17;33;0;381;433
"3343";"360610050004";9;21;3;1;324;358
"3344";"360610050005";30;118;6;1;56;211
"3345";"360610052001";30;71;25;5;230;361
"3346";"360610052002";26;193;40;4;303;566
"3347";"360610054001";28;106;19;8;156;317
"3348";"360610054002";20;6;8;1;28;63
"3349";"360610054003";13;13;4;1;89;120
"3350";"360610055011";18;16;11;3;123;171
"3351";"360610055012";5;5;1;0;126;137
"3352";"360610055013";2;6;8;0;105;121
"3353";"360610055021";15;111;5;1;36;168
"3354";"360610055022";21;53;104;6;228;412
"3355";"360610056001";35;39;15;3;148;240
"3356";"360610056002";12;63;9;0;175;259
"3357";"360610056003";18;25;3;1;27;74
"3358";"360610057001";16;42;3;3;69;133
"3359";"360610057002";18;61;16;1;314;410
"3360";"360610058001";51;126;40;2;352;571
"3361";"360610059001";7;8;1;0;74;90
"3362";"360610059002";13;108;3;0;22;146
"3363";"360610059003";42;31;4;1;104;182
"3364";"360610059004";3;4;1;0;30;38
"3365";"360610059005";7;10;1;0;22;40
"3366";"360610060001";44;0;2;1;8;55
"3367";"360610060002";1;11;6;0;14;32
"3368";"360610060003";1;0;0;2;1;4
"3369";"360610061001";19;90;20;4;112;245
"3370";"360610061002";19;11;9;1;50;90
"3371";"360610061003";22;81;39;10;175;327
"3372";"360610062001";5;11;41;3;36;96
"3373";"360610062002";7;0;24;4;7;42
"3374";"360610063001";11;18;11;0;195;235
"3375";"360610063002";16;20;19;0;38;93
"3376";"360610063003";21;44;24;4;29;122
"3377";"360610063004";9;18;1;1;22;51
"3378";"360610063005";11;28;7;0;27;73
"3379";"360610064001";13;15;15;7;22;72
"3380";"360610064002";131;11;7;1;18;168
"3381";"360610064003";6;13;9;0;25;53
"3382";"360610064004";29;12;30;2;38;111
"3383";"360610064005";8;21;15;0;25;69
"3384";"360610064006";6;2;8;2;15;33
"3385";"360610065001";25;93;9;1;133;261
"3386";"360610065002";50;77;9;0;60;196
"3387";"360610065003";31;61;5;1;151;249
"3388";"360610065004";75;137;8;3;66;289
"3389";"360610065005";32;94;9;1;41;177
"3390";"360610066001";21;58;8;1;24;112
"3391";"360610066002";41;4;6;0;49;100
"3392";"360610066003";23;22;6;1;62;114
"3393";"360610066004";8;3;3;0;26;40
"3394";"360610066005";21;36;6;0;24;87
"3395";"360610066006";0;3;8;0;6;17
"3396";"360610066007";4;2;0;1;6;13
"3397";"360610066008";125;16;18;1;61;221
"3398";"360610066009";8;1;4;0;18;31
"3399";"360610067001";68;79;5;0;54;206
"3400";"360610067002";30;97;25;3;78;233
"3401";"360610067003";29;8;14;6;23;80
"3402";"360610067004";31;29;8;2;26;96
"3403";"360610068001";12;71;30;1;39;153
"3404";"360610068002";10;33;4;0;52;99
"3405";"360610068003";17;12;9;0;17;55
"3406";"360610068004";221;6;7;1;17;252
"3407";"360610068005";11;14;15;0;26;66
"3408";"360610068006";43;46;20;1;32;142
"3409";"360610069001";230;197;40;10;162;639
"3410";"360610070001";55;77;13;1;34;180
"3411";"360610070002";94;52;9;4;145;304
"3412";"360610070003";55;15;18;1;38;127
"3413";"360610070004";7;6;6;0;20;39
"3414";"360610070005";2;1;3;0;6;12
"3415";"360610070006";24;15;4;0;27;70
"3416";"360610071001";2;11;4;0;242;259
"3417";"360610071002";4;17;1;1;50;73
"3418";"360610071003";15;15;7;6;33;76
"3419";"360610071004";21;17;19;7;22;86
"3420";"360610071005";6;69;21;1;37;134
"3421";"360610072001";6;2;1;0;12;21
"3422";"360610072002";31;21;51;0;173;276
"3423";"360610072003";25;44;12;0;143;224
"3424";"360610072004";19;38;12;0;125;194
"3425";"360610072005";12;8;2;1;35;58
"3426";"360610072006";5;5;4;0;14;28
"3427";"360610072007";3;10;4;2;26;45
"3428";"360610073001";31;42;7;9;12;101
"3429";"360610073002";13;39;1;1;8;62
"3430";"360610073003";25;58;14;4;16;117
"3431";"360610073004";72;66;7;1;25;171
"3432";"360610073005";4;5;44;0;6;59
"3433";"360610073006";44;53;24;3;24;148
"3434";"360610074001";15;26;13;0;120;174
"3435";"360610074002";12;38;8;2;79;139
"3436";"360610074003";18;80;19;0;166;283
"3437";"360610075001";17;14;25;2;34;92
"3438";"360610075002";10;15;8;4;5;42
"3439";"360610075003";47;61;4;4;12;128
"3440";"360610076001";18;257;47;1;392;715
"3441";"360610076002";11;38;48;3;133;233
"3442";"360610077001";68;181;3;5;145;402
"3443";"360610077002";41;17;8;2;12;80
"3444";"360610077003";58;113;12;5;68;256
"3445";"360610077004";35;22;9;7;33;106
"3446";"360610077005";14;8;1;4;18;45
"3447";"360610078001";6;39;4;0;20;69
"3448";"360610078002";31;165;4;0;27;227
"3449";"360610078003";9;37;2;0;8;56
"3450";"360610078004";17;94;5;5;35;156
"3451";"360610078005";20;22;2;0;53;97
"3452";"360610078006";8;28;3;1;11;51
"3453";"360610078007";16;45;6;0;0;67
"3454";"360610079001";25;118;49;1;61;254
"3455";"360610079002";10;12;9;0;5;36
"3456";"360610079003";5;22;30;2;25;84
"3457";"360610079004";6;13;21;2;5;47
"3458";"360610080001";10;129;9;5;71;224
"3459";"360610080002";6;27;17;1;78;129
"3460";"360610080003";18;6;13;5;18;60
"3461";"360610080004";12;26;3;1;10;52
"3462";"360610080005";8;16;16;4;10;54
"3463";"360610081001";21;32;8;1;39;101
"3464";"360610081002";11;22;5;3;42;83
"3465";"360610081003";18;14;10;3;29;74
"3466";"360610081004";23;30;2;5;297;357
"3467";"360610081005";27;9;2;4;16;58
"3468";"360610081006";22;19;1;3;49;94
"3469";"360610082001";11;24;27;0;283;345
"3470";"360610082002";1;15;13;1;117;147
"3471";"360610082003";7;7;9;0;18;41
"3472";"360610083001";26;66;25;6;29;152
"3473";"360610083002";11;30;6;3;51;101
"3474";"360610083003";37;62;31;2;70;202
"3475";"360610084001";0;31;10;0;106;147
"3476";"360610084002";28;89;53;3;296;469
"3477";"360610086010";0;1;0;0;3;4
"3478";"360610086011";4;13;19;5;48;89
"3479";"360610086012";15;11;16;0;23;65
"3480";"360610086021";0;2;7;0;72;81
"3481";"360610086030";1;1;0;0;0;2
"3482";"360610086031";3;5;8;1;4;21
"3483";"360610086032";5;3;9;0;5;22
"3484";"360610086033";0;8;9;2;3;22
"3485";"360610086034";11;2;5;0;12;30
"3486";"360610087001";57;104;25;9;98;293
"3487";"360610087002";25;19;4;7;10;65
"3488";"360610087003";17;16;10;19;18;80
"3489";"360610087004";26;20;7;3;24;80
"3490";"360610087005";21;16;0;5;10;52
"3491";"360610088001";4;23;34;2;51;114
"3492";"360610088002";10;39;3;5;18;75
"3493";"360610088003";2;2;14;1;9;28
"3494";"360610088004";4;19;4;0;13;40
"3495";"360610088005";1;4;7;1;11;24
"3496";"360610088006";2;1;18;0;10;31
"3497";"360610088007";2;1;10;1;7;21
"3498";"360610089001";25;6;5;5;12;53
"3499";"360610089002";19;16;11;11;22;79
"3500";"360610089003";42;28;21;0;34;125
"3501";"360610089004";21;8;11;1;34;75
"3502";"360610089005";19;8;5;0;12;44
"3503";"360610090001";63;15;250;1;68;397
"3504";"360610090002";11;4;25;0;6;46
"3505";"360610090003";1;75;147;0;28;251
"3506";"360610090004";18;14;5;3;17;57
"3507";"360610090005";9;11;0;0;53;73
"3508";"360610090006";4;11;2;1;16;34
"3509";"360610091001";25;58;18;8;181;290
"3510";"360610091002";39;35;7;5;86;172
"3511";"360610091003";26;9;5;3;111;154
"3512";"360610091004";10;10;7;2;139;168
"3513";"360610092001";21;49;56;2;498;626
"3514";"360610093001";2;7;13;0;23;45
"3515";"360610093002";4;16;8;3;98;129
"3516";"360610093003";1;5;3;3;9;21
"3517";"360610093004";4;0;3;0;3;10
"3518";"360610093005";12;11;4;4;19;50
"3519";"360610093006";34;45;6;1;11;97
"3520";"360610093007";41;6;9;5;13;74
"3521";"360610094001";6;33;46;2;509;596
"3522";"360610095001";36;144;38;6;235;459
"3523";"360610095002";19;45;24;6;79;173
"3524";"360610096001";7;97;84;1;1054;1243
"3525";"360610097001";6;0;10;1;58;75
"3526";"360610097002";267;13;19;2;251;552
"3527";"360610097003";2;0;0;0;0;2
"3528";"360610097004";345;10;4;3;40;402
"3529";"360610098001";10;11;6;0;17;44
"3530";"360610098002";26;16;12;2;15;71
"3531";"360610098003";21;24;8;2;52;107
"3532";"360610098004";21;1;3;1;17;43
"3533";"360610098005";4;11;4;2;15;36
"3534";"360610098006";42;47;46;2;12;149
"3535";"360610098007";56;13;11;4;5;89
"3536";"360610099001";96;145;234;9;515;999
"3537";"360610100001";3;28;37;6;130;204
"3538";"360610100002";3;18;22;0;73;116
"3539";"360610101001";13;134;44;2;714;907
"3540";"360610102001";1;24;40;4;290;359
"3541";"360610103001";50;121;70;3;177;421
"3542";"360610104001";17;59;28;2;396;502
"3543";"360610106010";0;0;0;0;1;1
"3544";"360610106011";2;5;3;0;11;21
"3545";"360610106012";7;2;8;2;2;21
"3546";"360610106013";2;12;2;0;2;18
"3547";"360610106014";0;6;1;0;9;16
"3548";"360610106015";3;1;2;0;1;7
"3549";"360610106016";2;3;7;0;6;18
"3550";"360610106021";4;33;4;0;7;48
"3551";"360610106022";9;196;15;3;111;334
"3552";"360610106023";0;9;3;0;32;44
"3553";"360610108001";4;42;2;1;15;64
"3554";"360610108002";5;5;6;1;9;26
"3555";"360610108003";3;19;16;2;3;43
"3556";"360610108004";0;5;4;0;4;13
"3557";"360610108005";29;9;3;3;9;53
"3558";"360610108006";20;26;2;2;36;86
"3559";"360610108007";5;42;10;2;58;117
"3560";"360610109001";7;701;57;0;795;1560
"3561";"360610110001";6;35;9;0;10;60
"3562";"360610110002";3;3;6;5;5;22
"3563";"360610110003";13;19;17;0;109;158
"3564";"360610110004";5;58;7;0;22;92
"3565";"360610110005";10;80;1;0;18;109
"3566";"360610110006";32;24;9;5;75;145
"3567";"360610111001";41;50;43;1;149;284
"3568";"360610111002";12;13;19;0;76;120
"3569";"360610111003";47;11;10;0;50;118
"3570";"360610112011";3;26;35;1;220;285
"3571";"360610112021";2;22;28;4;76;132
"3572";"360610112031";1;13;2;1;78;95
"3573";"360610112032";1;5;3;1;77;87
"3574";"360610113001";17;218;98;1;1046;1380
"3575";"360610114011";15;5;9;1;54;84
"3576";"360610114012";2;11;55;0;37;105
"3577";"360610114021";6;12;13;4;135;170
"3578";"360610114022";13;38;8;1;60;120
"3579";"360610115001";13;49;31;1;254;348
"3580";"360610115002";12;28;23;1;183;247
"3581";"360610116001";4;31;11;0;21;67
"3582";"360610116002";2;6;9;0;3;20
"3583";"360610116003";10;224;25;1;6;266
"3584";"360610117001";18;22;63;1;59;163
"3585";"360610118001";6;6;1;0;4;17
"3586";"360610118002";0;0;2;0;9;11
"3587";"360610118003";0;103;5;0;3;111
"3588";"360610118004";31;14;44;7;16;112
"3589";"360610118005";5;3;1;0;9;18
"3590";"360610118006";14;12;10;3;21;60
"3591";"360610118007";2;5;7;0;5;19
"3592";"360610118008";3;4;3;0;13;23
"3593";"360610119001";9;98;36;1;298;442
"3594";"360610119002";76;66;57;2;294;495
"3595";"360610120001";1;5;14;1;9;30
"3596";"360610120002";5;2;4;1;16;28
"3597";"360610120003";6;10;20;11;14;61
"3598";"360610120004";3;7;15;5;43;73
"3599";"360610121001";60;68;66;1;241;436
"3600";"360610121002";2;4;5;0;10;21
"3601";"360610121003";20;15;8;1;105;149
"3602";"360610121004";18;68;14;4;60;164
"3603";"360610121005";90;93;3;0;25;211
"3604";"360610121006";43;23;5;0;28;99
"3605";"360610122001";49;6;8;0;9;72
"3606";"360610122002";6;4;7;1;7;25
"3607";"360610122003";3;12;11;1;10;37
"3608";"360610122004";1;8;18;1;18;46
"3609";"360610124001";37;27;28;10;17;119
"3610";"360610124002";17;81;17;3;24;142
"3611";"360610124003";2;4;9;5;5;25
"3612";"360610124004";5;2;8;6;5;26
"3613";"360610124005";1;2;21;2;4;30
"3614";"360610124006";2;2;4;1;3;12
"3615";"360610124007";0;10;4;1;3;18
"3616";"360610124008";0;1;2;1;4;8
"3617";"360610125001";5;112;60;0;289;466
"3618";"360610125002";24;453;38;3;117;635
"3619";"360610126001";18;34;47;15;29;143
"3620";"360610126002";3;2;9;1;4;19
"3621";"360610126003";14;0;8;4;8;34
"3622";"360610126004";5;1;7;1;12;26
"3623";"360610126005";4;7;13;1;13;38
"3624";"360610126006";21;14;7;3;31;76
"3625";"360610126007";13;4;4;4;9;34
"3626";"360610126008";8;4;24;1;10;47
"3627";"360610127001";33;123;30;1;31;218
"3628";"360610127002";54;106;17;1;55;233
"3629";"360610127003";49;48;15;2;27;141
"3630";"360610127004";39;45;127;12;38;261
"3631";"360610127005";9;29;24;0;47;109
"3632";"360610128001";24;26;14;4;33;101
"3633";"360610128002";2;1;8;2;11;24
"3634";"360610128003";13;3;15;4;7;42
"3635";"360610128004";2;12;16;4;17;51
"3636";"360610128005";3;5;22;1;7;38
"3637";"360610129000";0;2;0;0;0;2
"3638";"360610129001";56;178;99;9;90;432
"3639";"360610129002";36;369;525;60;106;1096
"3640";"360610130001";5;8;13;1;9;36
"3641";"360610130002";1;2;23;3;25;54
"3642";"360610130003";6;1;7;3;17;34
"3643";"360610130004";8;5;13;0;16;42
"3644";"360610131001";7;33;39;1;217;297
"3645";"360610131002";12;70;25;7;309;423
"3646";"360610132001";7;1;8;3;10;29
"3647";"360610132002";20;6;8;1;9;44
"3648";"360610132003";9;15;7;5;3;39
"3649";"360610132004";30;50;26;7;118;231
"3650";"360610132005";19;5;10;5;6;45
"3651";"360610132006";14;3;18;0;10;45
"3652";"360610132007";8;3;12;1;9;33
"3653";"360610133001";6;28;8;0;29;71
"3654";"360610133002";31;69;19;4;46;169
"3655";"360610133003";43;140;24;0;74;281
"3656";"360610133004";25;42;31;0;23;121
"3657";"360610133005";30;35;13;1;56;135
"3658";"360610134001";20;18;7;1;12;58
"3659";"360610134002";25;2;2;0;19;48
"3660";"360610134003";22;14;11;5;9;61
"3661";"360610134004";0;12;5;1;11;29
"3662";"360610134005";8;49;15;2;26;100
"3663";"360610134006";18;14;11;6;15;64
"3664";"360610134007";30;18;6;1;54;109
"3665";"360610134008";2;15;7;2;104;130
"3666";"360610134009";17;87;6;3;14;127
"3667";"360610135001";42;44;40;2;51;179
"3668";"360610135002";54;53;44;5;99;255
"3669";"360610136001";65;11;12;2;19;109
"3670";"360610136002";10;5;2;1;6;24
"3671";"360610136003";11;1;8;0;9;29
"3672";"360610136004";40;7;64;2;22;135
"3673";"360610136005";3;5;11;0;6;25
"3674";"360610136006";6;2;3;0;1;12
"3675";"360610136007";95;4;7;2;8;116
"3676";"360610136008";41;13;11;1;11;77
"3677";"360610137001";1;10;19;0;40;70
"3678";"360610137002";3;35;18;2;65;123
"3679";"360610137003";8;85;28;2;362;485
"3680";"360610137004";10;59;12;0;151;232
"3681";"360610137005";1;5;41;0;73;120
"3682";"360610137006";5;104;18;0;73;200
"3683";"360610138001";17;11;7;0;6;41
"3684";"360610138002";23;6;4;2;13;48
"3685";"360610138003";15;43;12;0;14;84
"3686";"360610138004";43;29;20;1;50;143
"3687";"360610138005";17;10;16;2;3;48
"3688";"360610138006";16;11;2;5;5;39
"3689";"360610138007";8;3;19;1;16;47
"3690";"360610138008";20;1;3;1;8;33
"3691";"360610138009";4;9;11;0;10;34
"3692";"360610139001";26;13;2;0;36;77
"3693";"360610139002";35;25;5;1;18;84
"3694";"360610139003";65;75;23;9;28;200
"3695";"360610139004";10;14;28;9;14;75
"3696";"360610139005";12;53;14;1;34;114
"3697";"360610139006";4;6;4;1;62;77
"3698";"360610139007";11;10;32;1;66;120
"3699";"360610140001";23;28;8;1;17;77
"3700";"360610140002";9;21;11;1;11;53
"3701";"360610140003";6;65;11;0;21;103
"3702";"360610140004";2;4;20;1;8;35
"3703";"360610140005";4;6;9;3;8;30
"3704";"360610140006";10;5;3;0;10;28
"3705";"360610142001";0;2;5;0;15;22
"3706";"360610142002";12;2;14;5;4;37
"3707";"360610142003";8;6;1;2;3;20
"3708";"360610142004";6;6;17;1;10;40
"3709";"360610142005";28;10;7;0;2;47
"3710";"360610142006";0;2;4;0;4;10
"3711";"360610143001";19;222;91;3;141;476
"3712";"360610144011";8;3;5;2;2;20
"3713";"360610144012";0;3;6;0;10;19
"3714";"360610144013";13;10;4;0;7;34
"3715";"360610144014";2;3;5;3;5;18
"3716";"360610144021";7;6;8;1;6;28
"3717";"360610144022";21;5;2;0;6;34
"3718";"360610144023";30;7;7;3;0;47
"3719";"360610144024";30;15;22;6;12;85
"3720";"360610144025";15;3;7;1;7;33
"3721";"360610145001";8;6;34;0;61;109
"3722";"360610145002";3;3;4;0;19;29
"3723";"360610145003";2;60;62;3;805;932
"3724";"360610145004";2;9;20;1;102;134
"3725";"360610146011";11;35;13;2;24;85
"3726";"360610146012";13;148;2;0;11;174
"3727";"360610146013";1;81;21;2;22;127
"3728";"360610146014";59;63;7;8;9;146
"3729";"360610146021";9;34;13;0;19;75
"3730";"360610146022";15;11;6;2;15;49
"3731";"360610146023";19;19;7;1;14;60
"3732";"360610146024";33;26;2;2;29;92
"3733";"360610146025";3;4;15;2;6;30
"3734";"360610146026";8;5;16;0;10;39
"3735";"360610147001";7;8;17;3;28;63
"3736";"360610148011";18;13;8;0;140;179
"3737";"360610148012";2;45;107;1;125;280
"3738";"360610148021";29;16;19;0;14;78
"3739";"360610148022";10;56;18;1;76;161
"3740";"360610148023";19;6;3;0;16;44
"3741";"360610148024";19;6;10;0;6;41
"3742";"360610148025";1;7;40;3;36;87
"3743";"360610149001";7;30;46;2;238;323
"3744";"360610149002";2;7;12;0;50;71
"3745";"360610149003";1;18;49;1;224;293
"3746";"360610149004";0;10;19;0;216;245
"3747";"360610149005";2;7;4;1;31;45
"3748";"360610150011";6;7;4;0;4;21
"3749";"360610150012";1;6;4;1;11;23
"3750";"360610150021";6;1;11;0;6;24
"3751";"360610150022";0;2;8;0;1;11
"3752";"360610150023";6;4;6;8;3;27
"3753";"360610150024";2;3;10;0;6;21
"3754";"360610151001";58;90;2;0;7;157
"3755";"360610151002";109;10;8;0;10;137
"3756";"360610151003";11;17;9;0;11;48
"3757";"360610151004";11;16;19;0;31;77
"3758";"360610152001";57;3;5;0;3;68
"3759";"360610152002";112;4;8;0;22;146
"3760";"360610152003";8;5;6;0;5;24
"3761";"360610152004";5;4;4;1;7;21
"3762";"360610152005";3;0;8;2;3;16
"3763";"360610152006";4;12;19;2;5;42
"3764";"360610153001";15;17;4;2;132;170
"3765";"360610153002";8;10;17;1;65;101
"3766";"360610153003";4;7;26;1;96;134
"3767";"360610153004";2;9;31;0;149;191
"3768";"360610153005";14;1;5;0;8;28
"3769";"360610153006";17;3;34;0;18;72
"3770";"360610153007";12;107;18;3;20;160
"3771";"360610154001";17;19;14;2;16;68
"3772";"360610154002";13;4;4;0;9;30
"3773";"360610154003";44;9;9;4;14;80
"3774";"360610154004";15;5;10;1;6;37
"3775";"360610154005";43;80;3;0;10;136
"3776";"360610154006";57;5;10;1;5;78
"3777";"360610154007";2;7;4;1;2;16
"3778";"360610154008";8;10;9;1;19;47
"3779";"360610154009";56;10;12;0;13;91
"3780";"360610155001";1;1;6;0;2;10
"3781";"360610155002";1;0;14;0;1;16
"3782";"360610155003";0;1;5;0;1;7
"3783";"360610155004";0;3;8;0;1;12
"3784";"360610155005";1;3;1;0;2;7
"3785";"360610155006";13;3;13;4;16;49
"3786";"360610156011";13;7;13;1;9;43
"3787";"360610156012";8;31;16;5;8;68
"3788";"360610156013";30;19;14;0;10;73
"3789";"360610156014";9;5;19;4;4;41
"3790";"360610156021";51;21;20;3;16;111
"3791";"360610157001";11;2;10;4;12;39
"3792";"360610157002";17;3;10;1;21;52
"3793";"360610157003";10;16;9;0;17;52
"3794";"360610157004";28;5;24;0;8;65
"3795";"360610157005";19;11;7;0;8;45
"3796";"360610157006";7;20;3;0;50;80
"3797";"360610157007";17;14;6;4;228;269
"3798";"360610157008";10;9;8;1;75;103
"3799";"360610158011";3;33;48;4;11;99
"3800";"360610158012";17;18;7;3;16;61
"3801";"360610158013";5;11;10;0;7;33
"3802";"360610158014";6;3;7;0;7;23
"3803";"360610158021";13;10;43;0;8;74
"3804";"360610158022";59;29;53;0;8;149
"3805";"360610159001";3;2;3;0;12;20
"3806";"360610159002";4;7;17;0;6;34
"3807";"360610159003";6;2;13;0;7;28
"3808";"360610159004";2;2;5;0;67;76
"3809";"360610159005";11;41;14;0;101;167
"3810";"360610159006";22;20;9;1;103;155
"3811";"360610159007";1;8;2;0;38;49
"3812";"360610160011";7;0;13;3;1;24
"3813";"360610160012";3;3;16;0;13;35
"3814";"360610160013";5;2;16;0;5;28
"3815";"360610160014";6;3;2;0;4;15
"3816";"360610160021";2;1;2;1;5;11
"3817";"360610160022";29;4;2;2;9;46
"3818";"360610161001";5;13;7;2;50;77
"3819";"360610161002";6;9;2;0;10;27
"3820";"360610161003";26;9;11;1;34;81
"3821";"360610161004";20;9;47;0;11;87
"3822";"360610161005";31;3;64;4;23;125
"3823";"360610161006";15;11;10;0;17;53
"3824";"360610162001";2;10;9;0;17;38
"3825";"360610162002";16;2;2;0;3;23
"3826";"360610162003";63;6;5;1;2;77
"3827";"360610162004";108;25;13;0;10;156
"3828";"360610162005";81;24;27;1;4;137
"3829";"360610163001";11;5;11;2;20;49
"3830";"360610163002";13;10;20;2;7;52
"3831";"360610163003";63;12;16;1;30;122
"3832";"360610163004";26;100;14;0;71;211
"3833";"360610163005";9;20;33;1;75;138
"3834";"360610164001";59;25;11;0;12;107
"3835";"360610164002";181;17;26;3;22;249
"3836";"360610164003";39;8;7;2;10;66
"3837";"360610164004";17;6;5;0;8;36
"3838";"360610165001";3;10;27;2;35;77
"3839";"360610165002";4;26;3;1;46;80
"3840";"360610165003";5;4;15;6;38;68
"3841";"360610165004";17;13;4;1;6;41
"3842";"360610165005";23;10;9;1;14;57
"3843";"360610166001";22;30;7;0;30;89
"3844";"360610166002";45;22;18;8;13;106
"3845";"360610166003";41;106;19;5;5;176
"3846";"360610166004";32;8;6;0;10;56
"3847";"360610166005";38;5;4;0;8;55
"3848";"360610166006";91;35;18;1;7;152
"3849";"360610167001";12;3;25;0;7;47
"3850";"360610167002";8;5;9;0;26;48
"3851";"360610167003";4;3;11;1;156;175
"3852";"360610167004";16;12;26;0;81;135
"3853";"360610167005";5;9;9;2;33;58
"3854";"360610168001";174;21;12;0;3;210
"3855";"360610168002";69;13;33;1;3;119
"3856";"360610168003";12;23;16;0;10;61
"3857";"360610169001";10;2;7;0;21;40
"3858";"360610169002";25;38;4;3;17;87
"3859";"360610169003";8;18;10;0;124;160
"3860";"360610169004";43;36;93;3;9;184
"3861";"360610169005";11;1;14;1;10;37
"3862";"360610169006";31;1;9;1;1;43
"3863";"360610170001";2;12;33;0;6;53
"3864";"360610170002";13;8;10;0;13;44
"3865";"360610170003";26;27;14;2;19;88
"3866";"360610170004";22;30;22;1;6;81
"3867";"360610170005";33;200;22;1;14;270
"3868";"360610171001";15;56;13;2;116;202
"3869";"360610171002";15;13;10;0;196;234
"3870";"360610171003";15;17;5;0;118;155
"3871";"360610171004";5;3;11;2;4;25
"3872";"360610171005";72;4;5;0;12;93
"3873";"360610171006";11;25;9;0;31;76
"3874";"360610172001";94;132;32;3;66;327
"3875";"360610172002";11;2;5;2;7;27
"3876";"360610172003";12;11;10;9;10;52
"3877";"360610172004";29;294;6;1;35;365
"3878";"360610172005";19;30;8;0;32;89
"3879";"360610173001";6;39;5;0;66;116
"3880";"360610173002";14;3;4;0;4;25
"3881";"360610173003";55;18;12;1;11;97
"3882";"360610173004";27;32;9;4;5;77
"3883";"360610173005";5;2;6;1;2;16
"3884";"360610173006";9;6;3;0;5;23
"3885";"360610173007";11;5;6;0;10;32
"3886";"360610174011";30;11;6;19;4;70
"3887";"360610174012";35;60;9;0;5;109
"3888";"360610174013";45;49;16;0;32;142
"3889";"360610174021";101;42;19;3;37;202
"3890";"360610175001";24;11;14;0;24;73
"3891";"360610175002";4;6;11;0;16;37
"3892";"360610175003";9;3;4;0;10;26
"3893";"360610175004";3;13;3;0;20;39
"3894";"360610175005";5;22;32;0;14;73
"3895";"360610175006";6;14;9;1;36;66
"3896";"360610175007";21;28;9;2;108;168
"3897";"360610177001";5;8;11;0;5;29
"3898";"360610177002";70;18;6;0;16;110
"3899";"360610177003";9;9;6;0;10;34
"3900";"360610177004";170;11;2;0;7;190
"3901";"360610177005";93;17;10;0;13;133
"3902";"360610177006";53;4;5;0;5;67
"3903";"360610177007";2;9;4;1;5;21
"3904";"360610177008";31;3;5;1;10;50
"3905";"360610178001";22;164;23;1;26;236
"3906";"360610178002";57;60;59;3;16;195
"3907";"360610178003";34;71;30;15;20;170
"3908";"360610179001";20;3;10;0;19;52
"3909";"360610179002";3;1;1;0;2;7
"3910";"360610179003";15;4;5;1;9;34
"3911";"360610179004";15;3;6;4;42;70
"3912";"360610179005";10;2;1;0;29;42
"3913";"360610179006";21;30;10;0;61;122
"3914";"360610179007";10;10;8;0;38;66
"3915";"360610180001";64;25;11;4;9;113
"3916";"360610180002";98;57;47;1;52;255
"3917";"360610180003";42;61;23;2;38;166
"3918";"360610180004";35;10;1;0;1;47
"3919";"360610181001";36;15;5;0;5;61
"3920";"360610181002";7;7;8;0;9;31
"3921";"360610181003";15;10;5;0;12;42
"3922";"360610181004";7;7;12;0;4;30
"3923";"360610181005";20;4;2;0;10;36
"3924";"360610181006";8;2;2;0;27;39
"3925";"360610182001";39;131;2;0;63;235
"3926";"360610182002";103;40;11;0;43;197
"3927";"360610182003";38;84;19;3;79;223
"3928";"360610182004";59;8;5;1;1;74
"3929";"360610182005";133;34;2;0;30;199
"3930";"360610183001";36;11;15;5;29;96
"3931";"360610183002";1;1;5;1;6;14
"3932";"360610183003";58;6;5;0;5;74
"3933";"360610183004";8;7;42;3;48;108
"3934";"360610183005";2;8;215;0;59;284
"3935";"360610183006";42;49;93;7;81;272
"3936";"360610183007";12;33;14;1;34;94
"3937";"360610184001";93;63;46;9;95;306
"3938";"360610184002";15;8;13;0;11;47
"3939";"360610184003";93;18;5;0;13;129
"3940";"360610184004";80;11;16;0;5;112
"3941";"360610185001";2;7;4;2;6;21
"3942";"360610185002";38;38;26;5;53;160
"3943";"360610185003";2;1;0;0;14;17
"3944";"360610186001";82;35;17;1;3;138
"3945";"360610186002";97;76;24;1;31;229
"3946";"360610186003";59;30;3;1;6;99
"3947";"360610187001";31;10;7;0;8;56
"3948";"360610187002";21;4;20;2;4;51
"3949";"360610187003";17;4;3;1;25;50
"3950";"360610187004";7;3;3;1;34;48
"3951";"360610187005";24;17;5;4;38;88
"3952";"360610187006";23;47;21;0;39;130
"3953";"360610188001";163;137;20;0;97;417
"3954";"360610188002";131;119;112;3;30;395
"3955";"360610188003";77;97;37;0;94;305
"3956";"360610188004";66;72;21;1;22;182
"3957";"360610189001";37;22;8;2;28;97
"3958";"360610189002";52;10;6;0;28;96
"3959";"360610189003";219;38;11;0;9;277
"3960";"360610189004";23;56;7;2;21;109
"3961";"360610189005";33;54;4;0;21;112
"3962";"360610189006";111;17;2;1;35;166
"3963";"360610190001";122;112;59;4;29;326
"3964";"360610191001";14;9;9;0;12;44
"3965";"360610191002";15;5;3;0;11;34
"3966";"360610191003";9;2;0;0;18;29
"3967";"360610191004";12;13;5;0;5;35
"3968";"360610191005";47;90;6;0;62;205
"3969";"360610191006";29;18;8;0;84;139
"3970";"360610192000";0;0;0;0;1;1
"3971";"360610192001";398;44;43;3;14;502
"3972";"360610192002";43;11;0;0;3;57
"3973";"360610192003";1;0;0;0;0;1
"3974";"360610193001";40;22;1;0;20;83
"3975";"360610193002";36;47;6;1;22;112
"3976";"360610193003";59;15;3;1;10;88
"3977";"360610193004";34;59;16;0;53;162
"3978";"360610193005";118;217;12;1;69;417
"3979";"360610193006";39;15;3;0;24;81
"3980";"360610194001";172;23;20;0;10;225
"3981";"360610194002";22;14;7;0;21;64
"3982";"360610194003";10;30;8;2;11;61
"3983";"360610194004";43;2;12;3;8;68
"3984";"360610195001";11;26;4;2;45;88
"3985";"360610195002";18;105;30;0;66;219
"3986";"360610195003";93;69;10;3;55;230
"3987";"360610195004";36;15;18;0;14;83
"3988";"360610195005";20;21;13;0;8;62
"3989";"360610196001";30;45;21;1;13;110
"3990";"360610196002";20;27;18;1;44;110
"3991";"360610196003";13;60;44;2;395;514
"3992";"360610197011";15;74;25;0;284;398
"3993";"360610197021";39;41;22;2;63;167
"3994";"360610198001";32;111;42;1;358;544
"3995";"360610198002";1;28;5;3;42;79
"3996";"360610199001";28;14;10;0;45;97
"3997";"360610199002";9;13;5;0;116;143
"3998";"360610199003";29;6;2;0;25;62
"3999";"360610199004";19;7;14;0;4;44
"4000";"360610199005";19;9;6;0;38;72
"4001";"360610199006";18;26;9;0;95;148
"4002";"360610200001";87;69;4;0;18;178
"4003";"360610200002";125;380;110;6;102;723
"4004";"360610201011";6;3;10;0;38;57
"4005";"360610201021";19;31;18;0;51;119
"4006";"360610201022";71;117;8;0;33;229
"4007";"360610201023";10;54;6;0;16;86
"4008";"360610201024";29;22;2;6;38;97
"4009";"360610203001";3;4;1;0;3;11
"4010";"360610203002";0;4;13;0;17;34
"4011";"360610205001";7;16;14;1;258;296
"4012";"360610205002";22;0;16;1;12;51
"4013";"360610205003";1;3;3;0;16;23
"4014";"360610206001";86;113;22;10;25;256
"4015";"360610206002";81;37;39;14;49;220
"4016";"360610207011";2;1;2;0;4;9
"4017";"360610207012";10;4;3;1;10;28
"4018";"360610208001";137;81;6;3;9;236
"4019";"360610208002";131;51;29;0;27;238
"4020";"360610208003";50;42;26;5;36;159
"4021";"360610209011";21;25;10;4;83;143
"4022";"360610209012";136;63;21;0;26;246
"4023";"360610210001";11;8;30;1;8;58
"4024";"360610210002";4;4;6;0;12;26
"4025";"360610210003";71;13;9;0;9;102
"4026";"360610210004";102;4;7;0;35;148
"4027";"360610211001";15;31;11;1;24;82
"4028";"360610211002";12;24;15;0;5;56
"4029";"360610211003";65;85;22;1;26;199
"4030";"360610211004";28;6;8;0;10;52
"4031";"360610211005";26;51;18;0;6;101
"4032";"360610211006";3;13;1;0;1;18
"4033";"360610211007";21;13;5;0;9;48
"4034";"360610212001";37;26;71;5;19;158
"4035";"360610212002";0;1;4;1;45;51
"4036";"360610212003";4;6;5;2;9;26
"4037";"360610212004";16;11;20;7;69;123
"4038";"360610213031";53;41;4;0;20;118
"4039";"360610213032";13;12;22;8;25;80
"4040";"360610213033";226;117;4;0;8;355
"4041";"360610213034";93;69;7;0;24;193
"4042";"360610214001";26;32;8;0;23;89
"4043";"360610214002";46;24;9;0;13;92
"4044";"360610215001";47;109;17;0;31;204
"4045";"360610215002";157;70;13;1;31;272
"4046";"360610216001";64;66;6;1;104;241
"4047";"360610216002";49;16;3;0;9;77
"4048";"360610216003";25;144;2;1;9;181
"4049";"360610216004";82;93;13;0;17;205
"4050";"360610216005";145;60;19;0;34;258
"4051";"360610217031";21;71;26;4;18;140
"4052";"360610218001";63;110;16;4;30;223
"4053";"360610218002";234;205;33;4;48;524
"4054";"360610218003";100;143;54;1;60;358
"4055";"360610218004";55;133;29;1;62;280
"4056";"360610219001";69;46;20;3;45;183
"4057";"360610219002";63;61;8;15;7;154
"4058";"360610219003";129;13;7;0;8;157
"4059";"360610219004";72;9;48;0;6;135
"4060";"360610220001";103;43;10;4;16;176
"4061";"360610220002";41;75;8;7;15;146
"4062";"360610220003";61;25;1;0;5;92
"4063";"360610220004";14;62;4;1;17;98
"4064";"360610220005";93;103;6;2;14;218
"4065";"360610221021";64;55;56;7;23;205
"4066";"360610221022";16;37;26;5;47;131
"4067";"360610222001";59;140;36;4;86;325
"4068";"360610222002";77;324;187;7;180;775
"4069";"360610223011";105;46;13;1;13;178
"4070";"360610223012";210;195;6;1;206;618
"4071";"360610223013";487;303;22;0;38;850
"4072";"360610223014";518;127;5;0;14;664
"4073";"360610223021";102;33;38;2;15;190
"4074";"360610224001";22;22;12;9;19;84
"4075";"360610224002";68;96;31;5;20;220
"4076";"360610224003";289;153;3;4;11;460
"4077";"360610224004";83;5;6;0;8;102
"4078";"360610225001";263;312;19;0;30;624
"4079";"360610225002";63;19;8;3;23;116
"4080";"360610225003";100;165;12;5;132;414
"4081";"360610225004";36;39;6;0;7;88
"4082";"360610225005";303;161;11;0;24;499
"4083";"360610226001";91;237;131;20;33;512
"4084";"360610226002";81;33;33;2;33;182
"4085";"360610226003";93;144;37;2;21;297
"4086";"360610227001";53;43;26;3;37;162
"4087";"360610227002";90;14;52;2;9;167
"4088";"360610227003";154;29;72;5;20;280
"4089";"360610228001";125;76;21;0;52;274
"4090";"360610228002";30;17;12;3;73;135
"4091";"360610228003";48;30;2;2;49;131
"4092";"360610228004";10;17;28;4;6;65
"4093";"360610229001";7;10;6;0;12;35
"4094";"360610229002";127;112;12;3;16;270
"4095";"360610229003";207;205;19;0;36;467
"4096";"360610229004";71;158;0;1;12;242
"4097";"360610229005";115;135;7;2;27;286
"4098";"360610230001";155;33;5;1;13;207
"4099";"360610230002";76;48;4;0;16;144
"4100";"360610230003";30;39;76;4;19;168
"4101";"360610230004";296;99;4;0;12;411
"4102";"360610230005";78;26;3;2;22;131
"4103";"360610231001";90;63;27;3;26;209
"4104";"360610231002";128;102;31;5;25;291
"4105";"360610231003";215;147;39;3;39;443
"4106";"360610232001";71;9;12;0;36;128
"4107";"360610232002";429;82;12;7;15;545
"4108";"360610232003";148;12;2;0;12;174
"4109";"360610232004";139;125;9;2;37;312
"4110";"360610233001";119;110;6;1;35;271
"4111";"360610233002";119;98;13;1;10;241
"4112";"360610233003";146;143;34;0;13;336
"4113";"360610234001";245;83;20;27;12;387
"4114";"360610234002";110;78;24;10;12;234
"4115";"360610235011";49;14;11;0;6;80
"4116";"360610235012";241;139;7;4;19;410
"4117";"360610235013";19;8;21;0;2;50
"4118";"360610235014";132;56;32;0;4;224
"4119";"360610235021";34;114;20;0;31;199
"4120";"360610236001";30;5;32;9;9;85
"4121";"360610236002";131;34;6;3;12;186
"4122";"360610236003";27;6;7;0;3;43
"4123";"360610236004";63;23;7;2;12;107
"4124";"360610237001";136;317;7;4;16;480
"4125";"360610237002";171;148;29;1;20;369
"4126";"360610237003";131;154;28;0;13;326
"4127";"360610238010";0;0;1;0;0;1
"4128";"360610238011";13;7;2;0;9;31
"4129";"360610238021";1;0;0;1;0;2
"4130";"360610238022";8;1;1;0;1;11
"4131";"360610239001";49;15;9;2;19;94
"4132";"360610239002";136;46;7;0;16;205
"4133";"360610240001";1;5;1;3;5;15
"4134";"360610241001";45;8;9;1;8;71
"4135";"360610241002";47;12;7;2;21;89
"4136";"360610241003";90;124;3;2;9;228
"4137";"360610241004";165;100;5;0;9;279
"4138";"360610241005";36;28;2;0;6;72
"4139";"360610242001";45;12;39;10;40;146
"4140";"360610242002";12;1;32;4;50;99
"4141";"360610242003";6;11;32;8;151;208
"4142";"360610243011";51;62;7;1;6;127
"4143";"360610243012";58;28;91;1;20;198
"4144";"360610243013";30;43;7;0;5;85
"4145";"360610243020";1;1;0;1;0;3
"4146";"360610243021";475;18;14;1;16;524
"4147";"360610243023";302;8;1;0;3;314
"4148";"360610245001";95;325;19;0;19;458
"4149";"360610245002";53;60;5;0;9;127
"4150";"360610245003";80;141;5;2;13;241
"4151";"360610245004";166;96;36;0;29;327
"4152";"360610245005";73;43;12;0;17;145
"4153";"360610245006";83;39;5;0;11;138
"4154";"360610245007";80;85;5;0;11;181
"4155";"360610247001";32;62;17;3;9;123
"4156";"360610247002";45;70;5;4;14;138
"4157";"360610247003";42;129;3;0;1;175
"4158";"360610247004";97;144;71;0;20;332
"4159";"360610247005";103;93;31;1;7;235
"4160";"360610249001";51;30;12;2;8;103
"4161";"360610251001";90;62;30;0;33;215
"4162";"360610251002";14;64;47;0;17;142
"4163";"360610253001";95;167;15;1;5;283
"4164";"360610253002";98;92;4;1;14;209
"4165";"360610253003";102;109;33;2;25;271
"4166";"360610253004";87;34;14;0;23;158
"4167";"360610253005";229;132;4;1;17;383
"4168";"360610253006";56;37;27;0;13;133
"4169";"360610255001";21;9;20;1;4;55
"4170";"360610255002";43;44;11;0;18;116
"4171";"360610255003";96;62;4;1;6;169
"4172";"360610255004";26;13;14;1;3;57
"4173";"360610257001";60;94;23;2;91;270
"4174";"360610257002";28;15;32;2;46;123
"4175";"360610257003";11;75;1;2;28;117
"4176";"360610259001";789;245;48;12;11;1105
"4177";"360610259002";22;109;80;7;22;240
"4178";"360610261001";114;68;19;0;35;236
"4179";"360610261002";40;52;3;0;9;104
"4180";"360610261003";49;31;4;0;3;87
"4181";"360610261004";83;159;2;2;13;259
"4182";"360610261005";91;102;197;3;11;404
"4183";"360610261006";23;193;5;0;2;223
"4184";"360610261007";38;91;25;3;12;169
"4185";"360610263001";36;51;25;0;15;127
"4186";"360610263002";219;57;16;0;13;305
"4187";"360610263003";43;95;17;3;21;179
"4188";"360610263004";138;135;16;0;15;304
"4189";"360610263005";128;199;8;2;7;344
"4190";"360610265001";34;21;3;0;2;60
"4191";"360610265002";119;57;47;0;20;243
"4192";"360610265003";9;19;23;1;4;56
"4193";"360610265004";101;99;14;1;14;229
"4194";"360610265005";23;6;3;0;18;50
"4195";"360610267001";129;11;34;3;9;186
"4196";"360610269001";61;37;7;0;6;111
"4197";"360610269002";67;168;11;0;4;250
"4198";"360610269003";30;26;24;0;8;88
"4199";"360610269004";53;226;16;1;24;320
"4200";"360610269005";78;65;9;0;24;176
"4201";"360610269006";240;126;6;1;6;379
"4202";"360610271001";142;123;10;1;7;283
"4203";"360610271002";89;250;9;2;24;374
"4204";"360610271003";73;48;40;4;14;179
"4205";"360610271004";118;85;22;1;8;234
"4206";"360610271005";48;8;4;0;5;65
"4207";"360610273001";40;47;25;0;10;122
"4208";"360610273002";40;6;7;1;6;60
"4209";"360610273003";91;105;14;1;22;233
"4210";"360610273004";18;12;12;0;6;48
"4211";"360610275000";0;0;1;0;0;1
"4212";"360610275001";10;7;8;1;5;31
"4213";"360610275002";0;0;1;0;0;1
"4214";"360610277001";254;97;17;1;17;386
"4215";"360610277002";38;62;3;4;8;115
"4216";"360610277003";42;215;7;3;17;284
"4217";"360610277004";93;43;2;0;2;140
"4218";"360610279001";12;17;10;1;14;54
"4219";"360610279002";219;170;15;1;6;411
"4220";"360610279003";119;160;8;4;17;308
"4221";"360610279004";250;224;49;2;20;545
"4222";"360610279005";370;29;13;2;2;416
"4223";"360610279006";22;21;11;0;5;59
"4224";"360610279007";65;23;4;0;1;93
"4225";"360610281001";4;2;2;1;1;10
"4226";"360610281002";65;31;32;3;11;142
"4227";"360610283001";14;30;6;0;5;55
"4228";"360610283002";456;289;47;1;18;811
"4229";"360610283003";69;64;13;3;5;154
"4230";"360610283004";113;207;7;0;15;342
"4231";"360610285001";134;280;31;2;28;475
"4232";"360610285002";224;201;3;1;5;434
"4233";"360610285003";140;179;4;1;3;327
"4234";"360610285004";374;400;10;1;11;796
"4235";"360610287001";78;251;85;2;23;439
"4236";"360610287002";117;142;14;1;7;281
"4237";"360610287003";217;737;29;3;19;1005
"4238";"360610291001";212;105;2;4;7;330
"4239";"360610291002";47;45;13;1;4;110
"4240";"360610291003";199;58;2;0;11;270
"4241";"360610291004";376;96;17;0;12;501
"4242";"360610291005";66;117;4;0;12;199
"4243";"360610291006";121;93;1;0;9;224
"4244";"360610291007";204;139;6;0;6;355
"4245";"360610293001";94;310;8;2;15;429
"4246";"360610293002";57;26;7;0;9;99
"4247";"360610293003";107;237;27;14;19;404
"4248";"360610293004";216;272;39;1;16;544
"4249";"360610293005";71;102;2;1;11;187
"4250";"360610295001";66;218;47;1;13;345
"4251";"360610295002";67;437;26;1;24;555
"4252";"360610295003";128;86;18;2;6;240
"4253";"360610295004";210;27;44;6;11;298
"4254";"360610297001";11;171;45;1;7;235
"4255";"360610299000";0;0;0;0;1;1
"4256";"360610299001";336;19;11;0;3;369
"4257";"360610299002";30;44;62;5;18;159
"4258";"360610303001";197;323;36;0;11;567
"4259";"360610303002";69;45;14;4;15;147
"4260";"360610303003";94;93;29;1;15;232
"4261";"360610307001";47;76;48;4;11;186
"4262";"360610307002";7;6;41;3;0;57
"4263";"360610307003";102;60;15;0;8;185
"4264";"360610309001";210;43;41;0;14;308
"4265";"360610309002";32;23;49;2;13;119
"4266";"360610309003";117;11;22;0;8;158
"4267";"360610309004";198;82;77;2;11;370
"4268";"360610311001";21;73;48;2;11;155
"4269";"360610317031";3;50;26;1;19;99
"4270";"360610317032";5;69;25;1;3;103
"4271";"360610317041";11;76;12;0;5;104
"4272";"360610317042";21;7;4;6;1;39
"4273";"360610317043";10;86;17;0;5;118
"4274";"360610317044";11;32;71;3;10;127
"4275";"360610319001";0;5;4;0;11;20
"4276";"360810001001";31;165;183;26;26;431
"4277";"360810002001";40;7;113;37;20;217
"4278";"360810002002";80;12;146;27;25;290
"4279";"360810004001";47;16;180;10;5;258
"4280";"360810004002";33;10;107;59;25;234
"4281";"360810004003";39;11;80;52;34;216
"4282";"360810006001";22;19;76;14;15;146
"4283";"360810006002";9;9;46;28;14;106
"4284";"360810006003";44;59;128;64;11;306
"4285";"360810007001";26;18;73;19;17;153
"4286";"360810007002";10;38;53;20;19;140
"4287";"360810007003";9;30;116;22;20;197
"4288";"360810007004";17;249;170;27;32;495
"4289";"360810008001";42;14;81;70;26;233
"4290";"360810008002";56;4;162;39;34;295
"4291";"360810010001";17;11;68;8;13;117
"4292";"360810010002";44;10;154;22;25;255
"4293";"360810012001";51;8;100;20;15;194
"4294";"360810012002";37;6;92;41;12;188
"4295";"360810012003";54;18;106;24;24;226
"4296";"360810014001";30;6;167;25;16;244
"4297";"360810014002";31;7;83;29;27;177
"4298";"360810014003";29;8;93;30;73;233
"4299";"360810016001";48;11;78;14;17;168
"4300";"360810016002";93;28;85;33;16;255
"4301";"360810018001";41;12;53;10;30;146
"4302";"360810018002";52;26;88;40;31;237
"4303";"360810019001";40;47;420;90;45;642
"4304";"360810020001";30;6;156;34;24;250
"4305";"360810022001";26;7;96;21;19;169
"4306";"360810022002";28;13;66;17;15;139
"4307";"360810024001";65;1;31;13;14;124
"4308";"360810024002";49;33;140;27;14;263
"4309";"360810025001";9;8;2;0;1;20
"4310";"360810025002";33;12;0;0;2;47
"4311";"360810025003";80;33;2;0;3;118
"4312";"360810025004";98;8;2;0;3;111
"4313";"360810025005";50;10;2;0;1;63
"4314";"360810025006";40;9;8;1;4;62
"4315";"360810026001";10;2;43;17;14;86
"4316";"360810026002";35;25;34;28;17;139
"4317";"360810028001";91;15;65;38;21;230
"4318";"360810028002";65;23;86;37;16;227
"4319";"360810030001";31;4;53;41;15;144
"4320";"360810031001";13;42;79;17;9;160
"4321";"360810031002";12;16;149;15;27;219
"4322";"360810032001";52;27;92;53;44;268
"4323";"360810033001";17;72;129;1;33;252
"4324";"360810033002";15;9;116;17;25;182
"4325";"360810033003";11;2;97;118;20;248
"4326";"360810033004";10;2;82;33;14;141
"4327";"360810034001";6;19;101;40;31;197
"4328";"360810034002";28;20;79;63;25;215
"4329";"360810036001";58;11;121;52;22;264
"4330";"360810036002";73;8;112;55;25;273
"4331";"360810037001";163;79;26;7;9;284
"4332";"360810038001";93;19;39;16;8;175
"4333";"360810038002";16;3;58;18;33;128
"4334";"360810039001";27;6;128;63;20;244
"4335";"360810040011";18;3;52;24;15;112
"4336";"360810040012";47;3;40;23;28;141
"4337";"360810040021";17;16;74;37;22;166
"4338";"360810042001";30;15;123;48;38;254
"4339";"360810042002";13;2;52;9;7;83
"4340";"360810042003";48;3;53;34;22;160
"4341";"360810043001";230;52;60;28;17;387
"4342";"360810043002";1;1;30;27;4;63
"4343";"360810044011";13;12;46;34;31;136
"4344";"360810044012";29;5;57;42;20;153
"4345";"360810045001";10;8;33;25;26;102
"4346";"360810045002";0;1;3;4;0;8
"4347";"360810045003";3;7;3;6;0;19
"4348";"360810047001";9;13;77;7;12;118
"4349";"360810047002";168;22;10;3;4;207
"4350";"360810050001";3;2;20;5;1;31
"4351";"360810051001";35;24;38;9;18;124
"4352";"360810051002";53;14;69;13;10;159
"4353";"360810052001";62;8;53;49;21;193
"4354";"360810052002";53;11;66;42;10;182
"4355";"360810053001";13;8;78;1;13;113
"4356";"360810053002";103;9;57;6;27;202
"4357";"360810053003";22;1;22;0;2;47
"4358";"360810053004";36;8;63;1;20;128
"4359";"360810054001";5;3;24;12;13;57
"4360";"360810054002";13;6;47;16;23;105
"4361";"360810054003";26;3;102;48;37;216
"4362";"360810054004";51;8;108;37;19;223
"4363";"360810055001";54;104;222;64;32;476
"4364";"360810057001";29;38;52;10;11;140
"4365";"360810057002";13;19;23;14;18;87
"4366";"360810057003";65;105;54;2;13;239
"4367";"360810058001";25;20;158;44;26;273
"4368";"360810058002";8;2;31;24;11;76
"4369";"360810058003";15;8;43;28;29;123
"4370";"360810058004";10;27;55;14;20;126
"4371";"360810059001";17;15;53;0;11;96
"4372";"360810059002";63;11;108;2;7;191
"4373";"360810059003";12;88;33;0;27;160
"4374";"360810061001";29;63;72;1;13;178
"4375";"360810061002";50;100;43;0;16;209
"4376";"360810061003";29;121;14;0;19;183
"4377";"360810061004";35;10;31;0;5;81
"4378";"360810062011";4;1;14;1;2;22
"4379";"360810062012";31;7;107;31;65;241
"4380";"360810062021";1;4;36;16;8;65
"4381";"360810062022";7;4;47;15;12;85
"4382";"360810062023";11;7;55;22;44;139
"4383";"360810062024";70;2;44;7;2;125
"4384";"360810062025";39;4;47;18;6;114
"4385";"360810062026";17;1;43;21;7;89
"4386";"360810062027";26;0;63;17;33;139
"4387";"360810063001";16;16;46;2;13;93
"4388";"360810063002";39;17;41;3;9;109
"4389";"360810063003";27;14;23;1;8;73
"4390";"360810063004";25;39;48;2;21;135
"4391";"360810065011";40;20;24;3;4;91
"4392";"360810065012";14;3;47;0;8;72
"4393";"360810065013";18;8;26;1;0;53
"4394";"360810065021";29;101;67;8;17;222
"4395";"360810065022";17;6;71;4;4;102
"4396";"360810065023";40;21;52;2;24;139
"4397";"360810069001";28;10;83;1;9;131
"4398";"360810069002";85;16;125;3;36;265
"4399";"360810069003";12;36;31;2;11;92
"4400";"360810071001";5;8;38;4;11;66
"4401";"360810071002";13;3;4;0;8;28
"4402";"360810071003";14;1;35;0;4;54
"4403";"360810071004";22;127;60;2;47;258
"4404";"360810073001";30;8;52;3;22;115
"4405";"360810073002";25;2;18;1;2;48
"4406";"360810073003";79;15;45;0;16;155
"4407";"360810075001";15;1;52;0;14;82
"4408";"360810075002";47;34;25;5;13;124
"4409";"360810075003";10;6;9;1;6;32
"4410";"360810077001";35;11;67;5;15;133
"4411";"360810079001";35;11;174;20;13;253
"4412";"360810079002";4;5;33;14;9;65
"4413";"360810081001";33;45;100;40;13;231
"4414";"360810083001";28;18;253;27;11;337
"4415";"360810083002";59;46;90;36;32;263
"4416";"360810085001";53;4;165;44;9;275
"4417";"360810085002";3;24;71;30;6;134
"4418";"360810086001";38;8;63;27;32;168
"4419";"360810086002";27;9;42;37;15;130
"4420";"360810087001";468;18;12;1;9;508
"4421";"360810087002";21;17;29;10;11;88
"4422";"360810087003";89;41;8;1;5;144
"4423";"360810088001";53;10;139;69;17;288
"4424";"360810088002";17;37;102;27;38;221
"4425";"360810091001";5;3;24;6;11;49
"4426";"360810091002";31;13;99;14;13;170
"4427";"360810094001";43;23;60;15;76;217
"4428";"360810094002";36;4;99;15;29;183
"4429";"360810095001";10;3;28;1;9;51
"4430";"360810095002";17;6;45;8;17;93
"4431";"360810096001";63;4;108;31;62;268
"4432";"360810096002";79;13;102;18;49;261
"4433";"360810097001";14;2;10;1;5;32
"4434";"360810097002";2;10;22;15;8;57
"4435";"360810097003";5;1;16;3;3;28
"4436";"360810097004";16;15;21;0;18;70
"4437";"360810098001";17;13;96;19;22;167
"4438";"360810098002";83;11;106;12;36;248
"4439";"360810099001";4;20;3;0;3;30
"4440";"360810100001";149;37;70;17;56;329
"4441";"360810100002";116;13;113;33;49;324
"4442";"360810101001";7;10;57;9;20;103
"4443";"360810101002";14;19;65;3;12;113
"4444";"360810102001";80;3;60;19;31;193
"4445";"360810102002";40;2;104;21;45;212
"4446";"360810103001";12;18;31;4;11;76
"4447";"360810103002";10;8;29;6;11;64
"4448";"360810103003";12;8;20;0;7;47
"4449";"360810103004";28;15;19;0;10;72
"4450";"360810104001";58;54;95;5;49;261
"4451";"360810104002";119;4;163;30;44;360
"4452";"360810105001";31;4;7;2;2;46
"4453";"360810105002";13;4;4;3;7;31
"4454";"360810105003";13;12;9;2;17;53
"4455";"360810105004";6;3;17;1;1;28
"4456";"360810106001";16;1;94;18;49;178
"4457";"360810106002";74;17;206;21;67;385
"4458";"360810107011";1;4;17;18;7;47
"4459";"360810108001";43;8;114;28;38;231
"4460";"360810108002";25;4;154;26;60;269
"4461";"360810110001";20;4;69;22;24;139
"4462";"360810110002";101;9;295;26;48;479
"4463";"360810111001";46;7;26;7;10;96
"4464";"360810111002";6;8;60;5;6;85
"4465";"360810112001";99;10;110;20;30;269
"4466";"360810112002";30;11;98;9;27;175
"4467";"360810113001";14;2;9;1;13;39
"4468";"360810113002";29;18;27;1;10;85
"4469";"360810113003";11;47;92;1;13;164
"4470";"360810114001";59;6;137;75;20;297
"4471";"360810115001";16;25;92;12;34;179
"4472";"360810115002";7;12;59;0;76;154
"4473";"360810116001";114;18;41;18;16;207
"4474";"360810116002";37;11;104;36;28;216
"4475";"360810117001";8;37;65;2;11;123
"4476";"360810117002";7;6;12;1;4;30
"4477";"360810117003";13;20;87;7;24;151
"4478";"360810117004";14;5;36;2;6;63
"4479";"360810118001";43;2;146;35;53;279
"4480";"360810118002";20;1;60;29;44;154
"4481";"360810119001";8;13;84;1;7;113
"4482";"360810119002";8;1;36;5;14;64
"4483";"360810120001";8;2;38;8;15;71
"4484";"360810120002";11;7;135;22;25;200
"4485";"360810121001";16;3;32;3;6;60
"4486";"360810121002";7;2;14;0;12;35
"4487";"360810122001";24;103;115;21;51;314
"4488";"360810122002";93;14;85;21;31;244
"4489";"360810123011";12;46;40;69;23;190
"4490";"360810123012";3;4;41;38;11;97
"4491";"360810123013";4;30;30;16;16;96
"4492";"360810124001";21;31;46;21;17;136
"4493";"360810124002";23;13;85;45;18;184
"4494";"360810125001";5;6;60;10;15;96
"4495";"360810125002";4;34;25;5;18;86
"4496";"360810126011";30;2;71;26;22;151
"4497";"360810126012";19;6;97;24;17;163
"4498";"360810126021";36;6;57;11;32;142
"4499";"360810126022";60;8;89;46;22;225
"4500";"360810128001";6;2;30;18;11;67
"4501";"360810128002";46;8;51;9;14;128
"4502";"360810130001";4;3;34;33;7;81
"4503";"360810130002";26;27;28;10;9;100
"4504";"360810132001";15;1;17;1;6;40
"4505";"360810132002";12;6;51;7;19;95
"4506";"360810134001";318;5;20;3;11;357
"4507";"360810134002";6;4;299;1;23;333
"4508";"360810134003";85;3;90;5;2;185
"4509";"360810134004";14;0;11;1;1;27
"4510";"360810135001";6;3;30;18;10;67
"4511";"360810136001";5;2;20;1;13;41
"4512";"360810136002";31;118;20;0;5;174
"4513";"360810137001";35;18;104;24;24;205
"4514";"360810138001";10;4;21;0;9;44
"4515";"360810138002";62;11;234;18;38;363
"4516";"360810140001";19;4;138;9;11;181
"4517";"360810140002";59;9;126;5;18;217
"4518";"360810141001";11;34;14;1;5;65
"4519";"360810141002";15;9;81;78;19;202
"4520";"360810142011";16;14;97;12;17;156
"4521";"360810142012";26;11;148;15;62;262
"4522";"360810142021";45;30;147;21;32;275
"4523";"360810142022";44;8;79;21;10;162
"4524";"360810143001";11;2;46;2;11;72
"4525";"360810143002";48;186;65;1;33;333
"4526";"360810144001";34;24;188;10;51;307
"4527";"360810145001";12;2;93;59;11;177
"4528";"360810145002";60;19;79;26;7;191
"4529";"360810147001";4;1;42;6;12;65
"4530";"360810147002";36;6;62;16;11;131
"4531";"360810147003";13;18;51;0;9;91
"4532";"360810148001";54;7;87;15;47;210
"4533";"360810149001";18;12;29;4;6;69
"4534";"360810149002";22;15;68;8;17;130
"4535";"360810150001";329;3;61;20;22;435
"4536";"360810150002";40;8;50;12;20;130
"4537";"360810151001";36;20;48;11;5;120
"4538";"360810151002";19;25;58;30;9;141
"4539";"360810152001";10;3;75;16;29;133
"4540";"360810152002";26;5;78;35;26;170
"4541";"360810153001";9;6;58;11;12;96
"4542";"360810153002";17;13;75;11;9;125
"4543";"360810154001";34;15;42;11;24;126
"4544";"360810154002";31;15;127;37;29;239
"4545";"360810155001";20;90;70;0;23;203
"4546";"360810155002";24;76;73;0;28;201
"4547";"360810156001";65;6;96;28;26;221
"4548";"360810156002";36;9;71;27;51;194
"4549";"360810157001";15;27;42;23;39;146
"4550";"360810158011";24;6;31;27;25;113
"4551";"360810158012";29;6;38;29;15;117
"4552";"360810158013";46;22;79;34;39;220
"4553";"360810158021";99;14;108;20;98;339
"4554";"360810158022";129;14;91;19;35;288
"4555";"360810158023";49;14;49;7;34;153
"4556";"360810159001";25;18;57;0;12;112
"4557";"360810159002";41;13;7;7;19;87
"4558";"360810159003";30;2;14;4;7;57
"4559";"360810159004";17;5;37;2;8;69
"4560";"360810161001";9;5;25;5;13;57
"4561";"360810161002";20;20;35;1;24;100
"4562";"360810163001";14;1;38;13;3;69
"4563";"360810163002";47;22;4;11;2;86
"4564";"360810163003";172;11;7;7;10;207
"4565";"360810164001";25;2;97;49;28;201
"4566";"360810164002";72;15;92;41;60;280
"4567";"360810166001";108;18;149;12;53;340
"4568";"360810166002";33;107;40;7;18;205
"4569";"360810168001";80;7;91;24;36;238
"4570";"360810168002";97;7;82;84;66;336
"4571";"360810169001";30;0;26;10;5;71
"4572";"360810169002";60;4;16;0;19;99
"4573";"360810169003";14;8;30;5;12;69
"4574";"360810169004";10;10;12;2;6;40
"4575";"360810170001";32;1;83;15;25;156
"4576";"360810170002";50;16;76;13;19;174
"4577";"360810171001";4;31;123;34;12;204
"4578";"360810172001";85;6;51;34;29;205
"4579";"360810172002";10;13;41;31;21;116
"4580";"360810174001";48;5;30;39;14;136
"4581";"360810174002";30;2;75;36;54;197
"4582";"360810176001";49;5;77;21;22;174
"4583";"360810176002";25;6;25;5;6;67
"4584";"360810178001";54;4;84;13;15;170
"4585";"360810178002";31;3;50;36;19;139
"4586";"360810179001";6;0;67;17;12;102
"4587";"360810179002";37;34;51;12;23;157
"4588";"360810180001";39;13;67;29;33;181
"4589";"360810181011";22;15;28;0;2;67
"4590";"360810181012";18;6;13;3;2;42
"4591";"360810181013";30;3;8;0;6;47
"4592";"360810181021";9;5;8;3;6;31
"4593";"360810181022";30;46;8;1;7;92
"4594";"360810181023";29;67;11;4;17;128
"4595";"360810182001";34;7;23;25;11;100
"4596";"360810182002";18;1;45;26;22;112
"4597";"360810183001";11;2;61;7;6;87
"4598";"360810183002";31;2;23;0;7;63
"4599";"360810183003";32;13;12;0;12;69
"4600";"360810183004";46;35;23;0;16;120
"4601";"360810183005";21;93;20;4;9;147
"4602";"360810184011";106;12;98;80;22;318
"4603";"360810184021";18;2;36;28;15;99
"4604";"360810184022";8;5;25;14;9;61
"4605";"360810185011";15;2;91;0;15;123
"4606";"360810185012";4;3;10;2;1;20
"4607";"360810185013";35;20;42;2;12;111
"4608";"360810185021";13;2;4;0;5;24
"4609";"360810185022";67;7;19;1;5;99
"4610";"360810185023";16;22;3;0;14;55
"4611";"360810186001";64;7;102;48;29;250
"4612";"360810187001";15;2;59;18;8;102
"4613";"360810187002";5;2;11;0;5;23
"4614";"360810187003";10;4;57;4;4;79
"4615";"360810188001";18;2;81;38;31;170
"4616";"360810189001";187;3;50;2;24;266
"4617";"360810189002";24;4;84;13;7;132
"4618";"360810189003";12;2;27;3;4;48
"4619";"360810190001";17;7;43;56;26;149
"4620";"360810190002";18;4;72;45;19;158
"4621";"360810192001";99;10;96;32;45;282
"4622";"360810192002";10;10;37;21;15;93
"4623";"360810194001";43;8;42;32;38;163
"4624";"360810194002";66;4;66;49;22;207
"4625";"360810196001";23;1;33;26;33;116
"4626";"360810196002";13;4;98;46;17;178
"4627";"360810198001";21;6;42;46;19;134
"4628";"360810198002";33;7;37;37;18;132
"4629";"360810198003";9;5;38;16;11;79
"4630";"360810199001";0;4;208;17;19;248
"4631";"360810199002";4;5;155;126;20;310
"4632";"360810202001";44;13;102;87;40;286
"4633";"360810204001";19;5;86;113;15;238
"4634";"360810204002";23;12;109;131;23;298
"4635";"360810205001";1;4;31;33;12;81
"4636";"360810205002";8;3;91;61;4;167
"4637";"360810206001";68;9;130;84;31;322
"4638";"360810208001";32;6;89;17;34;178
"4639";"360810208002";8;13;145;82;58;306
"4640";"360810212001";5;30;30;17;37;119
"4641";"360810212002";41;5;31;17;11;105
"4642";"360810214001";65;5;16;0;8;94
"4643";"360810214002";31;5;77;17;3;133
"4644";"360810214003";28;18;107;43;29;225
"4645";"360810216001";8;5;19;0;26;58
"4646";"360810216002";58;0;53;10;4;125
"4647";"360810216003";16;2;22;17;9;66
"4648";"360810219001";1;3;102;251;11;368
"4649";"360810220011";3;0;37;1;6;47
"4650";"360810220012";35;5;82;7;6;135
"4651";"360810220013";49;9;53;3;6;120
"4652";"360810220014";1;5;3;0;1;10
"4653";"360810220021";4;2;59;1;5;71
"4654";"360810220022";24;3;52;9;7;95
"4655";"360810220023";66;2;51;4;9;132
"4656";"360810220024";72;5;26;0;16;119
"4657";"360810229001";1;1;13;8;6;29
"4658";"360810230001";19;3;32;6;8;68
"4659";"360810230002";15;2;22;4;12;55
"4660";"360810232001";3;1;12;1;2;19
"4661";"360810232002";12;2;77;3;18;112
"4662";"360810232003";21;6;104;30;17;178
"4663";"360810235001";45;14;25;8;25;117
"4664";"360810235002";30;39;16;6;7;98
"4665";"360810235003";18;23;34;5;6;86
"4666";"360810235004";30;35;29;2;25;121
"4667";"360810236001";17;7;35;8;17;84
"4668";"360810236002";32;9;15;1;12;69
"4669";"360810238001";216;3;21;4;11;255
"4670";"360810238002";15;8;10;6;14;53
"4671";"360810238003";78;3;16;1;8;106
"4672";"360810238004";16;4;24;2;6;52
"4673";"360810240001";27;33;21;7;12;100
"4674";"360810240002";90;17;51;2;12;172
"4675";"360810240003";28;7;4;0;10;49
"4676";"360810243001";12;54;25;32;15;138
"4677";"360810243002";2;2;29;27;15;75
"4678";"360810243003";26;5;69;22;13;135
"4679";"360810243004";18;1;72;48;28;167
"4680";"360810245001";2;0;12;1;0;15
"4681";"360810245002";16;1;27;7;10;61
"4682";"360810245003";0;4;7;1;2;14
"4683";"360810245004";27;2;61;4;2;96
"4684";"360810246001";1;5;27;2;17;52
"4685";"360810247001";6;1;59;1;11;78
"4686";"360810249001";22;22;64;4;5;117
"4687";"360810249002";22;5;20;1;7;55
"4688";"360810249003";14;8;48;1;12;83
"4689";"360810251001";7;7;22;2;16;54
"4690";"360810251002";14;1;24;3;4;46
"4691";"360810251003";56;33;206;3;14;312
"4692";"360810251004";24;12;8;2;12;58
"4693";"360810253011";31;30;18;0;8;87
"4694";"360810253012";40;6;23;0;8;77
"4695";"360810253013";26;5;10;1;10;52
"4696";"360810253014";29;18;12;0;4;63
"4697";"360810253021";10;1;3;0;4;18
"4698";"360810253022";46;26;54;4;5;135
"4699";"360810254001";44;12;69;34;23;182
"4700";"360810254002";10;7;43;7;24;91
"4701";"360810254003";53;17;19;13;7;109
"4702";"360810254004";12;2;24;5;12;55
"4703";"360810254005";35;5;185;72;24;321
"4704";"360810254006";24;6;40;31;21;122
"4705";"360810255001";27;8;131;32;36;234
"4706";"360810257001";35;43;157;22;24;281
"4707";"360810258001";33;8;39;45;16;141
"4708";"360810258002";11;0;21;12;13;57
"4709";"360810259001";24;11;106;5;22;168
"4710";"360810259002";130;15;75;4;30;254
"4711";"360810260001";69;7;26;14;6;122
"4712";"360810260002";14;8;69;41;23;155
"4713";"360810261001";3;4;11;2;17;37
"4714";"360810261002";23;2;95;0;19;139
"4715";"360810261003";44;77;21;4;33;179
"4716";"360810261004";22;28;72;2;16;140
"4717";"360810262001";21;6;40;12;20;99
"4718";"360810263001";27;31;57;15;16;146
"4719";"360810263002";47;30;67;5;24;173
"4720";"360810263003";20;6;81;0;13;120
"4721";"360810264001";38;4;12;21;19;94
"4722";"360810264002";22;1;25;29;28;105
"4723";"360810265001";21;56;118;6;16;217
"4724";"360810265002";22;5;67;0;20;114
"4725";"360810266001";23;9;28;11;25;96
"4726";"360810267001";26;2;25;4;15;72
"4727";"360810267002";10;29;40;1;107;187
"4728";"360810267003";21;9;176;0;49;255
"4729";"360810269011";8;12;12;0;14;46
"4730";"360810269012";22;3;5;0;3;33
"4731";"360810269013";17;1;13;0;3;34
"4732";"360810269014";9;7;41;1;7;65
"4733";"360810269021";30;14;30;0;21;95
"4734";"360810269022";29;3;36;0;19;87
"4735";"360810270001";31;15;65;95;28;234
"4736";"360810271001";44;72;105;0;3;224
"4737";"360810271002";44;2;17;0;1;64
"4738";"360810271003";23;4;77;0;9;113
"4739";"360810271004";11;3;20;0;12;46
"4740";"360810271005";15;0;9;0;17;41
"4741";"360810272001";18;0;13;13;22;66
"4742";"360810272002";15;0;37;11;12;75
"4743";"360810273001";5;3;10;0;2;20
"4744";"360810273002";39;11;14;5;12;81
"4745";"360810273003";77;78;10;1;9;175
"4746";"360810273004";21;5;23;8;15;72
"4747";"360810273005";41;28;78;3;13;163
"4748";"360810274001";15;5;48;15;18;101
"4749";"360810275001";13;0;12;8;0;33
"4750";"360810275002";107;18;70;8;14;217
"4751";"360810275003";118;18;149;4;22;311
"4752";"360810276001";35;8;52;44;12;151
"4753";"360810277001";2;2;5;3;0;12
"4754";"360810277002";37;8;39;9;15;108
"4755";"360810277003";48;3;16;0;11;78
"4756";"360810277004";8;2;17;7;9;43
"4757";"360810277005";102;5;46;3;22;178
"4758";"360810278001";145;44;13;4;18;224
"4759";"360810278002";48;4;1;0;2;55
"4760";"360810279001";31;16;80;12;10;149
"4761";"360810279002";73;19;48;0;10;150
"4762";"360810279003";24;13;8;2;5;52
"4763";"360810279004";7;17;10;0;0;34
"4764";"360810280001";64;8;24;14;18;128
"4765";"360810281001";60;25;51;2;14;152
"4766";"360810281002";53;4;30;1;3;91
"4767";"360810281003";7;10;8;0;5;30
"4768";"360810281004";30;14;5;1;8;58
"4769";"360810282001";29;10;54;17;15;125
"4770";"360810283001";17;11;11;1;0;40
"4771";"360810283002";31;3;7;3;3;47
"4772";"360810283003";21;21;8;0;11;61
"4773";"360810283004";13;13;6;1;14;47
"4774";"360810283005";54;10;4;0;5;73
"4775";"360810284001";40;3;63;36;27;169
"4776";"360810284002";34;3;20;15;9;81
"4777";"360810285001";7;10;5;2;1;25
"4778";"360810285002";2;9;9;0;2;22
"4779";"360810285003";17;3;28;4;4;56
"4780";"360810285004";49;27;40;2;5;123
"4781";"360810287001";35;7;11;1;4;58
"4782";"360810287002";9;4;29;3;2;47
"4783";"360810287003";30;29;65;4;13;141
"4784";"360810287004";36;22;13;2;6;79
"4785";"360810288001";23;0;21;12;9;65
"4786";"360810288002";17;9;28;28;14;96
"4787";"360810288003";18;1;13;32;22;86
"4788";"360810288004";15;3;32;26;28;104
"4789";"360810289001";75;9;25;0;4;113
"4790";"360810289002";28;6;59;1;1;95
"4791";"360810289003";72;44;51;4;22;193
"4792";"360810291001";9;2;39;0;11;61
"4793";"360810291002";25;2;54;2;19;102
"4794";"360810291003";44;17;26;0;7;94
"4795";"360810291004";13;26;51;3;14;107
"4796";"360810293001";5;1;106;18;20;150
"4797";"360810294001";12;4;29;12;18;75
"4798";"360810294002";28;7;34;14;10;93
"4799";"360810294003";16;3;45;24;8;96
"4800";"360810294004";16;1;12;6;6;41
"4801";"360810294005";13;5;18;20;11;67
"4802";"360810294006";7;3;34;25;3;72
"4803";"360810295001";12;2;82;37;3;136
"4804";"360810295002";35;1;185;108;17;346
"4805";"360810297001";12;41;174;45;23;295
"4806";"360810297002";19;6;167;45;16;253
"4807";"360810299001";0;0;5;11;9;25
"4808";"360810306001";11;3;89;27;12;142
"4809";"360810306002";19;10;34;49;7;119
"4810";"360810306003";56;6;37;37;20;156
"4811";"360810306004";5;13;32;22;10;82
"4812";"360810309021";15;1;39;20;9;84
"4813";"360810309022";22;2;99;10;25;158
"4814";"360810309023";18;3;62;10;12;105
"4815";"360810309024";18;5;86;1;11;121
"4816";"360810309025";19;0;93;12;3;127
"4817";"360810309031";48;28;103;5;24;208
"4818";"360810309032";32;3;106;14;21;176
"4819";"360810309033";34;16;96;4;23;173
"4820";"360810309041";22;10;130;20;20;202
"4821";"360810309042";15;5;62;3;18;103
"4822";"360810317001";29;12;103;13;19;176
"4823";"360810317002";3;2;32;3;4;44
"4824";"360810317003";15;3;80;19;6;123
"4825";"360810317004";29;1;39;15;17;101
"4826";"360810320001";12;6;38;37;7;100
"4827";"360810320002";0;4;44;12;9;69
"4828";"360810320003";36;7;115;49;52;259
"4829";"360810320004";9;2;17;34;11;73
"4830";"360810327001";22;11;87;5;22;147
"4831";"360810327002";40;72;41;1;24;178
"4832";"360810328001";23;3;10;24;15;75
"4833";"360810328002";15;6;17;15;18;71
"4834";"360810329001";17;3;39;38;5;102
"4835";"360810329002";7;4;40;20;16;87
"4836";"360810329003";11;10;74;7;19;121
"4837";"360810330001";28;20;36;56;34;174
"4838";"360810330002";7;0;17;12;10;46
"4839";"360810330003";20;5;14;27;16;82
"4840";"360810330004";22;2;46;28;11;109
"4841";"360810330005";6;0;30;20;13;69
"4842";"360810331001";1;2;24;6;4;37
"4843";"360810334011";35;3;37;27;37;139
"4844";"360810334012";37;6;80;119;30;272
"4845";"360810334021";6;1;3;0;1;11
"4846";"360810334022";5;2;3;0;0;10
"4847";"360810334023";0;5;3;0;0;8
"4848";"360810334024";9;5;0;0;0;14
"4849";"360810334025";8;8;12;4;3;35
"4850";"360810334026";10;2;55;45;9;121
"4851";"360810337001";27;2;81;8;28;146
"4852";"360810337002";11;13;60;1;33;118
"4853";"360810339001";11;1;26;4;8;50
"4854";"360810339002";26;1;2;0;2;31
"4855";"360810339003";11;18;51;2;5;87
"4856";"360810347001";46;5;86;29;18;184
"4857";"360810347002";36;3;98;13;13;163
"4858";"360810351001";40;2;21;11;14;88
"4859";"360810351002";50;15;61;11;8;145
"4860";"360810351003";23;35;44;12;15;129
"4861";"360810352001";9;9;33;25;12;88
"4862";"360810352002";6;3;22;42;11;84
"4863";"360810353001";19;8;55;5;19;106
"4864";"360810353002";34;1;51;2;6;94
"4865";"360810357001";43;3;179;7;12;244
"4866";"360810357002";23;14;230;11;23;301
"4867";"360810357003";49;15;136;13;17;230
"4868";"360810358001";11;3;21;13;5;53
"4869";"360810358002";29;6;30;24;12;101
"4870";"360810358003";17;1;14;32;6;70
"4871";"360810358004";0;0;5;10;3;18
"4872";"360810361001";114;9;52;13;36;224
"4873";"360810361002";47;4;52;11;11;125
"4874";"360810363001";46;3;35;8;13;105
"4875";"360810363002";42;10;54;8;16;130
"4876";"360810365001";24;3;95;9;26;157
"4877";"360810365002";41;12;149;20;33;255
"4878";"360810366001";10;5;45;58;10;128
"4879";"360810366002";18;48;50;49;12;177
"4880";"360810367001";13;0;25;4;8;50
"4881";"360810367002";26;7;92;26;27;178
"4882";"360810368001";7;6;20;15;4;52
"4883";"360810368002";33;3;32;14;14;96
"4884";"360810371001";20;4;148;9;15;196
"4885";"360810373001";23;5;80;29;7;144
"4886";"360810373002";232;79;150;13;30;504
"4887";"360810375001";38;13;98;6;12;167
"4888";"360810375002";39;81;79;4;13;216
"4889";"360810376001";3;8;15;13;17;56
"4890";"360810376002";24;5;19;14;15;77
"4891";"360810376003";5;4;11;12;4;36
"4892";"360810376004";10;2;21;29;8;70
"4893";"360810376005";13;1;30;14;12;70
"4894";"360810377001";49;22;216;5;38;330
"4895";"360810377002";37;2;76;5;8;128
"4896";"360810379001";81;16;291;8;26;422
"4897";"360810379002";65;14;192;28;7;306
"4898";"360810379003";31;4;89;21;16;161
"4899";"360810381001";69;16;134;7;27;253
"4900";"360810381002";89;2;164;37;19;311
"4901";"360810381003";45;33;150;21;17;266
"4902";"360810383011";4;46;24;15;2;91
"4903";"360810383021";36;327;81;25;36;505
"4904";"360810384001";9;2;19;13;19;62
"4905";"360810384002";9;6;40;34;31;120
"4906";"360810394001";14;3;15;18;9;59
"4907";"360810394002";9;3;17;20;16;65
"4908";"360810394003";15;1;15;13;5;49
"4909";"360810398001";16;7;8;9;15;55
"4910";"360810398002";3;2;15;2;1;23
"4911";"360810399001";25;1;85;7;9;127
"4912";"360810399002";28;1;40;5;11;85
"4913";"360810399003";34;2;75;32;7;150
"4914";"360810400001";4;1;14;11;6;36
"4915";"360810400002";5;3;5;27;6;46
"4916";"360810401001";140;10;193;30;12;385
"4917";"360810401002";33;33;91;17;19;193
"4918";"360810401003";48;7;109;4;17;185
"4919";"360810402001";7;1;8;16;9;41
"4920";"360810402002";7;0;3;21;14;45
"4921";"360810403001";91;21;218;14;29;373
"4922";"360810403002";19;4;68;4;17;112
"4923";"360810403003";13;0;63;3;10;89
"4924";"360810404001";17;2;10;7;6;42
"4925";"360810404002";14;4;6;40;8;72
"4926";"360810404003";22;22;18;10;13;85
"4927";"360810404004";32;2;18;20;16;88
"4928";"360810405001";18;32;43;14;14;121
"4929";"360810405002";7;13;39;5;21;85
"4930";"360810407001";18;1;96;1;11;127
"4931";"360810407002";31;6;25;6;38;106
"4932";"360810407003";9;0;39;3;4;55
"4933";"360810407004";4;2;67;4;6;83
"4934";"360810407005";5;32;21;0;3;61
"4935";"360810409001";44;23;99;10;9;185
"4936";"360810409002";24;2;39;19;4;88
"4937";"360810409003";21;7;58;3;1;90
"4938";"360810409004";7;8;38;3;6;62
"4939";"360810411001";61;9;70;7;5;152
"4940";"360810411002";55;2;90;10;11;168
"4941";"360810413001";65;19;128;8;15;235
"4942";"360810413002";24;3;122;4;6;159
"4943";"360810414001";21;5;46;80;20;172
"4944";"360810414002";37;9;1;10;4;61
"4945";"360810414003";31;5;31;41;17;125
"4946";"360810415001";46;7;126;20;25;224
"4947";"360810415002";38;10;48;8;12;116
"4948";"360810424001";43;12;37;39;17;148
"4949";"360810424002";17;3;7;6;8;41
"4950";"360810424003";14;7;10;7;2;40
"4951";"360810426001";13;3;5;3;3;27
"4952";"360810427001";44;13;129;9;16;211
"4953";"360810427002";36;11;187;10;22;266
"4954";"360810432001";9;13;21;17;29;89
"4955";"360810434001";26;5;26;24;18;99
"4956";"360810437011";22;7;79;6;18;132
"4957";"360810437012";15;2;44;14;11;86
"4958";"360810437021";115;14;26;12;6;173
"4959";"360810437022";81;5;285;19;11;401
"4960";"360810437023";76;6;128;17;20;247
"4961";"360810439001";24;4;149;16;11;204
"4962";"360810439002";54;22;249;6;24;355
"4963";"360810440001";32;9;117;78;28;264
"4964";"360810440002";49;5;45;37;14;150
"4965";"360810440003";44;1;58;25;15;143
"4966";"360810443011";35;5;84;6;10;140
"4967";"360810443012";27;7;73;9;7;123
"4968";"360810443021";51;4;90;4;11;160
"4969";"360810443022";51;10;50;5;11;127
"4970";"360810443023";105;139;90;6;26;366
"4971";"360810444001";30;4;66;4;23;127
"4972";"360810444002";14;91;130;14;31;280
"4973";"360810444003";40;5;63;36;96;240
"4974";"360810446011";12;17;15;0;27;71
"4975";"360810446012";33;22;12;3;13;83
"4976";"360810446021";12;16;35;10;25;98
"4977";"360810446022";33;9;14;0;11;67
"4978";"360810448001";18;23;76;10;63;190
"4979";"360810448002";3;1;35;5;4;48
"4980";"360810450001";9;2;47;3;24;85
"4981";"360810450002";5;11;38;13;19;86
"4982";"360810452001";16;5;37;4;8;70
"4983";"360810454001";20;3;98;8;9;138
"4984";"360810454002";35;3;56;9;20;123
"4985";"360810455001";14;5;2;0;2;23
"4986";"360810455002";4;4;1;0;2;11
"4987";"360810455003";18;3;18;1;2;42
"4988";"360810455004";20;0;4;0;1;25
"4989";"360810455005";7;1;1;0;1;10
"4990";"360810455006";0;0;6;0;1;7
"4991";"360810456001";13;1;32;5;24;75
"4992";"360810457001";20;3;110;6;8;147
"4993";"360810457002";16;7;117;0;8;148
"4994";"360810458001";38;65;118;5;29;255
"4995";"360810459001";26;1;106;10;7;150
"4996";"360810459002";26;1;64;1;9;101
"4997";"360810460001";21;2;12;0;23;58
"4998";"360810460002";64;4;12;2;15;97
"4999";"360810460003";29;9;13;3;5;59
"5000";"360810461001";23;12;162;3;18;218
"5001";"360810462001";53;8;45;6;22;134
"5002";"360810462002";42;48;61;5;54;210
"5003";"360810462003";92;36;130;5;28;291
"5004";"360810463001";39;4;64;0;8;115
"5005";"360810463002";37;19;135;6;18;215
"5006";"360810464001";15;3;59;1;6;84
"5007";"360810465001";77;20;79;33;14;223
"5008";"360810465002";28;5;58;2;23;116
"5009";"360810466001";18;41;90;2;6;157
"5010";"360810466002";3;4;55;0;14;76
"5011";"360810467001";64;4;42;1;7;118
"5012";"360810467002";57;5;153;1;3;219
"5013";"360810467003";27;6;64;0;12;109
"5014";"360810467004";59;4;16;0;10;89
"5015";"360810468001";26;14;37;0;32;109
"5016";"360810468002";44;18;137;38;40;277
"5017";"360810469001";49;22;46;7;23;147
"5018";"360810469002";80;3;29;1;4;117
"5019";"360810469003";11;0;33;0;5;49
"5020";"360810469004";6;3;6;3;8;26
"5021";"360810469005";27;2;4;0;3;36
"5022";"360810470001";28;10;40;2;19;99
"5023";"360810470002";98;29;52;21;34;234
"5024";"360810471001";56;39;35;1;23;154
"5025";"360810471002";43;6;44;0;10;103
"5026";"360810472001";35;1;29;0;6;71
"5027";"360810472002";11;0;24;14;19;68
"5028";"360810472003";17;2;1;2;3;25
"5029";"360810473001";11;4;105;0;4;124
"5030";"360810473002";16;10;66;6;31;129
"5031";"360810473003";7;0;5;0;2;14
"5032";"360810475001";41;3;65;6;18;133
"5033";"360810475002";48;5;164;5;13;235
"5034";"360810476001";1;0;5;5;7;18
"5035";"360810476002";11;1;4;7;6;29
"5036";"360810478001";19;2;21;15;12;69
"5037";"360810478002";25;4;27;29;8;93
"5038";"360810478003";62;3;62;7;19;153
"5039";"360810479001";56;4;69;12;22;163
"5040";"360810479002";5;1;32;11;20;69
"5041";"360810479003";32;5;39;6;14;96
"5042";"360810480001";40;4;53;14;15;126
"5043";"360810480002";16;1;31;19;9;76
"5044";"360810481001";17;4;78;0;4;103
"5045";"360810481002";29;0;25;2;4;60
"5046";"360810481003";122;3;25;2;13;165
"5047";"360810481004";16;14;8;0;103;141
"5048";"360810482001";61;3;64;49;31;208
"5049";"360810483001";13;8;78;4;16;119
"5050";"360810483002";20;3;145;11;15;194
"5051";"360810484001";31;7;35;16;37;126
"5052";"360810484002";37;9;51;26;21;144
"5053";"360810484003";26;5;31;4;16;82
"5054";"360810484004";32;24;53;31;3;143
"5055";"360810485001";5;5;32;5;3;50
"5056";"360810485002";17;0;29;14;9;69
"5057";"360810485003";15;34;137;10;30;226
"5058";"360810489001";13;8;150;87;27;285
"5059";"360810489002";4;0;45;14;15;78
"5060";"360810492001";217;14;63;27;5;326
"5061";"360810492002";6;1;9;3;9;28
"5062";"360810492003";32;3;49;16;23;123
"5063";"360810493011";10;5;156;44;26;241
"5064";"360810493012";16;0;130;38;20;204
"5065";"360810493021";25;8;69;10;22;134
"5066";"360810493022";2;3;113;29;17;164
"5067";"360810495001";10;0;163;19;11;203
"5068";"360810496001";31;1;27;8;24;91
"5069";"360810496002";48;9;30;37;22;146
"5070";"360810496003";11;3;35;33;16;98
"5071";"360810497001";41;5;71;17;11;145
"5072";"360810497002";1;4;61;36;6;108
"5073";"360810499001";9;2;43;15;22;91
"5074";"360810499002";16;1;93;10;19;139
"5075";"360810499003";13;1;84;24;29;151
"5076";"360810500001";40;18;47;18;18;141
"5077";"360810500002";93;1;54;16;22;186
"5078";"360810502011";32;5;36;36;12;121
"5079";"360810502021";42;3;22;18;11;96
"5080";"360810504001";21;1;21;18;10;71
"5081";"360810504002";7;3;8;10;17;45
"5082";"360810505001";37;2;87;10;7;143
"5083";"360810506001";12;7;11;40;4;74
"5084";"360810506002";17;5;1;9;5;37
"5085";"360810507001";20;2;123;28;26;199
"5086";"360810507002";9;1;64;16;20;110
"5087";"360810508001";24;10;25;40;11;110
"5088";"360810508002";16;67;19;19;13;134
"5089";"360810510001";8;3;7;10;8;36
"5090";"360810510002";7;2;9;11;17;46
"5091";"360810511001";3;2;113;16;11;145
"5092";"360810511002";2;3;71;19;5;100
"5093";"360810512001";5;1;59;12;11;88
"5094";"360810512002";13;5;12;9;6;45
"5095";"360810512003";8;3;21;13;8;53
"5096";"360810513001";35;2;103;21;18;179
"5097";"360810513002";4;1;112;14;5;136
"5098";"360810515001";7;11;93;16;11;138
"5099";"360810515002";24;3;82;5;2;116
"5100";"360810515003";6;4;110;48;8;176
"5101";"360810516001";15;2;22;16;10;65
"5102";"360810516002";10;3;14;15;6;48
"5103";"360810517001";16;1;80;10;21;128
"5104";"360810517002";31;3;134;28;14;210
"5105";"360810518001";49;7;15;10;10;91
"5106";"360810518002";6;2;13;11;12;44
"5107";"360810520001";30;17;34;16;8;105
"5108";"360810521001";3;2;33;11;3;52
"5109";"360810521002";5;12;106;30;31;184
"5110";"360810522001";16;2;32;26;9;85
"5111";"360810524001";21;0;8;8;4;41
"5112";"360810524002";15;2;22;4;25;68
"5113";"360810525001";8;0;140;36;20;204
"5114";"360810525002";11;1;51;51;7;121
"5115";"360810526001";10;4;28;15;8;65
"5116";"360810526002";3;8;18;13;25;67
"5117";"360810528001";53;9;34;9;7;112
"5118";"360810530001";7;2;29;13;11;62
"5119";"360810530002";18;1;18;14;10;61
"5120";"360810531001";11;5;156;96;26;294
"5121";"360810531002";13;1;81;10;8;113
"5122";"360810531003";8;8;53;60;12;141
"5123";"360810532001";15;0;39;14;4;72
"5124";"360810532002";16;1;16;13;12;58
"5125";"360810534011";15;9;18;16;8;66
"5126";"360810534012";12;2;14;15;10;53
"5127";"360810535001";12;8;88;45;24;177
"5128";"360810536011";7;4;19;17;10;57
"5129";"360810536012";4;1;6;15;4;30
"5130";"360810538001";22;0;7;10;16;55
"5131";"360810538002";3;1;3;13;9;29
"5132";"360810539001";59;13;159;63;14;308
"5133";"360810539002";33;19;50;13;10;125
"5134";"360810539003";68;19;43;5;13;148
"5135";"360810540001";36;2;55;66;21;180
"5136";"360810540002";29;3;49;77;21;179
"5137";"360810540003";14;3;29;11;10;67
"5138";"360810542001";36;13;27;20;25;121
"5139";"360810542002";66;7;69;27;35;204
"5140";"360810542003";48;5;45;20;49;167
"5141";"360810542004";14;2;30;14;20;80
"5142";"360810545001";52;17;74;9;25;177
"5143";"360810545002";40;38;42;1;4;125
"5144";"360810545003";31;82;28;2;13;156
"5145";"360810547001";36;166;28;0;12;242
"5146";"360810547002";53;28;31;5;11;128
"5147";"360810547003";45;16;18;1;11;91
"5148";"360810548001";44;3;16;23;26;112
"5149";"360810548002";11;0;19;9;18;57
"5150";"360810549001";32;15;39;7;7;100
"5151";"360810549002";47;6;27;2;11;93
"5152";"360810549003";40;18;24;3;9;94
"5153";"360810549004";41;19;6;0;10;76
"5154";"360810551001";20;20;55;0;5;100
"5155";"360810551002";16;8;9;0;6;39
"5156";"360810551003";24;15;9;3;8;59
"5157";"360810551004";29;17;28;2;4;80
"5158";"360810552001";45;4;17;8;11;85
"5159";"360810552002";48;4;63;24;62;201
"5160";"360810553001";6;58;89;4;8;165
"5161";"360810553002";73;67;13;1;19;173
"5162";"360810554001";10;0;31;13;13;67
"5163";"360810554002";9;5;25;14;14;67
"5164";"360810555001";13;14;49;9;5;90
"5165";"360810555002";28;28;58;11;10;135
"5166";"360810556001";26;3;120;10;32;191
"5167";"360810556002";14;0;10;7;9;40
"5168";"360810557001";65;7;58;5;24;159
"5169";"360810557002";5;214;109;4;11;343
"5170";"360810557003";19;7;6;2;6;40
"5171";"360810558001";23;0;10;11;20;64
"5172";"360810558002";16;5;14;19;21;75
"5173";"360810559001";33;22;85;28;36;204
"5174";"360810560001";6;0;12;5;5;28
"5175";"360810560002";11;0;6;4;12;33
"5176";"360810561001";2;60;40;6;5;113
"5177";"360810562001";31;7;50;8;15;111
"5178";"360810564001";21;3;25;16;15;80
"5179";"360810565001";80;68;142;76;14;380
"5180";"360810566001";21;4;7;6;7;45
"5181";"360810566002";21;2;16;9;23;71
"5182";"360810567001";8;0;208;43;1;260
"5183";"360810567002";22;5;412;63;86;588
"5184";"360810567003";38;20;164;29;21;272
"5185";"360810567004";40;3;85;29;19;176
"5186";"360810568001";18;3;40;13;22;96
"5187";"360810568002";10;1;11;23;17;62
"5188";"360810568003";4;1;9;13;5;32
"5189";"360810568004";16;22;65;44;29;176
"5190";"360810577001";18;2;37;0;19;76
"5191";"360810577002";19;6;180;4;8;217
"5192";"360810577003";8;3;127;12;9;159
"5193";"360810579001";16;77;40;5;7;145
"5194";"360810579002";10;2;34;6;7;59
"5195";"360810580001";8;1;9;9;3;30
"5196";"360810580002";20;3;10;22;6;61
"5197";"360810580003";23;2;13;48;11;97
"5198";"360810580004";5;3;11;13;7;39
"5199";"360810581001";13;0;95;9;8;125
"5200";"360810581002";13;44;136;2;4;199
"5201";"360810582001";6;5;77;22;13;123
"5202";"360810582002";19;4;45;44;20;132
"5203";"360810582003";4;5;30;8;5;52
"5204";"360810583001";29;36;17;0;26;108
"5205";"360810583002";9;2;22;0;11;44
"5206";"360810583003";5;9;24;3;6;47
"5207";"360810585001";14;2;56;3;17;92
"5208";"360810585002";9;1;58;11;8;87
"5209";"360810585003";36;34;38;14;18;140
"5210";"360810587001";9;5;112;1;13;140
"5211";"360810587002";3;1;56;0;6;66
"5212";"360810587003";15;3;21;1;12;52
"5213";"360810589001";33;10;81;2;10;136
"5214";"360810589002";20;13;13;12;8;66
"5215";"360810589003";29;58;35;14;9;145
"5216";"360810590001";10;4;3;10;15;42
"5217";"360810591001";22;3;95;8;10;138
"5218";"360810591002";21;18;97;3;9;148
"5219";"360810591003";29;10;160;2;11;212
"5220";"360810591004";15;1;180;0;4;200
"5221";"360810592001";8;3;13;44;18;86
"5222";"360810593001";262;3;106;8;11;390
"5223";"360810593002";13;15;133;2;23;186
"5224";"360810594001";1;1;3;11;5;21
"5225";"360810594002";8;1;1;8;6;24
"5226";"360810595001";45;15;101;46;14;221
"5227";"360810595002";29;5;50;3;9;96
"5228";"360810595003";6;6;28;29;10;79
"5229";"360810595004";24;6;63;14;20;127
"5230";"360810596001";5;0;7;12;5;29
"5231";"360810596002";1;0;3;18;7;29
"5232";"360810598001";15;1;10;3;3;32
"5233";"360810598002";6;4;17;8;6;41
"5234";"360810599001";5;0;55;17;18;95
"5235";"360810599002";18;97;41;28;9;193
"5236";"360810600001";19;0;19;20;7;65
"5237";"360810601001";14;1;88;27;28;158
"5238";"360810601002";62;78;103;23;24;290
"5239";"360810603001";17;6;168;51;18;260
"5240";"360810606001";11;3;23;21;1;59
"5241";"360810606002";9;2;11;13;4;39
"5242";"360810607011";3;2;87;25;5;122
"5243";"360810608001";10;83;34;42;4;173
"5244";"360810610001";3;2;62;23;4;94
"5245";"360810612001";3;1;12;9;4;29
"5246";"360810612002";2;2;16;7;6;33
"5247";"360810613011";36;15;106;19;24;200
"5248";"360810613012";15;15;264;25;21;340
"5249";"360810613013";11;4;66;5;10;96
"5250";"360810613014";10;9;42;3;2;66
"5251";"360810613021";0;0;7;2;0;9
"5252";"360810614001";6;3;7;3;4;23
"5253";"360810616011";1;0;3;4;3;11
"5254";"360810616012";1;0;3;19;4;27
"5255";"360810616013";4;1;7;9;8;29
"5256";"360810616021";5;0;4;5;1;15
"5257";"360810616022";4;0;10;26;4;44
"5258";"360810618001";6;0;1;7;3;17
"5259";"360810618002";11;7;24;14;4;60
"5260";"360810619001";49;30;201;35;20;335
"5261";"360810619002";5;3;48;10;6;72
"5262";"360810620001";8;3;14;31;10;66
"5263";"360810621001";15;10;84;8;6;123
"5264";"360810621002";11;1;36;12;8;68
"5265";"360810621003";11;1;68;4;11;95
"5266";"360810622001";7;8;27;25;1;68
"5267";"360810622002";6;7;8;6;9;36
"5268";"360810623001";4;2;68;21;13;108
"5269";"360810623002";7;3;166;47;1;224
"5270";"360810624001";1;0;3;1;0;5
"5271";"360810625001";1;4;76;5;10;96
"5272";"360810625002";51;5;141;17;15;229
"5273";"360810626001";5;2;10;25;6;48
"5274";"360810626002";11;4;17;16;7;55
"5275";"360810626003";3;0;5;13;8;29
"5276";"360810627001";30;1;133;4;5;173
"5277";"360810627002";10;1;104;1;21;137
"5278";"360810629001";6;2;148;16;11;183
"5279";"360810629002";5;6;22;1;4;38
"5280";"360810629003";6;12;97;6;6;127
"5281";"360810630001";6;3;21;14;2;46
"5282";"360810630002";6;0;16;23;1;46
"5283";"360810632001";4;0;7;7;3;21
"5284";"360810632002";7;11;42;26;12;98
"5285";"360810633011";19;4;121;54;8;206
"5286";"360810633021";0;4;46;17;8;75
"5287";"360810633022";4;1;74;13;11;103
"5288";"360810635001";7;3;35;12;6;63
"5289";"360810635002";12;1;94;40;8;155
"5290";"360810637001";1;8;58;16;16;99
"5291";"360810637002";2;7;103;43;17;172
"5292";"360810637003";12;10;37;12;7;78
"5293";"360810638001";11;11;32;19;6;79
"5294";"360810638002";16;5;20;13;7;61
"5295";"360810638003";3;0;12;5;1;21
"5296";"360810638004";3;0;10;26;10;49
"5297";"360810638005";11;5;15;7;10;48
"5298";"360810639001";7;2;90;28;13;140
"5299";"360810639002";40;6;173;12;12;243
"5300";"360810641011";7;6;40;11;1;65
"5301";"360810641021";18;14;163;26;17;238
"5302";"360810645001";1;2;19;33;7;62
"5303";"360810645002";7;7;48;14;11;87
"5304";"360810646001";7;0;22;33;7;69
"5305";"360810646002";6;1;34;16;7;64
"5306";"360810650001";6;2;20;21;11;60
"5307";"360810650002";10;1;44;23;19;97
"5308";"360810654001";6;7;34;32;8;87
"5309";"360810654002";17;7;31;11;15;81
"5310";"360810654003";6;5;4;24;3;42
"5311";"360810655011";1;59;20;2;2;84
"5312";"360810656001";6;5;52;28;13;104
"5313";"360810656002";9;0;8;11;7;35
"5314";"360810656003";67;3;52;36;7;165
"5315";"360810657021";14;14;91;16;19;154
"5316";"360810657031";1;4;102;18;17;142
"5317";"360810657032";8;2;29;7;12;58
"5318";"360810657033";7;2;57;15;17;98
"5319";"360810659001";2;2;18;9;6;37
"5320";"360810659002";2;2;51;17;10;82
"5321";"360810660001";45;3;27;15;8;98
"5322";"360810660002";39;4;26;28;12;109
"5323";"360810661001";14;3;46;18;6;87
"5324";"360810663001";3;0;49;15;8;75
"5325";"360810663002";1;3;34;14;12;64
"5326";"360810663003";1;1;38;8;15;63
"5327";"360810664001";13;1;8;10;4;36
"5328";"360810664002";13;1;27;37;14;92
"5329";"360810664003";13;4;7;4;11;39
"5330";"360810664004";37;1;14;11;18;81
"5331";"360810664005";14;1;18;15;6;54
"5332";"360810664006";18;2;12;24;2;58
"5333";"360810664007";14;3;46;18;6;87
"5334";"360810664008";19;1;30;31;10;91
"5335";"360810665011";1;5;29;18;3;56
"5336";"360810665012";0;1;34;8;2;45
"5337";"360810665013";6;1;33;7;2;49
"5338";"360810665014";16;0;20;5;10;51
"5339";"360810667011";14;2;123;28;14;181
"5340";"360810667012";0;1;71;12;6;90
"5341";"360810669001";3;0;62;14;15;94
"5342";"360810669002";5;4;96;15;20;140
"5343";"360810671001";1;3;41;10;10;65
"5344";"360810671002";0;2;55;39;11;107
"5345";"360810677001";0;3;23;17;3;46
"5346";"360810677002";3;3;42;7;5;60
"5347";"360810679001";1;0;64;9;3;77
"5348";"360810679002";48;4;25;0;12;89
"5349";"360810679003";20;10;225;24;7;286
"5350";"360810680001";14;1;19;10;14;58
"5351";"360810680002";17;3;23;43;20;106
"5352";"360810680003";18;6;22;28;20;94
"5353";"360810680004";13;0;8;12;7;40
"5354";"360810682001";0;0;12;8;11;31
"5355";"360810682002";5;0;9;11;5;30
"5356";"360810683001";49;6;23;2;8;88
"5357";"360810683002";7;6;45;3;23;84
"5358";"360810683003";5;3;16;7;11;42
"5359";"360810687001";8;1;4;2;5;20
"5360";"360810687002";21;11;67;4;5;108
"5361";"360810687003";108;3;164;4;13;292
"5362";"360810690001";7;2;32;29;9;79
"5363";"360810690002";73;4;45;49;16;187
"5364";"360810693001";141;5;235;0;14;395
"5365";"360810693002";16;5;41;4;15;81
"5366";"360810694001";14;5;34;42;23;118
"5367";"360810694002";62;7;81;21;13;184
"5368";"360810695001";34;2;61;3;6;106
"5369";"360810695002";8;5;55;5;8;81
"5370";"360810697011";26;1;19;4;3;53
"5371";"360810697012";21;1;86;2;5;115
"5372";"360810697013";5;0;36;3;2;46
"5373";"360810697021";7;2;13;7;8;37
"5374";"360810697022";5;1;21;13;4;44
"5375";"360810697023";11;1;27;14;1;54
"5376";"360810697024";6;1;16;3;9;35
"5377";"360810703001";8;2;18;19;10;57
"5378";"360810703002";9;9;111;25;18;172
"5379";"360810707001";2;1;8;2;7;20
"5380";"360810707002";4;3;13;1;5;26
"5381";"360810707003";5;1;20;3;10;39
"5382";"360810709001";1;0;66;2;6;75
"5383";"360810709002";3;2;18;5;3;31
"5384";"360810711001";7;6;50;2;4;69
"5385";"360810711002";43;24;72;1;21;161
"5386";"360810711003";10;1;24;0;1;36
"5387";"360810711004";10;16;43;1;103;173
"5388";"360810713031";17;2;13;1;1;34
"5389";"360810713032";55;4;20;0;25;104
"5390";"360810713033";67;8;24;0;6;105
"5391";"360810713041";10;1;23;1;3;38
"5392";"360810713042";3;2;15;0;2;22
"5393";"360810713043";5;1;0;0;0;6
"5394";"360810713044";23;2;12;0;5;42
"5395";"360810713051";22;3;5;0;7;37
"5396";"360810713052";11;1;17;0;4;33
"5397";"360810713053";45;6;73;0;11;135
"5398";"360810713061";107;5;36;1;1;150
"5399";"360810713062";18;2;56;7;4;87
"5400";"360810713063";17;5;14;0;14;50
"5401";"360810713064";21;9;18;1;15;64
"5402";"360810716001";0;1;8;1;7;17
"5403";"360810717011";32;3;3;0;1;39
"5404";"360810717012";3;7;36;0;3;49
"5405";"360810717013";1;1;7;0;1;10
"5406";"360810717014";16;3;9;0;4;32
"5407";"360810717021";7;8;57;1;15;88
"5408";"360810717022";2;0;31;1;1;35
"5409";"360810719001";24;0;65;0;9;98
"5410";"360810719002";37;5;122;0;18;182
"5411";"360810721001";7;3;10;1;0;21
"5412";"360810721002";7;2;11;2;1;23
"5413";"360810721003";70;5;24;0;1;100
"5414";"360810721004";6;5;15;0;1;27
"5415";"360810721005";23;5;54;0;5;87
"5416";"360810723001";2;10;4;1;3;20
"5417";"360810723002";1;1;18;4;2;26
"5418";"360810723003";1;2;11;0;3;17
"5419";"360810729001";14;5;13;3;4;39
"5420";"360810729002";6;2;75;11;14;108
"5421";"360810731001";7;9;8;0;8;32
"5422";"360810731002";2;68;19;6;2;97
"5423";"360810737001";10;74;18;0;35;137
"5424";"360810737002";1;6;4;1;2;14
"5425";"360810739001";3;1;16;0;0;20
"5426";"360810739002";10;1;8;0;3;22
"5427";"360810739003";4;4;18;0;8;34
"5428";"360810739004";5;6;13;1;6;31
"5429";"360810739005";11;8;4;1;1;25
"5430";"360810741001";1;0;3;0;1;5
"5431";"360810741002";22;5;23;0;4;54
"5432";"360810741003";2;2;6;0;3;13
"5433";"360810741004";2;2;5;0;2;11
"5434";"360810743001";5;0;12;0;5;22
"5435";"360810743002";7;1;37;0;2;47
"5436";"360810743003";11;2;25;0;4;42
"5437";"360810743004";21;5;5;0;5;36
"5438";"360810745001";34;4;23;1;9;71
"5439";"360810745002";28;0;34;0;3;65
"5440";"360810747001";25;4;52;17;10;108
"5441";"360810747002";16;1;19;1;3;40
"5442";"360810749001";1;0;0;0;0;1
"5443";"360810749002";4;1;7;3;4;19
"5444";"360810757011";32;6;40;0;17;95
"5445";"360810757012";5;1;21;1;8;36
"5446";"360810757013";7;8;25;0;10;50
"5447";"360810757021";49;3;26;6;4;88
"5448";"360810757022";0;1;67;11;7;86
"5449";"360810757023";6;4;7;0;1;18
"5450";"360810769011";18;6;8;2;5;39
"5451";"360810769012";63;13;17;1;7;101
"5452";"360810769021";23;13;74;2;17;129
"5453";"360810773001";14;16;40;3;4;77
"5454";"360810773002";41;7;19;0;17;84
"5455";"360810775001";24;4;38;3;7;76
"5456";"360810775002";21;2;33;3;6;65
"5457";"360810775003";13;112;37;3;29;194
"5458";"360810779021";0;0;16;2;5;23
"5459";"360810779022";0;4;19;9;5;37
"5460";"360810779023";5;2;23;14;2;46
"5461";"360810779024";5;1;5;1;1;13
"5462";"360810779025";6;1;24;0;10;41
"5463";"360810779031";3;0;3;1;0;7
"5464";"360810779032";2;1;4;0;0;7
"5465";"360810779033";12;1;19;3;4;39
"5466";"360810779041";0;0;9;11;10;30
"5467";"360810779042";31;4;62;4;14;115
"5468";"360810779043";28;10;28;1;8;75
"5469";"360810779044";7;3;21;3;3;37
"5470";"360810779051";7;28;15;22;6;78
"5471";"360810779052";0;0;8;0;0;8
"5472";"360810779061";22;7;12;3;8;52
"5473";"360810779062";27;7;69;16;32;151
"5474";"360810779071";12;4;54;17;3;90
"5475";"360810779072";3;0;31;3;6;43
"5476";"360810779081";4;5;15;3;4;31
"5477";"360810779082";77;7;11;3;3;101
"5478";"360810788001";56;7;18;28;21;130
"5479";"360810788002";7;1;5;14;13;40
"5480";"360810790001";21;6;23;43;15;108
"5481";"360810790002";28;6;63;46;33;176
"5482";"360810792001";57;6;28;35;4;130
"5483";"360810792002";33;3;58;36;35;165
"5484";"360810793001";0;0;0;1;7;8
"5485";"360810797011";15;1;2;1;3;22
"5486";"360810797012";23;5;1;0;8;37
"5487";"360810797013";3;1;0;0;7;11
"5488";"360810797014";6;3;9;0;9;27
"5489";"360810797021";7;13;154;10;17;201
"5490";"360810797022";21;1;51;0;5;78
"5491";"360810797023";12;0;4;0;1;17
"5492";"360810799001";14;6;173;11;27;231
"5493";"360810799002";18;8;239;8;17;290
"5494";"360810803011";10;5;43;8;16;82
"5495";"360810803012";17;2;89;6;14;128
"5496";"360810803013";4;5;80;10;15;114
"5497";"360810803021";12;0;56;11;11;90
"5498";"360810803022";3;1;12;14;14;44
"5499";"360810803023";5;1;39;9;25;79
"5500";"360810809001";27;1;7;0;0;35
"5501";"360810809002";13;2;31;3;0;49
"5502";"360810809003";3;0;22;0;2;27
"5503";"360810809004";9;10;36;22;19;96
"5504";"360810809005";5;0;15;4;4;28
"5505";"360810809006";4;1;4;2;0;11
"5506";"360810809007";4;11;28;14;3;60
"5507";"360810814001";49;7;88;27;13;184
"5508";"360810814002";16;14;21;23;14;88
"5509";"360810814003";44;3;24;24;13;108
"5510";"360810818001";70;48;35;41;44;238
"5511";"360810818002";24;7;28;19;34;112
"5512";"360810818003";53;6;33;27;21;140
"5513";"360810837001";11;12;70;17;15;125
"5514";"360810837002";3;1;74;26;30;134
"5515";"360810837003";2;1;39;7;17;66
"5516";"360810837004";15;5;30;6;8;64
"5517";"360810838001";14;9;31;46;17;117
"5518";"360810838002";17;7;50;29;22;125
"5519";"360810838003";14;9;46;15;29;113
"5520";"360810838004";19;4;59;17;20;119
"5521";"360810840001";73;32;43;37;37;222
"5522";"360810840002";57;25;52;16;34;184
"5523";"360810840003";33;19;57;8;26;143
"5524";"360810840004";32;8;59;4;17;120
"5525";"360810840005";75;0;38;6;18;137
"5526";"360810845001";14;0;2;0;0;16
"5527";"360810845002";131;5;2;0;5;143
"5528";"360810845003";5;7;155;4;20;191
"5529";"360810846011";27;0;91;52;16;186
"5530";"360810846012";29;1;51;19;13;113
"5531";"360810846021";9;7;107;77;11;211
"5532";"360810849001";82;7;49;2;30;170
"5533";"360810849002";10;1;37;0;12;60
"5534";"360810849003";19;0;102;1;32;154
"5535";"360810849004";1;14;93;11;38;157
"5536";"360810853001";4;15;24;1;30;74
"5537";"360810853002";3;5;15;0;16;39
"5538";"360810853003";5;5;24;0;4;38
"5539";"360810853004";6;2;6;0;8;22
"5540";"360810855001";23;8;6;0;10;47
"5541";"360810855002";22;13;11;0;4;50
"5542";"360810855003";12;26;72;0;3;113
"5543";"360810855004";23;11;53;0;6;93
"5544";"360810857001";20;3;14;0;5;42
"5545";"360810857002";17;2;38;0;6;63
"5546";"360810857003";26;4;15;0;21;66
"5547";"360810859001";19;8;13;0;22;62
"5548";"360810859002";19;6;62;0;69;156
"5549";"360810859003";10;11;28;0;5;54
"5550";"360810861001";23;1;9;0;8;41
"5551";"360810861002";11;4;41;0;38;94
"5552";"360810863001";8;0;7;0;9;24
"5553";"360810863002";23;0;20;1;3;47
"5554";"360810863003";29;2;2;0;10;43
"5555";"360810863004";32;2;77;0;65;176
"5556";"360810864001";21;48;144;20;30;263
"5557";"360810864002";17;13;29;23;13;95
"5558";"360810865001";54;12;39;1;8;114
"5559";"360810865002";13;27;29;1;22;92
"5560";"360810869001";7;18;116;2;38;181
"5561";"360810869002";2;3;91;18;18;132
"5562";"360810871001";41;32;74;0;26;173
"5563";"360810871002";6;14;80;2;52;154
"5564";"360810884001";5;1;79;21;31;137
"5565";"360810884002";3;4;20;6;16;49
"5566";"360810884003";0;0;13;10;9;32
"5567";"360810884004";7;0;9;18;34;68
"5568";"360810884005";15;7;30;12;21;85
"5569";"360810884006";10;2;130;36;24;202
"5570";"360810884007";1;2;21;18;16;58
"5571";"360810884008";1;2;42;37;9;91
"5572";"360810889011";15;7;95;11;39;167
"5573";"360810889012";4;7;9;4;1;25
"5574";"360810889013";20;6;13;2;4;45
"5575";"360810889014";5;3;6;1;7;22
"5576";"360810889015";2;0;27;0;1;30
"5577";"360810889016";14;10;14;5;3;46
"5578";"360810889017";17;7;26;0;9;59
"5579";"360810892001";9;3;8;6;9;35
"5580";"360810892002";9;7;23;6;6;51
"5581";"360810892003";2;3;38;15;27;85
"5582";"360810892004";4;0;8;20;14;46
"5583";"360810892005";10;2;14;10;18;54
"5584";"360810892006";9;0;2;1;8;20
"5585";"360810892007";6;1;6;6;6;25
"5586";"360810892008";9;171;6;4;9;199
"5587";"360810907001";19;8;123;89;32;271
"5588";"360810916011";0;0;2;0;0;2
"5589";"360810916012";0;0;0;0;1;1
"5590";"360810916013";1;0;1;0;2;4
"5591";"360810916014";1;1;3;0;9;14
"5592";"360810916021";0;0;7;0;1;8
"5593";"360810918001";1;0;0;0;0;1
"5594";"360810919001";9;2;55;24;8;98
"5595";"360810919002";61;9;116;28;35;249
"5596";"360810919003";9;10;113;19;12;163
"5597";"360810922001";6;1;2;0;2;11
"5598";"360810922002";0;0;9;0;22;31
"5599";"360810922003";2;4;70;0;11;87
"5600";"360810925001";22;16;102;23;12;175
"5601";"360810925002";19;14;85;25;22;165
"5602";"360810925003";14;5;91;30;14;154
"5603";"360810928001";22;6;12;0;12;52
"5604";"360810928002";0;2;7;2;8;19
"5605";"360810928003";2;0;6;2;2;12
"5606";"360810929000";0;1;0;0;0;1
"5607";"360810929001";78;20;131;86;58;373
"5608";"360810929002";43;9;134;64;32;282
"5609";"360810929003";18;3;44;7;8;80
"5610";"360810929004";3;4;14;8;2;31
"5611";"360810934010";1;0;0;0;1;2
"5612";"360810934011";5;1;15;1;8;30
"5613";"360810934012";14;5;40;5;11;75
"5614";"360810934013";2;14;48;1;7;72
"5615";"360810934021";44;7;36;2;19;108
"5616";"360810934022";8;0;24;2;5;39
"5617";"360810934023";30;0;22;3;12;67
"5618";"360810938001";8;0;1;0;33;42
"5619";"360810938002";24;23;95;1;27;170
"5620";"360810938003";182;114;67;5;75;443
"5621";"360810939001";64;23;85;61;33;266
"5622";"360810939002";27;3;64;20;20;134
"5623";"360810939003";27;8;72;30;19;156
"5624";"360810942011";116;204;153;4;25;502
"5625";"360810942021";157;34;13;8;18;230
"5626";"360810942022";78;13;37;17;35;180
"5627";"360810942031";35;63;35;4;11;148
"5628";"360810942032";2;7;17;1;2;29
"5629";"360810942033";37;7;2;1;3;50
"5630";"360810942034";5;0;9;0;6;20
"5631";"360810942035";0;8;1;4;0;13
"5632";"360810945000";0;1;0;0;0;1
"5633";"360810945001";27;28;44;39;36;174
"5634";"360810945002";42;9;41;34;21;147
"5635";"360810947001";45;235;109;25;48;462
"5636";"360810947002";26;9;56;26;26;143
"5637";"360810954001";33;4;14;2;26;79
"5638";"360810954002";80;7;15;4;4;110
"5639";"360810954003";18;6;26;8;11;69
"5640";"360810964001";47;8;26;4;15;100
"5641";"360810964002";49;21;94;16;20;200
"5642";"360810972021";168;2;0;10;20;200
"5643";"360810972031";4;0;4;19;10;37
"5644";"360810972032";30;2;5;9;1;47
"5645";"360810972033";59;3;1;7;1;71
"5646";"360810972034";117;4;3;1;2;127
"5647";"360810972041";74;9;2;0;13;98
"5648";"360810972042";23;5;26;13;14;81
"5649";"360810972043";7;4;2;1;0;14
"5650";"360810973001";20;42;18;22;7;109
"5651";"360810973002";11;4;9;1;5;30
"5652";"360810973003";5;4;2;1;3;15
"5653";"360810981001";11;9;8;6;12;46
"5654";"360810981002";6;8;39;12;8;73
"5655";"360810987001";16;17;31;20;22;106
"5656";"360810987002";10;36;50;22;1;119
"5657";"360810991001";5;1;30;13;1;50
"5658";"360810991002";0;0;20;2;2;24
"5659";"360810991003";6;0;18;6;4;34
"5660";"360810991004";22;3;19;7;8;59
"5661";"360810991005";11;3;33;12;11;70
"5662";"360810992001";53;1;25;9;25;113
"5663";"360810992002";111;7;47;25;0;190
"5664";"360810997011";11;3;12;16;6;48
"5665";"360810997012";5;0;48;8;11;72
"5666";"360810997013";1;0;9;6;4;20
"5667";"360810997031";13;11;45;21;19;109
"5668";"360810997032";1;3;20;3;1;28
"5669";"360810997033";3;0;23;5;5;36
"5670";"360810997041";3;1;10;14;0;28
"5671";"360810997042";107;4;5;8;2;126
"5672";"360810997043";2;1;15;5;13;36
"5673";"360810997044";3;1;16;9;4;33
"5674";"360810997051";8;6;29;13;0;56
"5675";"360810998011";39;3;20;4;20;86
"5676";"360810998012";56;2;8;0;1;67
"5677";"360810998013";63;9;37;8;13;130
"5678";"360810998014";13;0;6;0;0;19
"5679";"360810998015";20;5;12;14;14;65
"5680";"360810998021";105;11;13;35;26;190
"5681";"360810998022";32;0;1;3;1;37
"5682";"360810998023";1;2;2;0;1;6
"5683";"360810999001";0;1;0;0;0;1
"5684";"360811008011";70;10;13;4;4;101
"5685";"360811008012";55;8;19;6;5;93
"5686";"360811008021";58;35;52;15;19;179
"5687";"360811008022";29;3;23;14;15;84
"5688";"360811008023";21;3;24;6;7;61
"5689";"360811008024";32;1;17;12;15;77
"5690";"360811010011";51;7;58;12;19;147
"5691";"360811010012";43;4;30;8;8;93
"5692";"360811010013";45;55;36;12;11;159
"5693";"360811010014";35;5;23;5;3;71
"5694";"360811010021";5;5;20;4;17;51
"5695";"360811010022";136;12;33;11;19;211
"5696";"360811017001";3;1;13;8;4;29
"5697";"360811017002";2;0;7;15;6;30
"5698";"360811017003";11;1;10;4;4;30
"5699";"360811017004";4;0;21;2;2;29
"5700";"360811017005";3;0;6;7;11;27
"5701";"360811017006";7;11;20;9;10;57
"5702";"360811017007";5;1;8;7;9;30
"5703";"360811029001";11;4;40;24;12;91
"5704";"360811029002";3;22;35;22;3;85
"5705";"360811032011";43;1;47;22;15;128
"5706";"360811032012";67;7;23;17;22;136
"5707";"360811032013";21;3;6;10;8;48
"5708";"360811032021";21;2;39;5;10;77
"5709";"360811032022";1;0;5;15;1;22
"5710";"360811032023";78;12;21;0;12;123
"5711";"360811032024";76;11;16;5;10;118
"5712";"360811033001";19;1;43;18;11;92
"5713";"360811033002";7;2;17;6;10;42
"5714";"360811033003";3;4;9;3;3;22
"5715";"360811033004";4;0;11;5;4;24
"5716";"360811039001";53;5;41;19;18;136
"5717";"360811039002";18;8;47;54;35;162
"5718";"360811039003";12;8;18;14;25;77
"5719";"360811039004";28;8;22;23;4;85
"5720";"360811047001";8;3;48;3;19;81
"5721";"360811047002";5;7;15;24;20;71
"5722";"360811047003";8;3;95;17;11;134
"5723";"360811047004";9;1;51;3;22;86
"5724";"360811047005";8;2;67;24;10;111
"5725";"360811059001";4;3;10;6;1;24
"5726";"360811059002";4;0;18;15;13;50
"5727";"360811059003";4;3;1;4;4;16
"5728";"360811059004";2;0;6;10;97;115
"5729";"360811072011";18;7;53;20;33;131
"5730";"360811072020";0;0;1;0;0;1
"5731";"360811085001";19;6;15;9;10;59
"5732";"360811085002";2;1;32;3;7;45
"5733";"360811085003";3;1;75;6;7;92
"5734";"360811093001";2;1;16;4;2;25
"5735";"360811093002";2;4;38;3;10;57
"5736";"360811093003";2;1;1;2;5;11
"5737";"360811097001";1;1;4;3;1;10
"5738";"360811097002";8;3;8;5;7;31
"5739";"360811097003";5;4;17;0;8;34
"5740";"360811099001";1;0;48;20;24;93
"5741";"360811099002";2;0;22;12;15;51
"5742";"360811099003";11;61;27;11;16;126
"5743";"360811113001";11;2;10;1;23;47
"5744";"360811113002";0;0;16;5;9;30
"5745";"360811113003";8;2;16;10;12;48
"5746";"360811123001";8;2;52;2;9;73
"5747";"360811123002";7;31;110;8;22;178
"5748";"360811129001";2;1;20;6;9;38
"5749";"360811129002";2;0;3;4;17;26
"5750";"360811129003";11;1;27;7;5;51
"5751";"360811133001";1;0;22;1;5;29
"5752";"360811133002";0;0;7;7;4;18
"5753";"360811139001";7;6;36;6;5;60
"5754";"360811139002";72;3;80;7;5;167
"5755";"360811139003";10;3;46;9;6;74
"5756";"360811141001";14;29;23;9;4;79
"5757";"360811141002";4;5;24;11;20;64
"5758";"360811147001";2;1;7;10;3;23
"5759";"360811147002";4;3;15;2;19;43
"5760";"360811151001";1;7;19;3;23;53
"5761";"360811155001";26;2;30;0;22;80
"5762";"360811155002";33;2;32;1;5;73
"5763";"360811157001";7;5;42;3;11;68
"5764";"360811157002";18;7;38;1;16;80
"5765";"360811157003";21;0;21;0;6;48
"5766";"360811159001";3;3;26;2;9;43
"5767";"360811159002";0;4;47;5;7;63
"5768";"360811159003";62;2;49;2;14;129
"5769";"360811161001";2;0;66;0;12;80
"5770";"360811161002";15;3;11;0;13;42
"5771";"360811163001";10;2;8;0;2;22
"5772";"360811163002";11;3;24;0;3;41
"5773";"360811163003";36;7;32;0;5;80
"5774";"360811163004";33;1;18;1;7;60
"5775";"360811163005";2;1;50;2;9;64
"5776";"360811167001";16;21;604;5;44;690
"5777";"360811171001";3;6;38;22;24;93
"5778";"360811171002";37;2;22;1;15;77
"5779";"360811171003";16;3;28;1;9;57
"5780";"360811175001";3;3;38;1;13;58
"5781";"360811175002";13;7;40;0;10;70
"5782";"360811175003";13;5;32;17;4;71
"5783";"360811175004";15;30;46;20;25;136
"5784";"360811181001";7;4;70;3;12;96
"5785";"360811181002";3;4;81;7;26;121
"5786";"360811185001";12;5;73;7;18;115
"5787";"360811185002";4;0;65;8;4;81
"5788";"360811187001";10;0;43;5;2;60
"5789";"360811187002";60;3;124;1;15;203
"5790";"360811189001";12;2;37;10;32;93
"5791";"360811189002";0;1;44;7;8;60
"5792";"360811191001";14;6;105;19;26;170
"5793";"360811191002";18;8;63;7;15;111
"5794";"360811193001";14;2;42;3;25;86
"5795";"360811193002";18;0;31;2;9;60
"5796";"360811195001";24;3;64;26;16;133
"5797";"360811199001";8;2;41;27;18;96
"5798";"360811201001";20;3;85;6;15;129
"5799";"360811203001";6;6;20;2;8;42
"5800";"360811203002";3;0;32;1;17;53
"5801";"360811205001";11;15;168;6;12;212
"5802";"360811207001";6;0;14;20;20;60
"5803";"360811207002";22;3;71;20;26;142
"5804";"360811211001";0;1;18;1;3;23
"5805";"360811215001";35;3;114;31;12;195
"5806";"360811215002";2;0;150;24;35;211
"5807";"360811215003";13;2;148;31;32;226
"5808";"360811223001";18;1;88;17;8;132
"5809";"360811223002";1;1;19;24;13;58
"5810";"360811223003";13;2;31;29;23;98
"5811";"360811227011";13;17;152;8;8;198
"5812";"360811227012";8;1;26;1;6;42
"5813";"360811227013";15;4;86;6;16;127
"5814";"360811227014";12;2;9;0;6;29
"5815";"360811227015";67;2;82;7;3;161
"5816";"360811227016";1;1;6;1;0;9
"5817";"360811227017";17;2;6;2;2;29
"5818";"360811227021";91;6;5;5;2;109
"5819";"360811227022";71;20;19;5;4;119
"5820";"360811227023";358;3;14;1;22;398
"5821";"360811227024";13;0;39;2;7;61
"5822";"360811227025";40;2;12;1;7;62
"5823";"360811241001";13;1;29;19;13;75
"5824";"360811241002";9;3;18;31;10;71
"5825";"360811241003";26;1;41;9;11;88
"5826";"360811247001";11;2;13;34;13;73
"5827";"360811247002";4;0;16;11;3;34
"5828";"360811247003";26;0;16;17;14;73
"5829";"360811257001";40;18;48;3;16;125
"5830";"360811257002";50;101;77;5;158;391
"5831";"360811257003";46;4;248;1;195;494
"5832";"360811265001";28;0;28;19;27;102
"5833";"360811265002";11;5;42;6;276;340
"5834";"360811267001";4;4;31;7;13;59
"5835";"360811267002";9;4;65;8;16;102
"5836";"360811267003";11;4;24;21;16;76
"5837";"360811277001";23;2;11;15;17;68
"5838";"360811277002";18;5;7;18;16;64
"5839";"360811277003";6;2;9;8;7;32
"5840";"360811277004";1;4;9;5;4;23
"5841";"360811283001";0;9;35;2;3;49
"5842";"360811291021";11;1;18;7;12;49
"5843";"360811291022";8;3;3;7;3;24
"5844";"360811291023";6;2;3;2;6;19
"5845";"360811291024";9;2;4;2;2;19
"5846";"360811291031";5;0;7;4;2;18
"5847";"360811291032";3;0;2;1;2;8
"5848";"360811291033";0;1;8;17;2;28
"5849";"360811291041";0;0;0;0;2;2
"5850";"360811291042";6;0;13;6;1;26
"5851";"360811291043";1;2;11;3;5;22
"5852";"360811291044";4;2;10;5;10;31
"5853";"360811291045";21;1;35;2;1;60
"5854";"360811301001";2;0;3;6;5;16
"5855";"360811301002";14;4;9;9;5;41
"5856";"360811301003";5;6;30;6;13;60
"5857";"360811301004";10;1;9;8;6;34
"5858";"360811333001";4;0;23;17;2;46
"5859";"360811333002";2;0;17;12;3;34
"5860";"360811333003";68;6;36;15;38;163
"5861";"360811333004";2;3;30;9;7;51
"5862";"360811339001";31;1;39;18;12;101
"5863";"360811341001";23;3;58;24;11;119
"5864";"360811341002";14;1;23;29;19;86
"5865";"360811341003";2;1;21;7;6;37
"5866";"360811347001";21;14;39;3;5;82
"5867";"360811347002";3;1;11;3;3;21
"5868";"360811347003";10;1;19;20;2;52
"5869";"360811347004";14;2;26;5;0;47
"5870";"360811347005";40;1;24;7;5;77
"5871";"360811367001";8;3;41;3;11;66
"5872";"360811367002";11;0;12;6;6;35
"5873";"360811367003";1;0;22;5;0;28
"5874";"360811367004";3;1;7;4;6;21
"5875";"360811367005";2;1;17;30;3;53
"5876";"360811377001";10;1;32;1;5;49
"5877";"360811377002";14;1;37;6;9;67
"5878";"360811377003";5;0;49;9;5;68
"5879";"360811377004";2;1;16;10;4;33
"5880";"360811385011";1;4;17;8;5;35
"5881";"360811385012";13;0;34;1;3;51
"5882";"360811385013";8;2;20;8;1;39
"5883";"360811385014";9;4;28;8;19;68
"5884";"360811385021";4;4;10;7;3;28
"5885";"360811399001";0;1;9;7;11;28
"5886";"360811399002";11;1;22;6;6;46
"5887";"360811403001";1;1;6;4;4;16
"5888";"360811403002";17;1;39;10;7;74
"5889";"360811409011";3;1;6;7;5;22
"5890";"360811409021";4;2;54;10;10;80
"5891";"360811409022";10;0;125;33;8;176
"5892";"360811417001";2;0;15;8;3;28
"5893";"360811417002";5;0;9;10;12;36
"5894";"360811417003";2;1;7;3;12;25
"5895";"360811417004";13;3;9;8;9;42
"5896";"360811417005";15;1;24;3;7;50
"5897";"360811429001";0;4;6;2;12;24
"5898";"360811429002";14;0;20;11;10;55
"5899";"360811429003";6;0;7;12;10;35
"5900";"360811429004";5;0;17;2;4;28
"5901";"360811435001";8;2;29;3;13;55
"5902";"360811435002";5;1;5;9;8;28
"5903";"360811441001";5;1;10;3;11;30
"5904";"360811441002";27;2;30;2;3;64
"5905";"360811441003";2;0;8;2;7;19
"5906";"360811441004";1;2;7;0;3;13
"5907";"360811447001";7;2;36;9;13;67
"5908";"360811447002";14;2;41;13;16;86
"5909";"360811451011";8;1;23;5;16;53
"5910";"360811451021";2;0;12;5;13;32
"5911";"360811451022";11;0;15;7;4;37
"5912";"360811459001";5;2;7;10;7;31
"5913";"360811459002";2;9;10;3;6;30
"5914";"360811459003";12;2;18;2;9;43
"5915";"360811463001";0;4;60;17;17;98
"5916";"360811463002";8;3;36;12;18;77
"5917";"360811467001";22;14;121;15;13;185
"5918";"360811467002";42;0;2;1;0;45
"5919";"360811467003";4;1;51;12;9;77
"5920";"360811471001";26;4;112;20;17;179
"5921";"360811471002";10;5;33;4;10;62
"5922";"360811479001";3;3;66;5;17;94
"5923";"360811479002";17;9;73;1;13;113
"5924";"360811479003";4;4;48;11;12;79
"5925";"360811483001";0;11;16;5;4;36
"5926";"360811483002";4;0;20;4;15;43
"5927";"360811483003";7;2;12;4;8;33
"5928";"360811483004";10;1;17;8;10;46
"5929";"360811507011";4;1;9;9;11;34
"5930";"360811507012";1;1;18;12;8;40
"5931";"360811507013";1;0;7;6;5;19
"5932";"360811507021";0;1;11;7;4;23
"5933";"360811507022";1;0;8;1;1;11
"5934";"360811507023";5;0;15;6;6;32
"5935";"360811507024";2;50;56;8;4;120
"5936";"360811529011";0;1;19;9;5;34
"5937";"360811529012";23;8;99;29;20;179
"5938";"360811529013";3;2;30;19;3;57
"5939";"360811529021";1;0;3;9;3;16
"5940";"360811529022";2;1;13;13;4;33
"5941";"360811529023";4;0;28;11;8;51
"5942";"360811529024";1;4;24;1;7;37
"5943";"360811551021";3;0;25;4;2;34
"5944";"360811551022";1;0;8;2;4;15
"5945";"360811551023";3;8;65;3;24;103
"5946";"360811551024";0;2;23;14;9;48
"5947";"360811551025";2;2;18;5;4;31
"5948";"360811551026";2;0;15;6;0;23
"5949";"360811567001";5;6;34;6;18;69
"5950";"360811571011";0;0;9;1;1;11
"5951";"360811571012";6;4;28;3;10;51
"5952";"360811571013";0;1;12;9;1;23
"5953";"360811571014";1;1;10;10;5;27
"5954";"360811571015";6;0;18;18;9;51
"5955";"360811571016";9;12;22;16;27;86
"5956";"360811571017";0;5;35;14;17;71
"5957";"360811571018";1;0;6;10;4;21
"5958";"360811571021";2;1;16;6;15;40
"5959";"360811571022";6;3;35;11;5;60
"5960";"360811579011";4;2;25;2;10;43
"5961";"360811579012";2;1;12;2;13;30
"5962";"360811579013";1;0;1;1;5;8
"5963";"360811579014";15;1;0;3;5;24
"5964";"360811579015";2;0;27;10;5;44
"5965";"360811579016";4;5;6;5;3;23
"5966";"360811579021";0;49;11;6;5;71
"5967";"360811579022";10;2;25;7;8;52
"5968";"360811579023";18;42;13;3;6;82
"5969";"360811579024";7;2;9;3;5;26
"5970";"360811579025";6;11;27;4;21;69
"5971";"360811579031";5;0;12;11;12;40
"5972";"360811579032";2;4;44;10;15;75
"5973";"360811579033";10;4;19;15;13;61
"5974";"360811579034";3;9;97;52;62;223
"5975";"360811617001";11;0;29;13;26;79
"5976";"360811617002";3;1;12;7;1;24
"5977";"360811617003";2;2;14;8;11;37
"5978";"360811617004";15;3;35;20;28;101
"5979";"360811621001";16;1;13;3;14;47
"5980";"360811621002";15;4;31;6;12;68
"5981";"360811621003";23;7;13;5;11;59
"5982";"360811621004";2;2;13;7;12;36
"5983";"360811621005";29;11;39;13;20;112
"5984";"360850003001";54;1;13;0;18;86
"5985";"360850003002";20;5;47;25;20;117
"5986";"360850006001";13;96;24;5;8;146
"5987";"360850006002";25;14;92;32;15;178
"5988";"360850007001";31;1;5;2;11;50
"5989";"360850007002";6;0;48;7;6;67
"5990";"360850007003";44;5;39;11;4;103
"5991";"360850007004";42;9;42;6;14;113
"5992";"360850008001";8;0;59;35;33;135
"5993";"360850008002";53;7;73;7;11;151
"5994";"360850008003";2;4;16;13;17;52
"5995";"360850009001";97;4;72;23;8;204
"5996";"360850009002";10;3;17;6;12;48
"5997";"360850011001";22;38;76;24;21;181
"5998";"360850011002";94;7;13;6;14;134
"5999";"360850011003";41;22;28;13;14;118
"6000";"360850017001";3;1;19;5;4;32
"6001";"360850017002";40;5;20;25;20;110
"6002";"360850018001";0;1;0;0;0;1
"6003";"360850020011";4;0;31;31;5;71
"6004";"360850020012";3;1;42;17;8;71
"6005";"360850020021";30;2;48;29;15;124
"6006";"360850020022";1;2;11;10;7;31
"6007";"360850021001";110;37;63;27;40;277
"6008";"360850021002";19;26;54;29;59;187
"6009";"360850021003";44;72;59;52;59;286
"6010";"360850027001";47;53;23;16;51;190
"6011";"360850029001";21;4;52;59;27;163
"6012";"360850029002";178;12;11;7;7;215
"6013";"360850029003";86;82;36;35;17;256
"6014";"360850029004";19;8;33;14;19;93
"6015";"360850033001";17;2;27;19;2;67
"6016";"360850033002";32;34;156;60;30;312
"6017";"360850036001";29;1;41;27;13;111
"6018";"360850036002";17;1;33;14;9;74
"6019";"360850039001";4;1;6;13;1;25
"6020";"360850039002";26;0;53;10;2;91
"6021";"360850040001";21;1;22;15;17;76
"6022";"360850040002";207;35;14;30;11;297
"6023";"360850040003";80;7;11;3;5;106
"6024";"360850040004";61;2;12;1;11;87
"6025";"360850040005";16;6;3;1;7;33
"6026";"360850040006";25;7;15;12;16;75
"6027";"360850040007";30;1;11;32;13;87
"6028";"360850047001";10;2;37;15;13;77
"6029";"360850047002";11;2;21;2;6;42
"6030";"360850050001";0;3;25;11;4;43
"6031";"360850050002";10;0;21;13;4;48
"6032";"360850050003";6;2;21;12;4;45
"6033";"360850059001";66;28;106;25;14;239
"6034";"360850059002";2;6;11;8;9;36
"6035";"360850064001";4;1;25;5;11;46
"6036";"360850064002";5;0;12;4;3;24
"6037";"360850064003";61;2;88;13;21;185
"6038";"360850067001";7;1;13;13;6;40
"6039";"360850067002";23;7;38;6;10;84
"6040";"360850067003";10;2;10;16;9;47
"6041";"360850070001";24;21;73;26;30;174
"6042";"360850070002";2;2;208;11;9;232
"6043";"360850070003";17;6;33;53;22;131
"6044";"360850070004";12;3;29;10;8;62
"6045";"360850074001";19;3;69;18;18;127
"6046";"360850074002";64;9;53;22;27;175
"6047";"360850075001";14;0;17;15;20;66
"6048";"360850075002";22;3;39;12;30;106
"6049";"360850075003";56;8;38;42;29;173
"6050";"360850077001";64;16;12;20;22;134
"6051";"360850081001";34;8;31;20;22;115
"6052";"360850081002";24;1;15;13;3;56
"6053";"360850081003";132;28;22;18;30;230
"6054";"360850096011";32;12;120;102;13;279
"6055";"360850096012";6;1;67;13;23;110
"6056";"360850096021";7;3;37;26;8;81
"6057";"360850096022";32;4;13;6;19;74
"6058";"360850096023";5;2;16;6;13;42
"6059";"360850097001";30;3;33;19;12;97
"6060";"360850097002";14;1;6;3;7;31
"6061";"360850097003";25;12;5;17;2;61
"6062";"360850105001";16;21;15;3;9;64
"6063";"360850105002";6;23;28;8;14;79
"6064";"360850105003";6;2;24;16;4;52
"6065";"360850105004";14;2;77;35;23;151
"6066";"360850105005";34;32;22;13;13;114
"6067";"360850112011";20;2;55;10;38;125
"6068";"360850112012";73;29;95;34;32;263
"6069";"360850112021";23;12;42;14;29;120
"6070";"360850112022";17;9;50;15;17;108
"6071";"360850112023";27;5;15;3;11;61
"6072";"360850114011";31;6;47;7;3;94
"6073";"360850114012";235;7;18;11;10;281
"6074";"360850114021";2;3;3;2;10;20
"6075";"360850114022";22;0;16;6;13;57
"6076";"360850114023";3;2;6;11;9;31
"6077";"360850121001";7;2;5;4;4;22
"6078";"360850121002";1;0;17;3;7;28
"6079";"360850121003";2;3;12;5;8;30
"6080";"360850122001";3;1;10;9;10;33
"6081";"360850122002";7;4;9;3;12;35
"6082";"360850122003";4;4;6;5;7;26
"6083";"360850122004";19;133;4;5;8;169
"6084";"360850125001";115;13;42;29;23;222
"6085";"360850125002";54;131;17;23;13;238
"6086";"360850125003";9;2;7;10;5;33
"6087";"360850128041";26;6;45;42;36;155
"6088";"360850128042";65;20;147;25;106;363
"6089";"360850128051";7;2;14;17;18;58
"6090";"360850128061";3;1;6;9;1;20
"6091";"360850128062";12;5;13;16;5;51
"6092";"360850128063";30;3;18;1;10;62
"6093";"360850128064";28;2;32;14;19;95
"6094";"360850132011";6;1;12;4;0;23
"6095";"360850132012";2;8;5;1;2;18
"6096";"360850132031";7;1;17;16;4;45
"6097";"360850132032";11;0;20;6;14;51
"6098";"360850132033";24;3;28;15;11;81
"6099";"360850132041";5;0;38;9;10;62
"6100";"360850132042";23;3;45;24;10;105
"6101";"360850132043";2;1;21;5;12;41
"6102";"360850133011";104;3;6;2;6;121
"6103";"360850133021";15;2;41;53;22;133
"6104";"360850133022";14;19;37;32;38;140
"6105";"360850133023";111;25;51;26;30;243
"6106";"360850134001";7;4;30;17;11;69
"6107";"360850134002";1;1;19;7;12;40
"6108";"360850134003";7;1;22;11;16;57
"6109";"360850138001";4;2;4;4;4;18
"6110";"360850138002";9;1;13;2;11;36
"6111";"360850138003";3;1;5;10;8;27
"6112";"360850138004";4;0;5;3;9;21
"6113";"360850138005";3;1;21;15;5;45
"6114";"360850141001";22;7;19;9;14;71
"6115";"360850141002";8;0;8;8;8;32
"6116";"360850146041";9;2;24;3;6;44
"6117";"360850146042";9;4;31;7;12;63
"6118";"360850146043";8;3;31;11;10;63
"6119";"360850146044";17;20;68;6;8;119
"6120";"360850146051";20;40;87;25;19;191
"6121";"360850146052";39;22;26;6;18;111
"6122";"360850146061";15;3;73;15;14;120
"6123";"360850146062";21;1;63;3;34;122
"6124";"360850146063";16;3;22;10;23;74
"6125";"360850146064";8;2;35;3;6;54
"6126";"360850146071";9;4;59;23;19;114
"6127";"360850146072";65;18;13;17;6;119
"6128";"360850146081";5;2;103;5;4;119
"6129";"360850146082";8;7;17;7;6;45
"6130";"360850147001";2;0;5;6;2;15
"6131";"360850147002";8;4;29;17;7;65
"6132";"360850147003";6;1;42;10;7;66
"6133";"360850151001";20;4;17;19;10;70
"6134";"360850151002";11;4;5;2;6;28
"6135";"360850151003";2;0;11;10;5;28
"6136";"360850151004";11;0;5;7;8;31
"6137";"360850151005";39;8;18;7;3;75
"6138";"360850154001";1;0;1;0;1;3
"6139";"360850156011";16;9;17;5;4;51
"6140";"360850156012";3;1;11;4;6;25
"6141";"360850156013";6;1;19;36;9;71
"6142";"360850156014";20;0;10;4;3;37
"6143";"360850156015";1;0;2;4;1;8
"6144";"360850156016";1;0;3;5;1;10
"6145";"360850156021";5;3;15;2;6;31
"6146";"360850156022";4;1;23;1;20;49
"6147";"360850156023";6;1;11;0;5;23
"6148";"360850156024";0;0;13;8;5;26
"6149";"360850156031";4;2;11;2;7;26
"6150";"360850156032";9;12;38;16;24;99
"6151";"360850156033";7;84;57;22;15;185
"6152";"360850169011";0;1;16;14;35;66
"6153";"360850169012";16;3;44;17;12;92
"6154";"360850170051";24;9;20;13;23;89
"6155";"360850170052";8;9;17;16;15;65
"6156";"360850170071";10;28;21;15;15;89
"6157";"360850170072";16;8;39;4;12;79
"6158";"360850170081";16;1;51;14;16;98
"6159";"360850170082";17;0;101;10;18;146
"6160";"360850170083";17;2;119;12;16;166
"6161";"360850170091";9;0;8;1;7;25
"6162";"360850170092";6;0;10;4;11;31
"6163";"360850170093";2;0;14;6;6;28
"6164";"360850170101";10;0;80;13;10;113
"6165";"360850170102";11;5;40;17;9;82
"6166";"360850170103";9;1;103;15;14;142
"6167";"360850170104";6;1;20;6;13;46
"6168";"360850170111";9;1;40;14;6;70
"6169";"360850170112";12;1;30;20;9;72
"6170";"360850170121";11;4;34;12;9;70
"6171";"360850170122";2;2;9;3;9;25
"6172";"360850170123";0;0;33;5;9;47
"6173";"360850173001";8;7;19;11;6;51
"6174";"360850173002";132;11;2;0;7;152
"6175";"360850176001";10;3;22;4;2;41
"6176";"360850176002";3;0;14;3;7;27
"6177";"360850176003";6;0;8;4;10;28
"6178";"360850176004";10;0;20;10;9;49
"6179";"360850177001";7;0;10;4;6;27
"6180";"360850177002";8;2;14;4;7;35
"6181";"360850177003";8;0;3;9;3;23
"6182";"360850177004";8;0;16;3;5;32
"6183";"360850177005";1;2;20;13;17;53
"6184";"360850177006";0;1;0;1;1;3
"6185";"360850181001";8;0;5;2;6;21
"6186";"360850181002";5;3;13;1;5;27
"6187";"360850181003";0;3;15;0;7;25
"6188";"360850187011";9;10;19;10;28;76
"6189";"360850187012";9;2;15;13;11;50
"6190";"360850187021";26;2;20;28;5;81
"6191";"360850187022";9;3;29;13;20;74
"6192";"360850187023";8;3;38;10;3;62
"6193";"360850187024";27;0;49;5;17;98
"6194";"360850189011";72;12;54;28;22;188
"6195";"360850189012";11;4;9;10;18;52
"6196";"360850189021";16;0;25;16;6;63
"6197";"360850189022";5;1;32;22;7;67
"6198";"360850189023";12;3;22;10;5;52
"6199";"360850197001";3;1;8;13;1;26
"6200";"360850197002";20;3;8;6;3;40
"6201";"360850198001";0;5;0;1;1;7
"6202";"360850198002";7;3;45;5;15;75
"6203";"360850198003";7;3;6;6;11;33
"6204";"360850198004";9;1;36;5;14;65
"6205";"360850201001";45;6;15;9;19;94
"6206";"360850201002";3;8;22;9;5;47
"6207";"360850201003";6;4;10;5;17;42
"6208";"360850207001";65;17;90;27;56;255
"6209";"360850207002";18;5;38;25;23;109
"6210";"360850207003";19;3;19;17;15;73
"6211";"360850207004";32;5;35;27;29;128
"6212";"360850208011";5;3;61;20;10;99
"6213";"360850208012";8;1;40;13;6;68
"6214";"360850208013";11;3;60;10;24;108
"6215";"360850208014";19;3;57;17;7;103
"6216";"360850208031";14;3;86;15;13;131
"6217";"360850208032";11;2;18;17;21;69
"6218";"360850208033";3;0;10;1;8;22
"6219";"360850208041";19;1;14;10;13;57
"6220";"360850208042";7;0;36;11;19;73
"6221";"360850208043";1;0;33;9;23;66
"6222";"360850213001";40;10;55;31;27;163
"6223";"360850213002";32;30;13;5;14;94
"6224";"360850213003";52;4;36;20;21;133
"6225";"360850213004";12;1;26;8;11;58
"6226";"360850213005";11;5;52;9;17;94
"6227";"360850223001";30;11;41;33;29;144
"6228";"360850223002";19;4;90;68;42;223
"6229";"360850226001";2;3;89;30;16;140
"6230";"360850226002";4;4;57;7;11;83
"6231";"360850226003";3;3;61;19;17;103
"6232";"360850226004";17;7;13;9;25;71
"6233";"360850228001";5;8;13;11;9;46
"6234";"360850231001";59;13;44;28;42;186
"6235";"360850231002";24;6;20;6;12;68
"6236";"360850239001";30;10;42;26;45;153
"6237";"360850239002";32;3;35;14;31;115
"6238";"360850244011";5;1;8;8;12;34
"6239";"360850244012";13;1;20;8;28;70
"6240";"360850244013";7;5;16;2;19;49
"6241";"360850244021";4;1;20;2;5;32
"6242";"360850244022";3;21;21;13;24;82
"6243";"360850247001";25;4;28;12;18;87
"6244";"360850247002";18;9;18;48;10;103
"6245";"360850248001";7;6;52;13;11;89
"6246";"360850248002";5;5;27;9;5;51
"6247";"360850248003";11;101;40;7;23;182
"6248";"360850251001";8;6;31;20;10;75
"6249";"360850251002";7;3;8;12;6;36
"6250";"360850251003";10;4;36;12;22;84
"6251";"360850273011";1;1;20;8;3;33
"6252";"360850273012";13;2;63;33;12;123
"6253";"360850273021";36;42;56;12;8;154
"6254";"360850273022";5;3;23;4;3;38
"6255";"360850277021";6;3;46;4;4;63
"6256";"360850277022";12;3;15;6;7;43
"6257";"360850277023";15;6;38;16;13;88
"6258";"360850277041";14;0;196;22;8;240
"6259";"360850277042";8;8;38;7;11;72
"6260";"360850277051";10;5;109;64;10;198
"6261";"360850277052";23;0;15;10;11;59
"6262";"360850277053";0;4;16;7;15;42
"6263";"360850277061";17;1;33;22;68;141
"6264";"360850277062";10;0;25;9;8;52
"6265";"360850277063";2;1;22;14;2;41
"6266";"360850279001";4;4;43;12;11;74
"6267";"360850279002";7;0;9;1;8;25
"6268";"360850291021";3;5;39;15;18;80
"6269";"360850291022";27;12;99;26;17;181
"6270";"360850291031";15;3;66;17;15;116
"6271";"360850291032";2;0;5;2;3;12
"6272";"360850291033";23;2;17;7;7;56
"6273";"360850291034";11;0;6;11;6;34
"6274";"360850291035";9;2;24;12;24;71
"6275";"360850291041";18;1;63;26;21;129
"6276";"360850291042";15;8;33;13;7;76
"6277";"360850291043";5;3;35;9;5;57
"6278";"360850291044";8;5;31;23;21;88
"6279";"360850303011";58;4;79;45;20;206
"6280";"360850303012";6;4;18;12;13;53
"6281";"360850303021";6;5;29;8;21;69
"6282";"360850303022";26;10;112;17;5;170
"6283";"360850303023";7;1;62;9;6;85
"6284";"360850303024";11;3;10;8;3;35
"6285";"360850319011";87;8;21;7;6;129
"6286";"360850319012";28;5;12;8;14;67
"6287";"360850319021";34;0;12;9;1;56
"6288";"360850319022";52;2;27;34;24;139
"6289";"360850319023";14;5;80;42;14;155
"6290";"360850323001";41;1;16;30;24;112
"6291";"361190002031";0;0;1;0;0;1
"6292";"361190015031";2;0;9;2;1;14
"6293";"361190026001";0;0;1;0;0;1
"6294";"361190026003";7;1;4;2;0;14
"6295";"361190029002";0;0;2;0;0;2
