"";"Data";"0";"1";"3";"4";"5";"sum"
"1";"360050001001";0;0;3;0;1;4
"2";"360050002001";84;19;150;28;30;311
"3";"360050002002";154;79;89;89;29;440
"4";"360050002003";48;13;23;59;22;165
"5";"360050004001";4;2;37;17;13;73
"6";"360050004002";42;19;110;59;29;259
"7";"360050004003";38;59;44;7;10;158
"8";"360050004004";7;3;26;8;4;48
"9";"360050016001";39;6;38;0;10;93
"10";"360050016002";19;7;50;28;9;113
"11";"360050016003";11;0;4;0;2;17
"12";"360050016004";40;8;53;51;8;160
"13";"360050019001";30;14;89;21;37;191
"14";"360050019002";2;10;52;4;3;71
"15";"360050019003";11;8;80;41;45;185
"16";"360050019004";18;0;16;3;11;48
"17";"360050020001";31;13;70;31;7;152
"18";"360050020002";52;19;50;13;11;145
"19";"360050020003";52;16;1;0;3;72
"20";"360050020004";17;13;0;0;0;30
"21";"360050020005";47;1;1;1;0;50
"22";"360050020006";50;6;73;4;8;141
"23";"360050023001";135;9;7;0;6;157
"24";"360050023002";0;0;1;0;0;1
"25";"360050023003";28;5;5;0;3;41
"26";"360050024000";4;2;6;0;0;12
"27";"360050024001";62;11;5;0;0;78
"28";"360050025001";24;18;2;1;33;78
"29";"360050025002";17;0;2;0;2;21
"30";"360050025003";8;14;5;1;20;48
"31";"360050025004";61;12;3;0;5;81
"32";"360050025005";18;18;4;1;8;49
"33";"360050027011";71;0;13;4;4;92
"34";"360050027012";77;11;46;1;8;143
"35";"360050027021";33;7;8;0;6;54
"36";"360050027022";13;1;4;0;9;27
"37";"360050027023";23;13;15;1;27;79
"38";"360050027024";248;9;9;1;1;268
"39";"360050028001";18;27;74;20;20;159
"40";"360050028002";17;22;3;2;0;44
"41";"360050028003";4;0;1;0;1;6
"42";"360050028004";14;48;10;0;1;73
"43";"360050031001";81;42;49;14;31;217
"44";"360050033001";5;4;24;14;12;59
"45";"360050033002";73;6;12;1;2;94
"46";"360050033003";58;18;13;0;6;95
"47";"360050035001";19;10;36;11;21;97
"48";"360050035002";111;44;4;0;3;162
"49";"360050035003";43;33;53;2;25;156
"50";"360050037001";17;3;2;0;2;24
"51";"360050038001";88;6;60;46;7;207
"52";"360050039001";77;20;19;0;7;123
"53";"360050039002";21;21;12;1;18;73
"54";"360050039003";33;51;16;4;17;121
"55";"360050039004";34;4;18;1;43;100
"56";"360050039005";51;10;28;7;21;117
"57";"360050040011";18;9;73;18;13;131
"58";"360050041001";50;5;7;0;7;69
"59";"360050041002";75;5;52;4;29;165
"60";"360050041003";1;0;0;0;2;3
"61";"360050041004";165;27;4;1;14;211
"62";"360050042001";9;1;0;0;0;10
"63";"360050042002";101;8;3;0;1;113
"64";"360050042003";16;1;15;0;4;36
"65";"360050042004";12;1;0;4;0;17
"66";"360050042005";34;4;14;2;3;57
"67";"360050042006";0;3;3;0;1;7
"68";"360050042007";9;0;0;0;0;9
"69";"360050043001";68;52;18;7;40;185
"70";"360050043002";25;18;32;3;22;100
"71";"360050043003";53;32;13;3;10;111
"72";"360050043004";42;131;17;0;13;203
"73";"360050044001";15;7;1;4;2;29
"74";"360050044002";13;11;1;0;2;27
"75";"360050044003";13;3;31;2;6;55
"76";"360050044004";63;10;11;7;1;92
"77";"360050046001";60;5;15;17;20;117
"78";"360050048001";96;35;29;0;25;185
"79";"360050048002";52;33;83;3;23;194
"80";"360050050011";35;29;111;1;7;183
"81";"360050050012";174;26;16;0;574;790
"82";"360050050013";67;31;35;1;17;151
"83";"360050050014";44;20;11;6;5;86
"84";"360050050021";112;31;23;1;27;194
"85";"360050050022";16;11;15;1;5;48
"86";"360050050023";23;25;11;1;12;72
"87";"360050050024";71;33;7;1;9;121
"88";"360050051001";25;30;40;19;20;134
"89";"360050051002";119;21;62;8;19;229
"90";"360050051003";78;8;3;0;6;95
"91";"360050052001";14;4;145;6;15;184
"92";"360050052002";125;58;5;0;9;197
"93";"360050053001";164;3;0;0;10;177
"94";"360050053002";0;0;6;0;0;6
"95";"360050054001";11;4;31;0;24;70
"96";"360050054002";90;15;122;4;32;263
"97";"360050054003";34;27;52;12;40;165
"98";"360050054004";32;13;6;0;7;58
"99";"360050056001";160;12;24;0;2;198
"100";"360050056002";5;0;15;0;0;20
"101";"360050056003";37;5;65;7;11;125
"102";"360050059021";6;8;13;3;10;40
"103";"360050059022";0;7;34;3;7;51
"104";"360050060001";41;44;58;8;14;165
"105";"360050061001";1;2;11;0;0;14
"106";"360050061002";11;8;9;0;5;33
"107";"360050061003";2;7;13;12;4;38
"108";"360050062001";244;11;78;2;12;347
"109";"360050062002";57;1;14;0;4;76
"110";"360050062003";140;14;13;2;5;174
"111";"360050062004";45;188;56;1;19;309
"112";"360050062005";0;2;3;0;3;8
"113";"360050063001";28;39;14;2;7;90
"114";"360050063002";16;24;79;12;52;183
"115";"360050063003";62;135;15;3;14;229
"116";"360050063004";44;149;1;0;2;196
"117";"360050063005";43;52;9;1;9;114
"118";"360050063006";302;178;67;11;75;633
"119";"360050064001";30;13;89;2;9;143
"120";"360050064002";19;4;8;2;4;37
"121";"360050064003";7;0;28;3;5;43
"122";"360050064004";18;5;68;0;5;96
"123";"360050065001";52;9;32;1;65;159
"124";"360050065002";37;12;14;1;14;78
"125";"360050065003";31;3;20;7;8;69
"126";"360050065004";14;19;10;1;35;79
"127";"360050067001";57;27;34;4;20;142
"128";"360050067002";50;13;20;0;11;94
"129";"360050067003";23;10;2;2;7;44
"130";"360050067004";23;7;3;3;5;41
"131";"360050067005";10;3;1;0;9;23
"132";"360050067006";19;5;55;6;6;91
"133";"360050068001";28;16;42;4;4;94
"134";"360050068002";17;5;38;2;6;68
"135";"360050068003";49;23;89;2;10;173
"136";"360050069001";70;74;38;1;20;203
"137";"360050069002";128;25;80;21;20;274
"138";"360050069003";9;25;1;0;0;35
"139";"360050069004";10;1;2;1;0;14
"140";"360050070001";65;11;110;8;19;213
"141";"360050070002";75;793;50;2;27;947
"142";"360050070003";291;355;79;2;18;745
"143";"360050071001";7;5;63;3;4;82
"144";"360050071002";109;51;43;2;31;236
"145";"360050072001";70;33;57;2;27;189
"146";"360050072002";38;12;80;3;18;151
"147";"360050072003";20;5;18;0;13;56
"148";"360050072004";6;6;42;1;7;62
"149";"360050073001";61;19;56;2;19;157
"150";"360050073002";44;25;6;0;13;88
"151";"360050073003";57;33;7;0;10;107
"152";"360050074001";16;9;32;37;6;100
"153";"360050074002";52;13;23;9;24;121
"154";"360050074003";8;0;1;1;2;12
"155";"360050075001";122;21;82;1;21;247
"156";"360050075002";102;27;38;5;11;183
"157";"360050075003";158;2;7;0;3;170
"158";"360050075004";17;12;16;0;6;51
"159";"360050076001";6;4;5;1;12;28
"160";"360050076002";22;5;30;3;13;73
"161";"360050076003";3;2;23;2;4;34
"162";"360050076004";45;145;73;3;21;287
"163";"360050076005";16;3;108;11;20;158
"164";"360050077001";34;24;55;5;21;139
"165";"360050078001";20;6;64;5;21;116
"166";"360050078002";57;22;138;24;33;274
"167";"360050078003";22;26;8;3;8;67
"168";"360050078004";31;7;33;1;7;79
"169";"360050079001";56;23;16;2;28;125
"170";"360050079002";11;10;18;6;6;51
"171";"360050079003";9;10;6;0;4;29
"172";"360050079004";58;29;33;1;6;127
"173";"360050079005";19;2;7;1;2;31
"174";"360050079006";14;8;7;1;4;34
"175";"360050083001";15;11;15;0;7;48
"176";"360050083002";29;3;8;1;6;47
"177";"360050083003";51;5;25;1;7;89
"178";"360050083004";29;20;36;0;14;99
"179";"360050083005";26;18;13;5;6;68
"180";"360050083006";15;42;32;19;7;115
"181";"360050084001";16;0;28;23;9;76
"182";"360050084002";88;7;164;55;18;332
"183";"360050085001";38;16;44;0;22;120
"184";"360050085002";28;26;78;6;14;152
"185";"360050085003";28;9;9;3;6;55
"186";"360050085004";16;5;2;1;2;26
"187";"360050085005";10;5;3;0;3;21
"188";"360050086001";22;0;28;24;15;89
"189";"360050086002";58;3;7;14;4;86
"190";"360050086003";40;1;2;0;5;48
"191";"360050087001";21;8;9;7;18;63
"192";"360050087002";108;25;11;1;7;152
"193";"360050087003";35;9;16;0;3;63
"194";"360050087004";32;13;0;1;2;48
"195";"360050087005";31;23;5;12;9;80
"196";"360050089001";101;2;11;1;25;140
"197";"360050089002";33;7;44;0;11;95
"198";"360050090001";0;1;23;23;4;51
"199";"360050090002";3;48;9;23;8;91
"200";"360050090003";15;2;1;2;10;30
"201";"360050090004";6;0;64;24;17;111
"202";"360050090005";64;2;4;0;2;72
"203";"360050092001";90;8;29;0;9;136
"204";"360050092002";51;5;40;7;5;108
"205";"360050092003";23;15;45;10;33;126
"206";"360050092004";15;6;14;0;11;46
"207";"360050092005";14;24;73;18;4;133
"208";"360050093001";6;7;59;21;34;127
"209";"360050093002";34;26;31;8;25;124
"210";"360050093003";51;22;9;1;25;108
"211";"360050093004";54;22;32;7;9;124
"212";"360050093005";40;52;151;53;23;319
"213";"360050093006";0;13;119;111;18;261
"214";"360050096001";40;2;74;16;10;142
"215";"360050096002";17;37;108;38;30;230
"216";"360050098001";34;24;74;8;15;155
"217";"360050098002";38;10;25;4;5;82
"218";"360050098003";51;4;34;5;15;109
"219";"360050098004";8;2;30;5;6;51
"220";"360050098005";53;8;19;5;3;88
"221";"360050110001";22;31;25;31;6;115
"222";"360050115021";111;21;104;22;24;282
"223";"360050115022";56;18;37;5;11;127
"224";"360050115023";22;25;58;8;11;124
"225";"360050117001";76;53;24;14;10;177
"226";"360050117002";1;15;40;40;6;102
"227";"360050118001";14;3;42;20;8;87
"228";"360050118002";4;10;253;3;14;284
"229";"360050118003";52;66;83;32;9;242
"230";"360050119001";30;19;4;2;25;80
"231";"360050119002";30;2;25;4;19;80
"232";"360050119003";23;14;17;5;8;67
"233";"360050119004";19;1;2;2;4;28
"234";"360050119005";22;10;19;2;12;65
"235";"360050121011";274;54;35;10;13;386
"236";"360050121012";192;126;121;10;13;462
"237";"360050121021";25;36;13;1;35;110
"238";"360050123001";53;18;60;10;27;168
"239";"360050123002";147;15;45;4;14;225
"240";"360050123003";19;12;22;20;13;86
"241";"360050125001";51;28;116;3;33;231
"242";"360050125002";78;164;64;10;13;329
"243";"360050127011";9;3;7;2;11;32
"244";"360050127012";16;3;10;4;8;41
"245";"360050129011";35;18;61;18;26;158
"246";"360050129012";99;72;19;0;28;218
"247";"360050130001";17;2;61;18;12;110
"248";"360050131001";58;8;11;4;6;87
"249";"360050131002";61;10;83;34;23;211
"250";"360050131003";75;56;52;24;17;224
"251";"360050132001";35;5;52;22;23;137
"252";"360050132002";139;13;24;13;28;217
"253";"360050132003";15;11;137;16;14;193
"254";"360050132004";28;21;63;41;19;172
"255";"360050132005";43;6;46;24;14;133
"256";"360050133001";51;4;2;0;5;62
"257";"360050133002";38;24;30;1;5;98
"258";"360050133003";9;6;0;0;0;15
"259";"360050133004";133;1;3;0;1;138
"260";"360050135001";38;9;51;5;13;116
"261";"360050135002";26;4;12;0;9;51
"262";"360050135003";86;15;43;2;13;159
"263";"360050138001";12;25;15;32;11;95
"264";"360050138002";58;2;62;47;5;174
"265";"360050141001";64;16;14;11;9;114
"266";"360050141002";277;111;11;0;18;417
"267";"360050141003";69;56;59;5;14;203
"268";"360050143001";41;16;49;20;20;146
"269";"360050144001";2;0;0;0;1;3
"270";"360050144002";18;4;5;0;5;32
"271";"360050144003";33;1;0;4;0;38
"272";"360050144004";65;3;6;1;0;75
"273";"360050144005";48;6;46;9;10;119
"274";"360050144006";38;4;38;16;19;115
"275";"360050145001";68;8;23;3;18;120
"276";"360050145002";64;2;10;0;0;76
"277";"360050145003";4;4;27;4;7;46
"278";"360050145004";33;11;33;14;17;108
"279";"360050147011";62;17;1;1;1;82
"280";"360050147012";108;9;20;1;8;146
"281";"360050147013";52;7;7;0;6;72
"282";"360050147021";143;168;1;1;5;318
"283";"360050147022";125;5;11;0;3;144
"284";"360050147023";26;6;2;0;0;34
"285";"360050147024";19;30;2;0;1;52
"286";"360050149001";49;65;25;7;30;176
"287";"360050149002";31;56;92;7;7;193
"288";"360050149003";37;32;31;3;9;112
"289";"360050151001";22;5;16;0;7;50
"290";"360050151002";33;43;14;2;11;103
"291";"360050151003";55;30;28;1;9;123
"292";"360050151004";120;42;51;10;9;232
"293";"360050152001";47;4;48;39;28;166
"294";"360050152002";38;28;103;57;89;315
"295";"360050153001";165;63;83;41;21;373
"296";"360050153002";27;25;14;8;2;76
"297";"360050153003";22;20;74;12;6;134
"298";"360050155001";40;51;15;4;16;126
"299";"360050155002";20;10;17;6;19;72
"300";"360050157001";75;54;58;6;11;204
"301";"360050157002";76;23;36;11;24;170
"302";"360050157003";83;14;53;5;8;163
"303";"360050158001";33;5;105;89;21;253
"304";"360050159001";27;17;8;2;13;67
"305";"360050159002";118;21;5;1;8;153
"306";"360050160001";31;1;61;13;9;115
"307";"360050160002";3;1;31;5;2;42
"308";"360050160003";8;2;19;13;16;58
"309";"360050160004";4;1;25;9;7;46
"310";"360050161001";61;13;20;2;15;111
"311";"360050161002";19;43;21;8;10;101
"312";"360050161003";41;5;1;6;1;54
"313";"360050161004";36;46;12;4;10;108
"314";"360050162001";13;1;19;7;7;47
"315";"360050162002";37;13;38;22;12;122
"316";"360050163001";27;23;8;2;7;67
"317";"360050164001";16;5;38;14;5;78
"318";"360050165001";29;13;69;26;24;161
"319";"360050166001";35;5;64;14;29;147
"320";"360050166002";26;0;27;28;9;90
"321";"360050167001";20;25;9;6;6;66
"322";"360050167002";31;9;38;21;19;118
"323";"360050169001";147;26;36;0;13;222
"324";"360050171001";73;45;29;4;7;158
"325";"360050173001";10;16;120;5;10;161
"326";"360050173002";31;9;24;1;11;76
"327";"360050173003";42;18;44;10;14;128
"328";"360050173004";28;43;18;2;4;95
"329";"360050175001";33;9;10;6;13;71
"330";"360050175002";30;16;3;0;5;54
"331";"360050175003";46;15;3;4;3;71
"332";"360050175004";105;29;21;0;10;165
"333";"360050175005";37;1;2;0;1;41
"334";"360050175006";49;5;5;0;1;60
"335";"360050177011";209;99;59;2;4;373
"336";"360050177012";166;2;1;4;2;175
"337";"360050177013";30;11;27;5;13;86
"338";"360050177021";36;4;17;0;3;60
"339";"360050177022";46;14;76;7;23;166
"340";"360050177023";40;72;72;1;20;205
"341";"360050177024";24;15;17;1;9;66
"342";"360050179011";139;268;47;4;19;477
"343";"360050179012";3;6;1;0;1;11
"344";"360050179013";100;36;5;0;8;149
"345";"360050179021";61;40;34;2;10;147
"346";"360050179022";33;18;4;2;10;67
"347";"360050179023";25;65;3;0;13;106
"348";"360050181011";127;32;192;5;4;360
"349";"360050181012";50;4;12;0;5;71
"350";"360050181013";10;9;23;1;3;46
"351";"360050181021";54;21;16;3;8;102
"352";"360050181022";21;38;6;1;8;74
"353";"360050181023";34;5;16;0;3;58
"354";"360050181024";45;7;9;1;4;66
"355";"360050183011";100;32;40;0;7;179
"356";"360050183012";51;76;10;1;13;151
"357";"360050183013";156;37;20;0;5;218
"358";"360050183021";98;38;35;0;2;173
"359";"360050183022";36;33;23;7;8;107
"360";"360050183023";16;9;36;3;7;71
"361";"360050184001";15;2;52;21;21;111
"362";"360050184002";8;1;123;53;57;242
"363";"360050184003";4;3;17;10;11;45
"364";"360050184004";8;49;70;12;9;148
"365";"360050185001";138;30;148;16;24;356
"366";"360050185002";65;6;34;9;3;117
"367";"360050185003";78;46;54;3;27;208
"368";"360050185004";6;14;24;3;4;51
"369";"360050185005";20;3;21;0;8;52
"370";"360050189001";79;35;27;5;16;162
"371";"360050189002";6;7;4;1;4;22
"372";"360050189003";679;183;52;21;147;1082
"373";"360050189004";193;42;173;2;29;439
"374";"360050193001";301;66;15;2;13;397
"375";"360050193002";30;6;4;0;0;40
"376";"360050193003";12;5;3;4;3;27
"377";"360050193004";34;13;49;10;18;124
"378";"360050194001";24;9;94;46;19;192
"379";"360050195001";101;37;14;2;16;170
"380";"360050195002";100;131;27;2;32;292
"381";"360050195003";185;55;9;4;18;271
"382";"360050195004";30;8;9;0;4;51
"383";"360050197001";62;64;5;2;10;143
"384";"360050197002";93;52;8;7;9;169
"385";"360050197003";138;74;10;1;30;253
"386";"360050197004";10;5;3;1;13;32
"387";"360050197005";267;5;4;0;0;276
"388";"360050199001";43;23;3;0;7;76
"389";"360050199002";65;55;3;0;7;130
"390";"360050199003";15;13;48;4;8;88
"391";"360050199004";93;21;23;0;17;154
"392";"360050199005";21;20;4;0;6;51
"393";"360050199006";177;126;130;1;16;450
"394";"360050200001";22;23;56;8;48;157
"395";"360050200002";2;11;60;14;12;99
"396";"360050200003";58;15;72;12;53;210
"397";"360050200004";43;24;9;4;6;86
"398";"360050201001";67;67;39;5;1;179
"399";"360050201002";12;86;24;9;3;134
"400";"360050201003";57;20;14;2;17;110
"401";"360050202001";33;3;52;7;8;103
"402";"360050202002";64;8;64;1;30;167
"403";"360050204001";14;1;37;2;15;69
"404";"360050204002";10;2;35;5;6;58
"405";"360050204003";32;5;52;0;11;100
"406";"360050205011";67;97;10;8;5;187
"407";"360050205012";55;45;15;6;8;129
"408";"360050205013";43;28;61;5;7;144
"409";"360050205014";159;70;114;10;4;357
"410";"360050205021";18;11;47;8;2;86
"411";"360050205022";24;3;104;3;3;137
"412";"360050205023";15;3;82;2;14;116
"413";"360050206011";31;8;31;0;14;84
"414";"360050206012";13;3;140;13;24;193
"415";"360050209001";12;25;19;9;12;77
"416";"360050209002";57;18;5;1;9;90
"417";"360050209003";20;11;10;0;4;45
"418";"360050209004";207;12;32;1;6;258
"419";"360050210011";6;0;3;0;1;10
"420";"360050210012";22;0;3;0;3;28
"421";"360050210013";2;0;0;0;0;2
"422";"360050210014";4;0;1;2;5;12
"423";"360050210015";8;2;2;1;7;20
"424";"360050210016";15;0;1;0;0;16
"425";"360050210021";6;1;3;0;0;10
"426";"360050210022";20;5;11;0;0;36
"427";"360050210023";0;0;2;0;0;2
"428";"360050210025";1;0;3;2;0;6
"429";"360050210026";5;1;3;0;0;9
"430";"360050210027";0;0;1;0;3;4
"431";"360050211001";105;7;58;4;13;187
"432";"360050211002";36;47;14;6;13;116
"433";"360050211003";30;18;29;4;3;84
"434";"360050211004";6;2;6;0;3;17
"435";"360050212001";2;0;1;0;0;3
"436";"360050212002";1;0;0;0;0;1
"437";"360050212004";7;1;10;0;3;21
"438";"360050212005";2;0;0;0;0;2
"439";"360050213011";4;2;10;0;0;16
"440";"360050213012";30;12;46;2;4;94
"441";"360050213021";59;41;54;14;17;185
"442";"360050213022";17;13;34;5;2;71
"443";"360050213023";12;5;16;2;7;42
"444";"360050213024";98;64;151;1;2;316
"445";"360050215011";14;17;11;1;9;52
"446";"360050215012";125;58;37;0;3;223
"447";"360050215013";26;37;43;0;4;110
"448";"360050215021";73;45;27;7;8;160
"449";"360050215022";48;6;63;3;11;131
"450";"360050215023";29;5;96;2;13;145
"451";"360050215024";96;10;48;1;4;159
"452";"360050215025";36;3;15;1;6;61
"453";"360050216011";45;16;95;3;11;170
"454";"360050216012";97;12;112;3;23;247
"455";"360050216013";41;2;8;6;6;63
"456";"360050216014";37;1;14;8;3;63
"457";"360050216021";24;4;37;0;13;78
"458";"360050216022";39;4;1;0;6;50
"459";"360050216023";4;5;1;0;1;11
"460";"360050216024";6;3;12;0;7;28
"461";"360050216025";16;27;13;2;9;67
"462";"360050217001";54;42;107;18;15;236
"463";"360050217002";300;54;9;0;7;370
"464";"360050217003";3;4;14;10;11;42
"465";"360050217004";78;73;39;0;1;191
"466";"360050218001";44;22;3;6;7;82
"467";"360050218002";58;39;48;5;11;161
"468";"360050218003";110;7;176;5;21;319
"469";"360050218004";30;2;79;23;15;149
"470";"360050218005";69;2;34;10;20;135
"471";"360050219001";118;191;97;32;35;473
"472";"360050220001";134;29;112;11;21;307
"473";"360050221011";57;7;1;0;3;68
"474";"360050221012";11;19;16;0;8;54
"475";"360050221013";103;27;13;2;6;151
"476";"360050221021";66;86;21;3;18;194
"477";"360050221022";38;31;3;0;8;80
"478";"360050221023";91;14;6;1;21;133
"479";"360050222001";21;12;64;1;7;105
"480";"360050222002";11;1;25;0;20;57
"481";"360050222003";46;67;61;5;26;205
"482";"360050222004";8;2;14;2;97;123
"483";"360050223001";14;56;9;3;14;96
"484";"360050223002";42;22;12;1;6;83
"485";"360050223003";59;66;4;4;9;142
"486";"360050223004";21;18;4;2;8;53
"487";"360050224011";5;10;2;1;7;25
"488";"360050224012";119;14;14;4;13;164
"489";"360050224031";115;11;10;2;8;146
"490";"360050224032";64;17;13;1;23;118
"491";"360050224041";14;13;21;0;6;54
"492";"360050224042";81;8;16;1;6;112
"493";"360050224043";91;14;18;0;3;126
"494";"360050225001";69;38;10;3;17;137
"495";"360050225002";43;37;26;3;9;118
"496";"360050225003";13;28;4;2;10;57
"497";"360050225004";26;11;15;0;9;61
"498";"360050225005";36;20;5;1;5;67
"499";"360050225006";37;10;7;3;4;61
"500";"360050227011";63;13;13;7;14;110
"501";"360050227012";54;40;17;1;25;137
"502";"360050227013";30;27;85;15;21;178
"503";"360050227021";105;30;41;11;26;213
"504";"360050227031";21;41;13;4;3;82
"505";"360050228001";19;13;85;0;15;132
"506";"360050228002";120;18;14;1;9;162
"507";"360050228003";110;9;5;1;7;132
"508";"360050228004";56;9;4;0;3;72
"509";"360050229011";112;26;17;1;14;170
"510";"360050229012";57;44;57;0;3;161
"511";"360050229013";54;123;5;0;3;185
"512";"360050229014";39;87;54;1;5;186
"513";"360050229015";105;68;93;1;12;279
"514";"360050229021";15;13;35;11;1;75
"515";"360050229022";30;16;41;10;4;101
"516";"360050229023";55;15;5;1;4;80
"517";"360050230001";84;14;93;11;22;224
"518";"360050230002";49;5;149;2;8;213
"519";"360050231001";43;33;49;10;21;156
"520";"360050232001";18;20;80;6;17;141
"521";"360050232002";22;11;79;4;10;126
"522";"360050233011";34;33;21;8;12;108
"523";"360050233012";115;263;10;1;25;414
"524";"360050233013";14;15;45;4;10;88
"525";"360050233014";45;3;14;0;4;66
"526";"360050233021";115;80;14;4;12;225
"527";"360050233022";36;125;29;4;14;208
"528";"360050235011";90;15;14;1;37;157
"529";"360050235012";18;22;7;0;10;57
"530";"360050235013";27;57;0;0;8;92
"531";"360050235021";29;27;22;1;4;83
"532";"360050235022";26;22;13;0;7;68
"533";"360050235023";21;5;16;5;14;61
"534";"360050235024";182;36;5;2;15;240
"535";"360050236001";16;17;62;9;7;111
"536";"360050236002";11;14;23;3;14;65
"537";"360050237021";71;23;6;4;24;128
"538";"360050237031";70;39;54;0;45;208
"539";"360050237032";77;115;2;3;116;313
"540";"360050237033";82;44;12;2;12;152
"541";"360050237041";65;27;3;0;5;100
"542";"360050237042";87;32;31;1;5;156
"543";"360050237043";320;35;0;1;3;359
"544";"360050238001";0;3;31;2;12;48
"545";"360050238002";22;16;110;6;13;167
"546";"360050238003";31;11;61;5;10;118
"547";"360050239001";208;198;37;4;16;463
"548";"360050239002";46;110;17;4;14;191
"549";"360050239003";28;16;67;4;10;125
"550";"360050239004";110;52;33;1;28;224
"551";"360050239005";24;63;9;1;4;101
"552";"360050239006";111;26;9;1;8;155
"553";"360050240001";54;17;188;32;54;345
"554";"360050240002";21;8;46;7;8;90
"555";"360050240003";59;11;51;7;16;144
"556";"360050241001";68;40;5;3;18;134
"557";"360050241002";17;6;7;1;26;57
"558";"360050241003";48;8;36;1;15;108
"559";"360050241004";31;6;6;0;10;53
"560";"360050241005";56;19;8;0;8;91
"561";"360050243001";16;21;4;1;42;84
"562";"360050243002";17;7;84;3;9;120
"563";"360050243003";28;0;9;0;1;38
"564";"360050243004";72;5;67;2;12;158
"565";"360050244001";28;11;55;3;4;101
"566";"360050244002";17;7;99;44;17;184
"567";"360050245011";70;33;39;0;3;145
"568";"360050245012";49;36;101;1;4;191
"569";"360050245013";12;3;18;5;1;39
"570";"360050245014";19;8;35;2;6;70
"571";"360050245021";16;37;54;0;4;111
"572";"360050245022";2;3;3;1;2;11
"573";"360050245023";90;67;66;1;11;235
"574";"360050246001";227;3;108;16;23;377
"575";"360050246002";33;2;68;7;7;117
"576";"360050247001";0;0;7;0;2;9
"577";"360050247002";32;2;20;2;3;59
"578";"360050248001";11;2;38;8;4;63
"579";"360050248002";14;4;88;18;10;134
"580";"360050248003";12;1;93;11;13;130
"581";"360050249001";26;10;30;0;3;69
"582";"360050250001";108;1;33;7;18;167
"583";"360050250002";17;2;47;23;24;113
"584";"360050251001";85;77;37;1;5;205
"585";"360050251002";42;108;61;3;3;217
"586";"360050251003";40;57;51;5;21;174
"587";"360050251004";7;4;17;2;0;30
"588";"360050251005";44;20;53;3;8;128
"589";"360050251006";36;15;44;0;3;98
"590";"360050251007";7;4;9;0;2;22
"591";"360050252001";44;6;103;35;20;208
"592";"360050252002";38;5;103;78;3;227
"593";"360050253001";355;15;17;0;12;399
"594";"360050253002";46;23;54;0;6;129
"595";"360050253003";52;20;6;0;21;99
"596";"360050253004";56;18;15;2;12;103
"597";"360050254001";32;10;60;7;13;122
"598";"360050254002";11;20;61;13;11;116
"599";"360050255001";89;103;32;6;23;253
"600";"360050255002";114;68;28;8;15;233
"601";"360050255003";215;175;84;0;17;491
"602";"360050256001";52;15;53;97;20;237
"603";"360050256002";31;20;87;41;13;192
"604";"360050257001";75;17;228;4;11;335
"605";"360050261001";115;45;34;2;6;202
"606";"360050263001";156;102;14;0;25;297
"607";"360050263002";74;41;7;4;3;129
"608";"360050263003";224;137;44;3;8;416
"609";"360050263004";8;43;75;2;2;130
"610";"360050263005";28;17;8;1;4;58
"611";"360050264001";37;5;67;12;24;145
"612";"360050264002";10;3;65;21;21;120
"613";"360050264003";17;2;95;23;16;153
"614";"360050264004";21;3;43;26;11;104
"615";"360050265001";70;29;37;4;14;154
"616";"360050265002";170;51;36;4;9;270
"617";"360050265003";94;53;10;1;14;172
"618";"360050265004";21;53;32;0;5;111
"619";"360050266011";13;1;32;11;6;63
"620";"360050266012";21;21;9;1;7;59
"621";"360050266013";1;2;34;12;7;56
"622";"360050266021";44;4;50;8;14;120
"623";"360050266022";45;11;44;17;13;130
"624";"360050266023";18;1;88;15;24;146
"625";"360050266024";13;1;47;3;5;69
"626";"360050266025";23;2;42;7;19;93
"627";"360050267011";110;5;42;0;4;161
"628";"360050267012";119;67;3;0;7;196
"629";"360050267013";63;4;24;0;13;104
"630";"360050267021";90;33;74;3;17;217
"631";"360050267022";24;5;14;0;8;51
"632";"360050267023";62;8;18;0;3;91
"633";"360050267024";16;0;16;0;4;36
"634";"360050267025";11;8;11;0;7;37
"635";"360050267026";72;17;92;2;17;200
"636";"360050269001";32;83;264;14;15;408
"637";"360050269002";177;9;42;3;2;233
"638";"360050269003";37;14;32;0;2;85
"639";"360050273001";18;30;17;4;6;75
"640";"360050273002";94;133;105;2;5;339
"641";"360050273003";63;14;108;1;9;195
"642";"360050273004";164;132;105;7;23;431
"643";"360050274011";2;2;5;8;2;19
"644";"360050274012";12;5;35;14;16;82
"645";"360050274013";14;3;57;16;127;217
"646";"360050274014";21;1;77;39;28;166
"647";"360050274021";4;4;27;7;12;54
"648";"360050274022";1;1;12;18;2;34
"649";"360050274023";23;13;65;14;11;126
"650";"360050276001";21;17;39;11;23;111
"651";"360050277001";57;45;31;1;7;141
"652";"360050277002";16;18;40;0;6;80
"653";"360050277003";49;16;58;10;5;138
"654";"360050277004";76;18;4;0;3;101
"655";"360050279001";26;70;31;1;4;132
"656";"360050279002";29;9;49;0;15;102
"657";"360050279003";49;5;72;5;59;190
"658";"360050279004";33;16;82;2;8;141
"659";"360050279005";10;2;18;0;0;30
"660";"360050279006";162;14;50;1;5;232
"661";"360050281001";19;6;60;1;9;95
"662";"360050281002";26;4;6;1;3;40
"663";"360050281003";0;2;9;2;0;13
"664";"360050283001";23;25;24;4;22;98
"665";"360050283002";44;12;6;0;15;77
"666";"360050284001";73;9;67;44;10;203
"667";"360050285001";105;19;50;4;11;189
"668";"360050285002";48;4;8;0;4;64
"669";"360050285003";17;55;6;0;8;86
"670";"360050285004";63;39;87;4;8;201
"671";"360050286001";7;1;56;15;9;88
"672";"360050286002";5;32;36;9;9;91
"673";"360050287001";37;10;147;7;10;211
"674";"360050287002";51;9;3;0;2;65
"675";"360050287003";50;61;11;0;3;125
"676";"360050288001";23;4;35;24;9;95
"677";"360050288002";2;2;23;14;5;46
"678";"360050288003";3;0;24;1;1;29
"679";"360050288004";0;0;25;10;12;47
"680";"360050289001";150;20;74;3;13;260
"681";"360050289002";12;0;0;0;3;15
"682";"360050289003";12;13;17;7;14;63
"683";"360050289004";38;9;17;0;4;68
"684";"360050293011";1;1;2;16;2;22
"685";"360050293012";39;1;7;1;3;51
"686";"360050293021";12;3;2;0;0;17
"687";"360050293022";2;2;11;1;2;18
"688";"360050293023";50;1;16;0;2;69
"689";"360050293024";36;4;63;5;10;118
"690";"360050295001";51;17;21;5;4;98
"691";"360050295002";97;59;18;0;4;178
"692";"360050295003";87;4;42;3;4;140
"693";"360050295004";36;7;78;0;13;134
"694";"360050296001";120;36;79;65;18;318
"695";"360050296002";6;0;5;8;13;32
"696";"360050297001";27;3;32;2;7;71
"697";"360050297002";27;4;19;3;3;56
"698";"360050297003";8;5;19;0;3;35
"699";"360050300001";67;12;48;13;21;161
"700";"360050300002";31;3;127;28;21;210
"701";"360050300003";10;36;59;6;16;127
"702";"360050300004";35;3;33;6;8;85
"703";"360050300005";12;0;28;5;5;50
"704";"360050300006";6;0;75;11;6;98
"705";"360050301001";6;0;26;1;3;36
"706";"360050301002";1;0;15;0;0;16
"707";"360050302001";2;0;1;1;0;4
"708";"360050302002";1;1;1;0;1;4
"709";"360050302003";4;4;98;2;7;115
"710";"360050302004";3;0;0;1;1;5
"711";"360050302005";28;4;7;0;2;41
"712";"360050302006";3;0;0;0;1;4
"713";"360050307011";5;10;21;14;2;52
"714";"360050307012";4;0;6;0;0;10
"715";"360050307013";6;0;47;0;1;54
"716";"360050307014";0;4;6;0;0;10
"717";"360050309001";1;2;0;0;1;4
"718";"360050309002";1;1;7;0;3;12
"719";"360050309003";9;1;12;0;0;22
"720";"360050309004";3;21;10;1;0;35
"721";"360050310001";5;17;25;27;10;84
"722";"360050310002";27;11;29;22;11;100
"723";"360050310003";6;4;49;29;13;101
"724";"360050312001";8;1;18;30;19;76
"725";"360050312002";2;2;46;22;13;85
"726";"360050314001";26;3;36;14;11;90
"727";"360050314002";5;0;24;10;10;49
"728";"360050316001";22;5;84;32;24;167
"729";"360050316002";4;1;16;8;6;35
"730";"360050318001";7;2;59;7;4;79
"731";"360050318002";8;2;36;30;11;87
"732";"360050323001";1;3;3;4;0;11
"733";"360050323002";5;13;5;13;0;36
"734";"360050323003";10;0;3;2;16;31
"735";"360050323004";24;3;45;18;2;92
"736";"360050324001";196;11;25;6;5;243
"737";"360050324002";22;18;48;3;10;101
"738";"360050326001";79;12;73;12;11;187
"739";"360050326002";27;1;21;26;15;90
"740";"360050326003";5;0;49;12;8;74
"741";"360050328001";109;31;28;6;5;179
"742";"360050328002";107;13;3;4;1;128
"743";"360050328003";56;6;37;2;3;104
"744";"360050328004";52;2;41;5;2;102
"745";"360050330001";18;3;42;8;13;84
"746";"360050330002";826;6;15;2;4;853
"747";"360050330003";18;5;11;7;17;58
"748";"360050330004";26;2;25;2;5;60
"749";"360050332011";26;8;10;2;1;47
"750";"360050332012";75;4;37;4;3;123
"751";"360050332013";88;7;39;6;6;146
"752";"360050332021";117;1;88;8;2;216
"753";"360050332022";49;38;31;2;4;124
"754";"360050332023";12;3;27;1;1;44
"755";"360050332024";9;0;50;2;3;64
"756";"360050334001";25;44;20;11;13;113
"757";"360050335001";0;0;0;4;2;6
"758";"360050335002";22;22;51;7;4;106
"759";"360050335003";31;104;29;1;2;167
"760";"360050336001";17;5;46;12;3;83
"761";"360050336002";206;52;3;4;8;273
"762";"360050336003";42;25;2;14;3;86
"763";"360050336004";29;5;2;1;4;41
"764";"360050336005";121;1;0;7;15;144
"765";"360050336006";35;7;18;4;3;67
"766";"360050337001";2;2;6;0;0;10
"767";"360050337002";10;1;52;40;8;111
"768";"360050337003";32;15;63;20;10;140
"769";"360050338001";21;7;15;5;2;50
"770";"360050338002";54;5;17;4;5;85
"771";"360050338003";34;5;116;6;17;178
"772";"360050338004";42;4;70;11;17;144
"773";"360050340001";36;4;67;9;4;120
"774";"360050340002";71;7;62;8;6;154
"775";"360050340003";76;23;9;6;7;121
"776";"360050340004";11;5;31;2;7;56
"777";"360050342001";12;1;36;10;3;62
"778";"360050342002";55;23;78;18;10;184
"779";"360050343001";3;2;40;19;2;66
"780";"360050343002";74;4;56;25;3;162
"781";"360050344001";7;3;27;4;6;47
"782";"360050344002";7;0;30;27;8;72
"783";"360050345001";37;4;120;27;6;194
"784";"360050345002";33;3;51;32;3;122
"785";"360050345003";65;1;15;2;4;87
"786";"360050348001";33;4;73;66;11;187
"787";"360050348002";157;43;7;4;12;223
"788";"360050348003";40;1;151;50;15;257
"789";"360050348004";21;4;76;21;7;129
"790";"360050350001";26;8;77;18;15;144
"791";"360050350002";18;8;18;26;12;82
"792";"360050351001";1;4;35;14;0;54
"793";"360050351002";140;4;41;32;8;225
"794";"360050351003";10;17;29;24;9;89
"795";"360050356001";6;5;27;11;6;55
"796";"360050356002";24;11;70;44;11;160
"797";"360050358001";16;12;37;24;4;93
"798";"360050358002";29;4;44;57;4;138
"799";"360050358003";17;3;25;21;11;77
"800";"360050358004";11;3;28;13;11;66
"801";"360050358005";7;2;36;15;1;61
"802";"360050358006";12;8;33;5;9;67
"803";"360050358007";29;12;50;6;4;101
"804";"360050359001";39;41;31;18;16;145
"805";"360050360001";10;2;35;14;11;72
"806";"360050360002";19;6;47;56;13;141
"807";"360050360003";8;0;29;25;7;69
"808";"360050361001";32;15;8;2;3;60
"809";"360050361002";55;7;40;2;7;111
"810";"360050361003";13;3;3;3;5;27
"811";"360050361004";93;0;0;0;2;95
"812";"360050361005";91;48;1;1;4;145
"813";"360050363001";60;9;23;5;5;102
"814";"360050363002";14;2;2;0;3;21
"815";"360050363003";35;19;32;1;39;126
"816";"360050363004";116;6;51;30;14;217
"817";"360050363005";126;22;7;1;11;167
"818";"360050363006";94;13;18;11;21;157
"819";"360050364001";3;7;61;13;4;88
"820";"360050364002";10;2;17;2;8;39
"821";"360050364003";20;5;37;7;2;71
"822";"360050365011";53;2;10;2;10;77
"823";"360050365012";20;5;31;2;5;63
"824";"360050365013";51;7;14;4;9;85
"825";"360050365021";51;59;30;2;6;148
"826";"360050365022";61;22;42;10;12;147
"827";"360050367001";34;5;17;16;8;80
"828";"360050367002";410;58;21;12;23;524
"829";"360050368001";23;4;44;10;10;91
"830";"360050368002";8;5;29;6;7;55
"831";"360050369011";46;40;10;6;26;128
"832";"360050369012";30;15;16;3;4;68
"833";"360050369021";83;3;1;2;4;93
"834";"360050369022";44;22;18;2;1;87
"835";"360050370001";12;6;30;16;6;70
"836";"360050370002";6;0;32;2;4;44
"837";"360050370003";12;1;14;1;16;44
"838";"360050371001";41;5;82;1;12;141
"839";"360050371002";54;12;20;4;41;131
"840";"360050371003";48;14;16;9;10;97
"841";"360050371004";44;4;35;4;9;96
"842";"360050372001";12;3;19;2;9;45
"843";"360050372002";39;26;82;15;10;172
"844";"360050373001";50;14;6;2;4;76
"845";"360050373002";44;62;62;10;14;192
"846";"360050373003";49;58;21;12;18;158
"847";"360050373004";199;36;16;3;14;268
"848";"360050374001";22;5;26;1;9;63
"849";"360050374002";66;18;110;8;28;230
"850";"360050374003";43;6;1;0;3;53
"851";"360050374004";6;0;0;0;5;11
"852";"360050375041";4;10;26;14;8;62
"853";"360050375042";52;34;24;39;8;157
"854";"360050375043";66;71;37;9;14;197
"855";"360050376001";138;6;20;4;5;173
"856";"360050376002";8;3;19;32;10;72
"857";"360050378001";67;11;49;8;32;167
"858";"360050378002";11;20;8;1;4;44
"859";"360050378003";27;10;24;15;15;91
"860";"360050379001";18;18;58;28;8;130
"861";"360050379002";15;2;5;1;1;24
"862";"360050379003";51;6;4;3;8;72
"863";"360050379004";29;10;26;2;3;70
"864";"360050379005";69;21;15;8;4;117
"865";"360050380001";54;2;13;5;1;75
"866";"360050380002";24;4;42;1;8;79
"867";"360050380003";39;5;55;26;15;140
"868";"360050380004";48;9;49;20;10;136
"869";"360050381001";44;4;3;2;3;56
"870";"360050381002";78;46;10;0;4;138
"871";"360050381003";48;22;11;0;2;83
"872";"360050381004";29;4;9;4;7;53
"873";"360050381005";10;11;50;1;6;78
"874";"360050381006";100;8;8;1;19;136
"875";"360050382001";40;1;85;13;19;158
"876";"360050382002";25;7;52;4;6;94
"877";"360050383011";22;20;48;1;8;99
"878";"360050383012";93;8;30;2;8;141
"879";"360050383013";49;38;19;0;13;119
"880";"360050383021";33;25;18;12;22;110
"881";"360050383022";118;73;30;3;7;231
"882";"360050383023";166;32;21;6;12;237
"883";"360050385001";46;15;23;6;20;110
"884";"360050385002";16;19;20;2;8;65
"885";"360050385003";18;33;21;6;15;93
"886";"360050385004";113;25;35;28;18;219
"887";"360050386001";17;2;92;32;15;158
"888";"360050386002";23;3;58;20;9;113
"889";"360050386003";23;34;1;0;6;64
"890";"360050386004";26;16;54;1;6;103
"891";"360050386005";25;3;32;11;6;77
"892";"360050386006";20;30;14;1;5;70
"893";"360050386007";8;2;1;3;5;19
"894";"360050386008";75;62;10;0;3;150
"895";"360050387001";73;11;14;0;90;188
"896";"360050387002";106;38;10;10;17;181
"897";"360050387003";21;29;9;5;8;72
"898";"360050388001";19;5;47;4;9;84
"899";"360050388002";20;1;99;5;9;134
"900";"360050389001";62;10;27;6;6;111
"901";"360050389002";21;10;5;2;10;48
"902";"360050389003";135;40;11;2;24;212
"903";"360050389004";23;24;17;0;5;69
"904";"360050389005";21;9;24;2;16;72
"905";"360050390001";20;2;59;3;5;89
"906";"360050390002";31;12;78;17;16;154
"907";"360050391001";201;26;26;1;8;262
"908";"360050391002";27;9;49;13;13;111
"909";"360050391003";30;29;100;6;5;170
"910";"360050391004";27;33;18;0;23;101
"911";"360050391005";15;1;2;2;16;36
"912";"360050391006";22;2;4;0;24;52
"913";"360050392001";15;7;38;2;6;68
"914";"360050392002";10;7;60;0;17;94
"915";"360050393001";85;21;24;3;6;139
"916";"360050393002";151;81;19;4;15;270
"917";"360050393003";31;6;0;6;2;45
"918";"360050393004";20;15;7;0;8;50
"919";"360050393005";4;21;9;3;3;40
"920";"360050393006";48;50;29;7;22;156
"921";"360050394001";76;7;21;0;7;111
"922";"360050394002";62;5;68;6;12;153
"923";"360050394003";7;5;18;1;3;34
"924";"360050394004";12;15;39;2;12;80
"925";"360050395001";21;40;90;53;15;219
"926";"360050395002";23;17;39;13;19;111
"927";"360050395003";21;7;70;32;20;150
"928";"360050395004";44;34;66;32;27;203
"929";"360050396001";121;10;61;4;9;205
"930";"360050396002";45;31;103;10;12;201
"931";"360050396003";38;5;75;4;30;152
"932";"360050396004";24;1;48;1;3;77
"933";"360050397001";38;14;28;5;27;112
"934";"360050397002";138;20;14;1;62;235
"935";"360050398001";41;4;86;8;15;154
"936";"360050398002";15;3;22;1;3;44
"937";"360050398003";17;0;22;6;10;55
"938";"360050399011";59;19;2;1;27;108
"939";"360050399012";21;15;5;0;6;47
"940";"360050399013";39;32;25;2;15;113
"941";"360050399014";20;12;1;0;3;36
"942";"360050399015";92;111;32;9;16;260
"943";"360050399021";54;50;24;7;22;157
"944";"360050399022";25;32;3;0;7;67
"945";"360050399023";73;64;18;2;10;167
"946";"360050399024";39;5;3;0;3;50
"947";"360050399025";90;6;13;2;3;114
"948";"360050401001";60;4;0;0;2;66
"949";"360050401002";205;47;25;0;13;290
"950";"360050401003";109;34;14;1;16;174
"951";"360050401004";37;2;1;0;7;47
"952";"360050401005";322;149;33;0;13;517
"953";"360050403021";460;29;3;4;8;504
"954";"360050403022";9;5;2;1;0;17
"955";"360050403023";14;7;6;1;1;29
"956";"360050403031";102;35;14;2;14;167
"957";"360050403032";140;27;124;2;15;308
"958";"360050403033";48;27;9;3;11;98
"959";"360050403041";53;119;15;2;12;201
"960";"360050403042";167;39;21;0;12;239
"961";"360050403043";113;23;8;0;9;153
"962";"360050404001";26;5;143;9;13;196
"963";"360050404002";4;0;37;1;9;51
"964";"360050404003";26;1;35;4;3;69
"965";"360050405011";136;88;21;5;17;267
"966";"360050405012";33;9;15;2;5;64
"967";"360050405013";20;6;22;4;7;59
"968";"360050405021";69;34;17;1;4;125
"969";"360050405022";23;29;35;0;5;92
"970";"360050405023";47;26;48;2;5;128
"971";"360050405024";9;5;9;0;2;25
"972";"360050405025";20;5;20;0;0;45
"973";"360050405026";23;4;49;8;10;94
"974";"360050406001";204;14;74;9;23;324
"975";"360050406002";64;25;54;0;8;151
"976";"360050406003";66;12;35;3;19;135
"977";"360050407011";27;55;6;2;8;98
"978";"360050407012";434;21;12;1;6;474
"979";"360050407013";105;33;9;1;4;152
"980";"360050407021";27;4;10;0;8;49
"981";"360050407022";89;138;45;14;8;294
"982";"360050407023";201;13;14;5;3;236
"983";"360050407024";58;10;49;1;6;124
"984";"360050407025";26;4;25;0;2;57
"985";"360050408001";43;7;19;0;4;73
"986";"360050408002";98;35;40;1;4;178
"987";"360050408003";76;14;13;1;2;106
"988";"360050408004";85;15;65;5;13;183
"989";"360050409001";19;29;140;20;61;269
"990";"360050409002";24;11;26;4;5;70
"991";"360050411001";92;6;44;0;3;145
"992";"360050411002";30;5;22;9;1;67
"993";"360050411003";43;16;35;16;10;120
"994";"360050413001";84;69;107;2;17;279
"995";"360050413002";29;31;14;2;4;80
"996";"360050413003";55;47;24;0;5;131
"997";"360050413004";22;3;5;3;3;36
"998";"360050413005";18;3;15;1;5;42
"999";"360050413006";42;9;43;0;3;97
"1000";"360050413007";103;8;43;0;10;164
"1001";"360050414001";34;5;52;60;8;159
"1002";"360050414002";23;15;82;26;9;155
"1003";"360050414003";51;2;80;38;7;178
"1004";"360050414004";96;34;59;33;13;235
"1005";"360050415001";77;14;90;6;14;201
"1006";"360050415002";45;6;19;0;0;70
"1007";"360050415003";24;1;31;1;6;63
"1008";"360050415004";10;6;14;0;5;35
"1009";"360050415005";28;10;23;2;2;65
"1010";"360050415006";112;16;27;0;7;162
"1011";"360050418001";20;5;37;41;4;107
"1012";"360050418002";30;11;34;36;2;113
"1013";"360050418003";22;1;41;20;4;88
"1014";"360050418004";9;3;18;40;8;78
"1015";"360050419001";40;3;64;1;6;114
"1016";"360050419002";15;6;5;1;8;35
"1017";"360050419003";55;5;7;2;5;74
"1018";"360050419004";44;7;30;1;14;96
"1019";"360050419005";16;2;4;1;3;26
"1020";"360050419006";40;13;8;0;6;67
"1021";"360050419007";44;14;28;0;6;92
"1022";"360050420001";28;7;16;10;5;66
"1023";"360050420002";136;7;40;2;7;192
"1024";"360050420003";83;9;31;2;7;132
"1025";"360050421001";5;6;15;1;1;28
"1026";"360050421002";147;41;2;0;25;215
"1027";"360050421003";20;1;4;5;9;39
"1028";"360050421004";222;33;16;7;5;283
"1029";"360050421005";36;20;3;0;3;62
"1030";"360050422001";33;7;179;24;9;252
"1031";"360050422002";14;6;63;12;6;101
"1032";"360050423001";47;8;22;0;4;81
"1033";"360050423002";61;12;61;13;5;152
"1034";"360050423003";30;22;69;3;7;131
"1035";"360050424001";10;0;53;7;7;77
"1036";"360050424002";36;2;78;5;9;130
"1037";"360050425001";26;5;9;1;7;48
"1038";"360050425002";141;44;53;2;21;261
"1039";"360050425003";101;107;144;1;11;364
"1040";"360050425004";73;1;48;4;4;130
"1041";"360050425005";34;29;26;8;18;115
"1042";"360050425006";14;4;15;2;6;41
"1043";"360050425007";107;57;46;4;25;239
"1044";"360050426001";45;13;132;40;13;243
"1045";"360050426002";67;5;78;26;8;184
"1046";"360050426003";8;1;71;14;2;96
"1047";"360050426004";6;5;28;12;11;62
"1048";"360050426005";9;0;32;12;5;58
"1049";"360050426006";10;0;65;9;9;93
"1050";"360050428001";13;31;60;16;9;129
"1051";"360050428002";34;1;69;25;12;141
"1052";"360050429011";171;16;138;11;15;351
"1053";"360050429012";28;12;38;0;7;85
"1054";"360050429013";17;32;38;2;3;92
"1055";"360050429021";149;75;89;8;30;351
"1056";"360050429022";27;10;78;2;7;124
"1057";"360050429023";106;3;27;5;5;146
"1058";"360050430001";5;2;65;35;8;115
"1059";"360050430002";16;2;25;21;2;66
"1060";"360050430003";28;3;86;17;6;140
"1061";"360050431001";21;11;3;0;0;35
"1062";"360050431002";31;5;7;0;20;63
"1063";"360050431003";14;1;5;0;1;21
"1064";"360050431004";35;27;28;1;10;101
"1065";"360050431005";486;48;28;5;11;578
"1066";"360050431006";125;43;21;5;11;205
"1067";"360050431007";149;33;13;1;9;205
"1068";"360050431008";47;37;17;2;2;105
"1069";"360050434001";23;22;48;33;21;147
"1070";"360050434002";52;13;24;10;8;107
"1071";"360050434003";16;1;56;9;15;97
"1072";"360050434004";166;3;56;10;6;241
"1073";"360050435001";151;100;136;38;42;467
"1074";"360050436001";49;6;31;42;27;155
"1075";"360050436002";28;23;81;13;2;147
"1076";"360050442001";206;7;5;3;5;226
"1077";"360050442002";8;2;30;14;9;63
"1078";"360050442003";1;0;21;44;2;68
"1079";"360050442004";37;3;71;64;15;190
"1080";"360050442005";11;6;32;28;5;82
"1081";"360050444001";24;5;42;13;12;96
"1082";"360050444002";11;4;16;2;7;40
"1083";"360050444003";31;9;41;16;5;102
"1084";"360050444004";13;4;83;34;5;139
"1085";"360050448001";24;2;33;26;4;89
"1086";"360050448002";6;0;32;9;5;52
"1087";"360050449011";13;2;47;18;4;84
"1088";"360050449012";8;6;60;16;4;94
"1089";"360050449021";23;3;68;6;7;107
"1090";"360050449022";22;4;61;29;12;128
"1091";"360050451011";16;7;117;7;13;160
"1092";"360050451012";42;4;98;28;10;182
"1093";"360050451021";27;3;72;15;6;123
"1094";"360050451022";35;1;37;12;10;95
"1095";"360050456001";9;3;44;11;6;73
"1096";"360050456002";20;5;105;61;11;202
"1097";"360050456003";20;1;9;10;5;45
"1098";"360050458001";17;10;7;2;1;37
"1099";"360050458002";244;3;1;0;6;254
"1100";"360050458003";6;0;1;0;2;9
"1101";"360050458004";302;12;10;3;1;328
"1102";"360050460001";54;9;52;17;8;140
"1103";"360050460002";7;1;34;17;3;62
"1104";"360050462011";8;8;59;11;1;87
"1105";"360050462012";0;0;1;1;1;3
"1106";"360050462013";10;2;20;2;2;36
"1107";"360050462014";6;2;54;2;2;66
"1108";"360050462015";13;1;4;0;0;18
"1109";"360050462016";20;2;1;0;2;25
"1110";"360050462017";3;1;16;0;0;20
"1111";"360050462018";2;4;25;4;6;41
"1112";"360050462019";8;0;8;1;1;18
"1113";"360050462021";35;11;67;94;14;221
"1114";"360050462022";16;11;90;54;11;182
"1115";"360050462023";33;4;97;51;7;192
"1116";"360050462024";10;17;19;22;3;71
"1117";"360050462025";7;8;47;35;8;105
"1118";"360050462026";4;0;10;17;1;32
"1119";"360050484001";12;1;36;9;3;61
"1120";"360050484002";16;30;139;175;37;397
"1121";"360050484003";2;2;17;29;2;52
"1122";"360050484004";21;4;61;19;6;111
"1123";"360050504001";1;5;2;3;3;14
"1124";"360050516001";13;28;94;17;9;161
"1125";"360050516002";9;16;47;21;14;107
"1126";"360050516003";9;24;59;26;17;135
"1127";"360050516004";56;43;81;12;10;202
"1128";"360470001001";4;52;74;1;5;136
"1129";"360470001002";6;11;6;0;0;23
"1130";"360470001003";28;25;22;1;10;86
"1131";"360470001004";1;18;6;0;3;28
"1132";"360470002001";14;21;122;28;50;235
"1133";"360470003011";4;5;6;0;0;15
"1134";"360470003012";9;18;15;1;0;43
"1135";"360470003013";3;12;7;0;3;25
"1136";"360470003014";4;8;26;0;9;47
"1137";"360470003015";8;11;8;0;2;29
"1138";"360470005011";38;10;27;2;10;87
"1139";"360470005012";8;21;9;1;1;40
"1140";"360470005013";2;4;12;0;5;23
"1141";"360470005021";13;5;7;5;7;37
"1142";"360470005022";15;46;15;0;8;84
"1143";"360470007001";13;17;67;7;11;115
"1144";"360470007002";12;3;24;0;4;43
"1145";"360470007003";19;8;34;5;8;74
"1146";"360470009001";18;71;75;7;30;201
"1147";"360470009002";5;19;13;4;11;52
"1148";"360470011001";6;32;140;0;37;215
"1149";"360470013001";6;69;128;4;22;229
"1150";"360470013002";1;1;4;0;0;6
"1151";"360470015001";44;135;69;11;8;267
"1152";"360470015002";152;14;8;3;8;185
"1153";"360470015003";28;48;120;5;21;222
"1154";"360470018001";21;16;191;56;52;336
"1155";"360470020001";1;8;68;7;21;105
"1156";"360470020002";9;17;96;5;12;139
"1157";"360470021001";12;66;93;0;10;181
"1158";"360470021002";13;21;50;7;24;115
"1159";"360470021003";50;164;92;3;16;325
"1160";"360470022001";54;18;148;15;42;277
"1161";"360470022002";20;9;61;11;28;129
"1162";"360470022003";13;11;172;71;19;286
"1163";"360470023001";52;19;4;4;1;80
"1164";"360470023002";85;5;1;0;3;94
"1165";"360470023003";460;8;22;4;3;497
"1166";"360470029011";630;7;16;1;1;655
"1167";"360470029012";116;9;10;10;12;157
"1168";"360470030001";7;6;41;32;10;96
"1169";"360470030002";20;0;29;2;5;56
"1170";"360470031001";17;19;35;2;5;78
"1171";"360470031002";1;7;7;1;3;19
"1172";"360470031003";1;2;10;2;3;18
"1173";"360470033001";2;13;19;4;5;43
"1174";"360470033002";80;48;73;3;38;242
"1175";"360470034001";14;17;66;16;14;127
"1176";"360470034002";21;7;229;3;9;269
"1177";"360470034003";4;3;115;6;10;138
"1178";"360470035001";7;56;26;2;35;126
"1179";"360470035002";13;28;18;0;10;69
"1180";"360470036001";11;6;104;8;6;135
"1181";"360470036002";59;9;161;3;3;235
"1182";"360470036003";11;1;173;33;8;226
"1183";"360470037001";22;124;167;3;43;359
"1184";"360470038001";9;5;290;8;10;322
"1185";"360470039001";15;30;118;4;11;178
"1186";"360470039002";77;10;40;3;25;155
"1187";"360470039003";9;20;34;8;42;113
"1188";"360470041001";25;28;342;12;14;421
"1189";"360470041002";3;17;29;2;6;57
"1190";"360470041003";11;8;37;3;5;64
"1191";"360470043001";0;0;3;0;0;3
"1192";"360470043002";6;6;73;8;12;105
"1193";"360470043003";10;20;38;8;4;80
"1194";"360470043004";18;48;64;8;23;161
"1195";"360470044001";6;7;95;18;13;139
"1196";"360470044002";52;1;74;11;5;143
"1197";"360470045001";9;21;42;2;9;83
"1198";"360470045002";2;11;25;2;1;41
"1199";"360470045003";9;5;10;2;4;30
"1200";"360470045004";4;5;36;1;3;49
"1201";"360470046001";9;5;78;29;13;134
"1202";"360470047001";26;46;40;16;19;147
"1203";"360470049001";4;19;52;1;10;86
"1204";"360470049002";4;2;5;2;1;14
"1205";"360470049003";7;2;17;2;0;28
"1206";"360470050001";9;3;35;0;5;52
"1207";"360470050002";13;1;33;17;4;68
"1208";"360470050003";11;6;76;7;12;112
"1209";"360470051001";1;33;33;3;3;73
"1210";"360470051002";8;5;34;4;6;57
"1211";"360470051003";7;12;51;5;11;86
"1212";"360470052011";12;7;43;3;8;73
"1213";"360470052021";7;3;20;9;1;40
"1214";"360470052022";17;3;57;3;9;89
"1215";"360470053001";13;50;92;36;48;239
"1216";"360470053002";23;18;48;8;13;110
"1217";"360470053003";14;15;51;16;9;105
"1218";"360470053004";11;9;38;7;17;82
"1219";"360470054001";36;7;25;6;5;79
"1220";"360470054002";17;12;32;5;6;72
"1221";"360470054003";25;2;44;3;28;102
"1222";"360470056011";12;1;52;23;10;98
"1223";"360470056012";60;5;90;7;5;167
"1224";"360470056021";7;50;104;14;16;191
"1225";"360470058001";30;28;38;4;10;110
"1226";"360470058002";35;25;97;7;26;190
"1227";"360470058003";3;0;25;3;3;34
"1228";"360470059001";75;65;48;12;25;225
"1229";"360470059002";9;14;126;180;26;355
"1230";"360470060001";25;12;41;4;18;100
"1231";"360470060002";15;13;75;16;12;131
"1232";"360470060003";2;10;24;0;17;53
"1233";"360470062001";16;24;35;4;9;88
"1234";"360470062002";20;99;61;0;9;189
"1235";"360470062003";30;49;26;0;1;106
"1236";"360470063001";4;1;16;1;3;25
"1237";"360470063002";5;7;33;7;11;63
"1238";"360470064001";25;18;50;4;19;116
"1239";"360470064002";34;7;75;5;78;199
"1240";"360470064003";22;58;52;8;10;150
"1241";"360470065001";3;6;11;4;4;28
"1242";"360470065002";9;17;7;0;4;37
"1243";"360470065003";6;1;24;3;1;35
"1244";"360470065004";4;3;9;1;6;23
"1245";"360470065005";2;0;9;2;7;20
"1246";"360470065006";13;15;37;4;7;76
"1247";"360470065007";2;2;10;0;17;31
"1248";"360470066001";5;44;89;14;12;164
"1249";"360470066002";28;62;81;6;9;186
"1250";"360470066003";17;16;125;13;12;183
"1251";"360470067001";3;1;9;3;3;19
"1252";"360470067002";2;3;2;0;1;8
"1253";"360470067003";5;6;22;3;2;38
"1254";"360470067004";28;19;34;3;2;86
"1255";"360470067005";3;2;14;3;0;22
"1256";"360470068001";44;4;25;3;19;95
"1257";"360470068002";165;3;44;6;44;262
"1258";"360470068003";0;10;141;2;5;158
"1259";"360470068004";44;30;133;5;14;226
"1260";"360470069001";4;8;9;1;6;28
"1261";"360470069002";7;13;26;1;14;61
"1262";"360470069003";4;27;12;2;13;58
"1263";"360470069004";21;2;19;6;9;57
"1264";"360470070001";1;5;110;10;8;134
"1265";"360470070002";12;0;47;6;4;69
"1266";"360470071001";2;10;8;1;3;24
"1267";"360470071002";8;16;25;17;8;74
"1268";"360470071003";47;10;3;0;1;61
"1269";"360470071004";384;42;3;0;1;430
"1270";"360470072001";17;14;63;23;43;160
"1271";"360470074001";38;12;102;4;20;176
"1272";"360470074002";13;12;14;1;43;83
"1273";"360470074003";29;21;31;3;19;103
"1274";"360470074004";9;4;11;3;7;34
"1275";"360470075001";2;17;15;8;7;49
"1276";"360470075002";3;52;10;8;5;78
"1277";"360470075003";8;14;36;7;8;73
"1278";"360470075004";16;10;8;0;9;43
"1279";"360470075005";2;14;26;14;3;59
"1280";"360470076001";54;13;35;10;31;143
"1281";"360470076002";9;13;10;2;24;58
"1282";"360470076003";38;12;81;2;21;154
"1283";"360470077001";4;6;60;0;8;78
"1284";"360470077002";14;16;84;2;7;123
"1285";"360470077003";24;84;35;11;16;170
"1286";"360470077004";25;35;7;7;14;88
"1287";"360470078001";31;12;23;6;21;93
"1288";"360470078002";12;14;6;3;16;51
"1289";"360470078003";20;44;54;3;14;135
"1290";"360470078004";19;16;7;4;14;60
"1291";"360470080001";59;42;16;4;26;147
"1292";"360470080002";92;83;27;4;26;232
"1293";"360470080003";6;1;35;2;15;59
"1294";"360470082001";24;13;13;14;20;84
"1295";"360470082002";22;13;25;5;12;77
"1296";"360470082003";26;14;23;3;11;77
"1297";"360470084001";13;28;38;8;17;104
"1298";"360470084002";62;19;27;4;22;134
"1299";"360470084003";3;11;30;3;29;76
"1300";"360470085001";72;44;9;7;6;138
"1301";"360470085002";69;9;8;0;4;90
"1302";"360470085003";37;24;5;2;4;72
"1303";"360470086001";16;684;53;2;6;761
"1304";"360470088001";24;53;34;3;27;141
"1305";"360470088002";30;30;31;10;8;109
"1306";"360470090001";20;8;63;13;30;134
"1307";"360470090002";33;21;111;4;25;194
"1308";"360470092001";305;24;24;2;13;368
"1309";"360470092002";82;10;9;5;17;123
"1310";"360470092003";45;14;18;3;20;100
"1311";"360470094001";39;12;55;4;18;128
"1312";"360470094002";29;14;45;4;22;114
"1313";"360470094003";29;86;34;0;33;182
"1314";"360470096001";25;17;32;2;22;98
"1315";"360470096002";26;18;45;4;25;118
"1316";"360470096003";21;5;44;8;25;103
"1317";"360470096004";39;49;34;1;28;151
"1318";"360470098001";18;20;53;1;32;124
"1319";"360470098002";37;16;63;3;34;153
"1320";"360470098003";6;13;28;1;23;71
"1321";"360470098004";32;34;42;5;28;141
"1322";"360470100001";3;2;18;2;15;40
"1323";"360470100002";32;3;23;2;20;80
"1324";"360470100003";8;21;10;4;32;75
"1325";"360470100004";49;62;15;0;18;144
"1326";"360470101001";36;65;56;14;25;196
"1327";"360470101002";20;11;85;24;28;168
"1328";"360470101003";28;16;60;22;27;153
"1329";"360470102001";11;23;58;3;51;146
"1330";"360470102002";8;13;19;1;17;58
"1331";"360470102003";31;15;38;4;30;118
"1332";"360470104001";8;4;89;1;49;151
"1333";"360470104002";35;15;30;3;43;126
"1334";"360470104003";23;29;73;1;45;171
"1335";"360470106001";7;2;99;1;62;171
"1336";"360470106002";14;0;32;0;39;85
"1337";"360470106003";35;0;28;3;38;104
"1338";"360470108001";10;10;53;9;35;117
"1339";"360470108002";15;3;44;5;17;84
"1340";"360470108003";1;5;78;1;47;132
"1341";"360470110001";22;24;160;14;32;252
"1342";"360470110002";31;5;255;14;30;335
"1343";"360470112001";30;29;92;8;12;171
"1344";"360470112002";17;4;13;8;6;48
"1345";"360470112003";6;0;45;3;7;61
"1346";"360470112004";24;46;28;5;13;116
"1347";"360470114001";2;5;20;3;6;36
"1348";"360470114002";21;1;134;8;10;174
"1349";"360470114003";33;7;34;8;19;101
"1350";"360470116001";7;2;88;2;12;111
"1351";"360470116002";26;4;41;0;21;92
"1352";"360470116003";3;3;28;1;14;49
"1353";"360470117001";16;11;63;19;19;128
"1354";"360470117002";8;12;51;9;21;101
"1355";"360470117003";1;31;89;13;23;157
"1356";"360470118001";29;40;55;3;30;157
"1357";"360470118002";7;5;100;3;23;138
"1358";"360470119001";5;41;139;6;39;230
"1359";"360470119002";28;897;137;17;62;1141
"1360";"360470119003";12;23;127;4;27;193
"1361";"360470120001";28;13;158;24;42;265
"1362";"360470121001";63;16;61;25;23;188
"1363";"360470121002";13;19;71;14;28;145
"1364";"360470122001";36;30;26;1;48;141
"1365";"360470122002";34;24;36;1;33;128
"1366";"360470122003";40;27;118;0;32;217
"1367";"360470126001";24;17;53;7;20;121
"1368";"360470126002";3;8;39;4;10;64
"1369";"360470126003";3;2;111;3;7;126
"1370";"360470127001";48;48;61;4;22;183
"1371";"360470127002";83;61;53;43;16;256
"1372";"360470127003";69;21;5;0;2;97
"1373";"360470128011";11;33;90;6;14;154
"1374";"360470129011";15;24;85;5;27;156
"1375";"360470129012";32;83;81;11;20;227
"1376";"360470129013";14;3;48;2;9;76
"1377";"360470129021";9;35;24;0;15;83
"1378";"360470129022";29;411;145;6;10;601
"1379";"360470129023";13;17;30;1;9;70
"1380";"360470130001";2;9;29;4;9;53
"1381";"360470130002";20;5;61;4;9;99
"1382";"360470130003";7;7;126;4;22;166
"1383";"360470130004";10;16;47;8;20;101
"1384";"360470131001";16;23;20;0;2;61
"1385";"360470131002";24;11;15;1;12;63
"1386";"360470131003";9;12;20;2;4;47
"1387";"360470131004";36;38;19;1;14;108
"1388";"360470132001";6;1;14;1;5;27
"1389";"360470132002";7;4;72;18;14;115
"1390";"360470133001";3;14;26;13;7;63
"1391";"360470133002";10;15;23;3;6;57
"1392";"360470133003";12;11;44;4;2;73
"1393";"360470133004";22;7;23;1;7;60
"1394";"360470134001";7;9;604;20;33;673
"1395";"360470134002";33;2;34;15;25;109
"1396";"360470134003";109;41;170;12;20;352
"1397";"360470135001";15;10;8;2;6;41
"1398";"360470135002";17;24;48;8;28;125
"1399";"360470135003";12;31;81;6;11;141
"1400";"360470136001";10;8;93;5;17;133
"1401";"360470136002";16;3;37;0;12;68
"1402";"360470136003";19;12;56;9;25;121
"1403";"360470136004";6;11;59;7;13;96
"1404";"360470137001";10;63;26;6;8;113
"1405";"360470137002";8;15;20;4;13;60
"1406";"360470137003";24;32;91;23;33;203
"1407";"360470138001";17;30;49;2;23;121
"1408";"360470138002";22;6;24;2;13;67
"1409";"360470138003";7;8;30;3;8;56
"1410";"360470139001";28;17;19;2;12;78
"1411";"360470139002";60;73;22;2;17;174
"1412";"360470139003";9;4;7;4;9;33
"1413";"360470139004";9;5;17;11;26;68
"1414";"360470140001";11;2;82;2;14;111
"1415";"360470140002";5;4;81;12;11;113
"1416";"360470141001";19;10;28;4;15;76
"1417";"360470141002";4;8;44;5;29;90
"1418";"360470141003";54;11;87;0;13;165
"1419";"360470142001";114;15;44;4;31;208
"1420";"360470142002";42;16;22;0;21;101
"1421";"360470142003";80;25;42;2;14;163
"1422";"360470143001";56;52;64;8;57;237
"1423";"360470143002";34;27;63;5;38;167
"1424";"360470143003";25;17;29;4;18;93
"1425";"360470145001";35;75;107;8;19;244
"1426";"360470145002";20;5;35;12;28;100
"1427";"360470145003";36;12;49;7;14;118
"1428";"360470145004";23;6;33;10;15;87
"1429";"360470147001";12;28;17;3;8;68
"1430";"360470147002";29;16;52;5;6;108
"1431";"360470148001";20;1;34;3;11;69
"1432";"360470148002";2;4;40;4;10;60
"1433";"360470149001";19;3;26;3;4;55
"1434";"360470149002";7;7;38;2;5;59
"1435";"360470149003";3;4;19;6;6;38
"1436";"360470149004";9;18;33;2;12;74
"1437";"360470149005";2;6;23;0;14;45
"1438";"360470150001";2;0;16;1;5;24
"1439";"360470150002";3;5;45;10;5;68
"1440";"360470151001";9;5;18;0;39;71
"1441";"360470151002";6;12;7;2;2;29
"1442";"360470151003";34;5;21;10;23;93
"1443";"360470151004";3;6;6;2;31;48
"1444";"360470152001";0;0;36;13;8;57
"1445";"360470152002";1;1;15;8;1;26
"1446";"360470152003";7;5;88;22;9;131
"1447";"360470153001";6;5;20;0;7;38
"1448";"360470153002";4;5;34;7;19;69
"1449";"360470153003";4;20;12;3;16;55
"1450";"360470153004";4;0;18;0;20;42
"1451";"360470154001";15;19;24;2;9;69
"1452";"360470155001";29;20;8;2;3;62
"1453";"360470155002";13;1;8;3;11;36
"1454";"360470155003";9;4;46;1;2;62
"1455";"360470155004";3;18;16;3;1;41
"1456";"360470157001";4;8;51;4;5;72
"1457";"360470157002";5;9;9;4;7;34
"1458";"360470157003";11;5;26;10;11;63
"1459";"360470157004";23;7;8;0;3;41
"1460";"360470159001";5;19;55;9;27;115
"1461";"360470159002";11;5;30;1;10;57
"1462";"360470159003";20;46;11;2;5;84
"1463";"360470159004";23;9;23;6;3;64
"1464";"360470159005";15;12;22;4;6;59
"1465";"360470160001";6;0;34;8;8;56
"1466";"360470160002";11;38;29;0;7;85
"1467";"360470160003";20;3;46;6;16;91
"1468";"360470160004";49;79;71;9;30;238
"1469";"360470161001";31;40;148;12;6;237
"1470";"360470161002";15;17;29;3;1;65
"1471";"360470161003";25;147;115;14;30;331
"1472";"360470162001";8;1;38;3;6;56
"1473";"360470162002";3;4;95;9;6;117
"1474";"360470163001";8;10;99;1;5;123
"1475";"360470163002";11;14;28;4;8;65
"1476";"360470163003";64;10;31;3;4;112
"1477";"360470164001";2;0;2;3;3;10
"1478";"360470165001";8;9;25;3;6;51
"1479";"360470165002";10;3;22;4;1;40
"1480";"360470165003";28;7;69;4;8;116
"1481";"360470165004";3;5;12;1;2;23
"1482";"360470166001";8;7;41;7;8;71
"1483";"360470166002";14;8;28;24;28;102
"1484";"360470167001";7;1;40;2;6;56
"1485";"360470167002";0;3;22;7;2;34
"1486";"360470167003";11;12;16;4;9;52
"1487";"360470167004";16;9;59;2;12;98
"1488";"360470168001";24;6;324;9;12;375
"1489";"360470169001";0;9;33;2;11;55
"1490";"360470169002";45;20;3;1;9;78
"1491";"360470169003";11;24;5;2;14;56
"1492";"360470169004";3;8;19;3;15;48
"1493";"360470169005";7;5;23;3;1;39
"1494";"360470170001";7;4;20;5;5;41
"1495";"360470170002";11;17;144;9;21;202
"1496";"360470170003";7;6;105;13;15;146
"1497";"360470171001";2;1;33;8;6;50
"1498";"360470171002";1;2;7;3;3;16
"1499";"360470171003";2;5;22;0;4;33
"1500";"360470171004";24;1;22;2;2;51
"1501";"360470172001";9;12;64;17;22;124
"1502";"360470172002";4;8;75;2;10;99
"1503";"360470174001";3;11;121;10;12;157
"1504";"360470174002";4;2;61;2;2;71
"1505";"360470175001";9;15;33;10;3;70
"1506";"360470176001";1;1;114;24;15;155
"1507";"360470176002";12;2;108;4;9;135
"1508";"360470177001";45;137;128;31;66;407
"1509";"360470178001";11;6;31;17;20;85
"1510";"360470178002";21;6;109;8;25;169
"1511";"360470179001";11;4;7;0;1;23
"1512";"360470179002";126;49;101;5;8;289
"1513";"360470179003";8;23;24;0;6;61
"1514";"360470180001";6;1;62;20;32;121
"1515";"360470180002";20;8;77;8;9;122
"1516";"360470181001";13;29;8;3;9;62
"1517";"360470181002";1;5;16;1;3;26
"1518";"360470181003";15;43;35;4;15;112
"1519";"360470181004";16;19;21;13;6;75
"1520";"360470182001";5;2;25;4;13;49
"1521";"360470182002";11;4;63;22;27;127
"1522";"360470183001";13;36;22;1;12;84
"1523";"360470183002";146;342;20;7;12;527
"1524";"360470183003";12;10;42;3;6;73
"1525";"360470184001";3;3;103;6;9;124
"1526";"360470184002";14;4;70;5;32;125
"1527";"360470185011";5;5;13;2;7;32
"1528";"360470185012";30;5;59;2;2;98
"1529";"360470185013";30;5;38;0;4;77
"1530";"360470185014";13;6;4;1;3;27
"1531";"360470186001";18;0;54;2;13;87
"1532";"360470186002";12;3;27;3;10;55
"1533";"360470187001";34;31;34;8;15;122
"1534";"360470188001";9;2;121;10;13;155
"1535";"360470188002";17;2;165;4;19;207
"1536";"360470190001";12;3;145;5;14;179
"1537";"360470190002";29;2;92;8;26;157
"1538";"360470190003";9;5;110;9;16;149
"1539";"360470191001";85;79;96;4;45;309
"1540";"360470191002";9;11;22;3;11;56
"1541";"360470191003";20;101;35;5;29;190
"1542";"360470192001";5;5;65;15;23;113
"1543";"360470192002";12;70;96;22;91;291
"1544";"360470193001";25;43;33;4;10;115
"1545";"360470193002";48;14;23;0;2;87
"1546";"360470193003";2;5;4;1;3;15
"1547";"360470193004";14;20;5;1;24;64
"1548";"360470194001";15;14;59;19;33;140
"1549";"360470194002";82;2;63;9;12;168
"1550";"360470194003";5;2;84;69;19;179
"1551";"360470195001";31;24;33;5;11;104
"1552";"360470195002";47;20;28;2;6;103
"1553";"360470195003";10;16;28;5;2;61
"1554";"360470195004";0;7;21;6;6;40
"1555";"360470196001";22;1;64;7;22;116
"1556";"360470196002";4;0;67;1;26;98
"1557";"360470196003";7;6;61;2;12;88
"1558";"360470197001";3;1;56;0;3;63
"1559";"360470197002";29;12;26;1;7;75
"1560";"360470197003";7;16;34;1;14;72
"1561";"360470197004";8;25;14;1;6;54
"1562";"360470198001";1;2;39;10;15;67
"1563";"360470198002";5;3;50;7;21;86
"1564";"360470199001";11;52;25;0;4;92
"1565";"360470199002";102;58;26;0;9;195
"1566";"360470199003";25;178;29;7;22;261
"1567";"360470199004";21;2;21;0;6;50
"1568";"360470200001";5;3;43;5;20;76
"1569";"360470200002";4;4;122;1;17;148
"1570";"360470201001";16;11;8;2;6;43
"1571";"360470201002";23;42;19;4;39;127
"1572";"360470201003";31;31;39;3;12;116
"1573";"360470201004";72;13;20;2;1;108
"1574";"360470202001";7;1;58;4;20;90
"1575";"360470202002";3;3;75;6;17;104
"1576";"360470203001";34;214;179;20;30;477
"1577";"360470203002";6;14;37;14;13;84
"1578";"360470204001";7;7;118;8;15;155
"1579";"360470204002";0;1;87;2;15;105
"1580";"360470205001";32;41;146;8;18;245
"1581";"360470205002";48;107;158;14;7;334
"1582";"360470205003";4;13;22;17;4;60
"1583";"360470206001";10;1;55;4;14;84
"1584";"360470206002";5;1;77;3;56;142
"1585";"360470207001";75;41;52;11;13;192
"1586";"360470207002";32;88;51;0;15;186
"1587";"360470207003";2;2;27;0;4;35
"1588";"360470208001";0;2;134;0;12;148
"1589";"360470208002";7;1;73;2;40;123
"1590";"360470208003";5;1;132;0;22;160
"1591";"360470210001";17;4;164;15;20;220
"1592";"360470210002";4;3;66;5;8;86
"1593";"360470210003";5;0;25;2;10;42
"1594";"360470211001";6;20;20;4;3;53
"1595";"360470211002";32;54;436;39;31;592
"1596";"360470212001";24;9;62;22;19;136
"1597";"360470212002";8;8;40;3;10;69
"1598";"360470212003";8;0;92;2;12;114
"1599";"360470213001";49;67;7;2;9;134
"1600";"360470213002";53;45;8;0;6;112
"1601";"360470213003";55;6;20;8;2;91
"1602";"360470214001";2;6;54;23;10;95
"1603";"360470214002";13;20;55;3;25;116
"1604";"360470215001";35;83;55;6;10;189
"1605";"360470215002";35;66;12;1;12;126
"1606";"360470215003";42;20;11;2;12;87
"1607";"360470215004";22;59;39;2;16;138
"1608";"360470216001";3;0;42;6;2;53
"1609";"360470216002";0;3;48;2;4;57
"1610";"360470216003";10;5;84;4;15;118
"1611";"360470217001";114;46;17;5;11;193
"1612";"360470217002";108;214;35;0;14;371
"1613";"360470218001";14;4;29;4;27;78
"1614";"360470218002";1;0;15;3;1;20
"1615";"360470218003";4;2;45;11;10;72
"1616";"360470219001";45;27;6;3;7;88
"1617";"360470219002";14;4;22;2;8;50
"1618";"360470219003";28;18;33;4;22;105
"1619";"360470220001";2;1;7;1;2;13
"1620";"360470220002";15;3;36;4;12;70
"1621";"360470220003";11;0;13;0;4;28
"1622";"360470220004";2;4;45;0;10;61
"1623";"360470221001";20;18;43;31;34;146
"1624";"360470221002";140;134;64;5;31;374
"1625";"360470221003";24;25;23;3;8;83
"1626";"360470222001";3;1;15;2;5;26
"1627";"360470222002";3;4;18;3;8;36
"1628";"360470222003";9;4;38;7;15;73
"1629";"360470224001";3;1;27;4;1;36
"1630";"360470224002";12;0;32;2;2;48
"1631";"360470224003";16;3;67;6;5;97
"1632";"360470224004";7;14;212;6;12;251
"1633";"360470226001";11;9;81;35;20;156
"1634";"360470226002";37;24;83;9;17;170
"1635";"360470227001";31;51;24;7;26;139
"1636";"360470227002";33;180;56;18;27;314
"1637";"360470227003";46;103;18;8;21;196
"1638";"360470227004";59;69;49;6;20;203
"1639";"360470228001";17;24;98;5;9;153
"1640";"360470228002";6;16;81;12;2;117
"1641";"360470228003";1;5;38;8;2;54
"1642";"360470229001";97;29;16;1;19;162
"1643";"360470229002";60;9;17;4;23;113
"1644";"360470229003";10;7;29;3;10;59
"1645";"360470229004";71;31;21;9;37;169
"1646";"360470230001";0;2;20;5;1;28
"1647";"360470230002";0;5;8;1;1;15
"1648";"360470230003";11;8;39;45;6;109
"1649";"360470231001";76;85;12;0;12;185
"1650";"360470231002";75;34;79;9;11;208
"1651";"360470231003";83;45;15;0;19;162
"1652";"360470232001";0;0;27;1;4;32
"1653";"360470232002";9;0;19;1;5;34
"1654";"360470232003";1;1;18;0;3;23
"1655";"360470232004";1;4;8;3;2;18
"1656";"360470232005";6;4;53;0;4;67
"1657";"360470233001";42;62;26;2;19;151
"1658";"360470233002";451;30;9;0;8;498
"1659";"360470233003";63;44;73;12;46;238
"1660";"360470234001";7;4;21;2;3;37
"1661";"360470234002";7;1;10;1;2;21
"1662";"360470234003";31;6;40;2;1;80
"1663";"360470235001";66;223;192;7;34;522
"1664";"360470235002";16;8;42;43;15;124
"1665";"360470236001";6;1;22;2;3;34
"1666";"360470236002";4;8;14;4;2;32
"1667";"360470236003";0;8;21;0;0;29
"1668";"360470236004";2;10;70;0;1;83
"1669";"360470238001";8;0;33;3;3;47
"1670";"360470238002";7;6;42;5;4;64
"1671";"360470238003";2;4;13;6;5;30
"1672";"360470240001";3;3;25;2;3;36
"1673";"360470240002";3;4;45;11;24;87
"1674";"360470240003";2;2;15;2;6;27
"1675";"360470241001";80;188;363;19;62;712
"1676";"360470241002";61;39;24;6;9;139
"1677";"360470242001";0;1;74;8;2;85
"1678";"360470242002";1;1;32;4;4;42
"1679";"360470243001";78;33;22;3;28;164
"1680";"360470243002";165;51;29;24;11;280
"1681";"360470243003";50;39;34;10;22;155
"1682";"360470244001";11;13;66;3;12;105
"1683";"360470244002";4;6;80;5;10;105
"1684";"360470244003";2;2;68;10;12;94
"1685";"360470245001";34;16;60;29;9;148
"1686";"360470245002";115;22;20;6;13;176
"1687";"360470245003";22;35;9;2;10;78
"1688";"360470245004";28;20;12;0;18;78
"1689";"360470246001";1;1;44;1;6;53
"1690";"360470246002";3;1;77;12;11;104
"1691";"360470246003";9;26;58;7;4;104
"1692";"360470247001";38;55;23;8;27;151
"1693";"360470247002";65;41;84;20;51;261
"1694";"360470248001";0;2;43;4;22;71
"1695";"360470248002";10;37;108;7;42;204
"1696";"360470249001";33;101;15;9;20;178
"1697";"360470249002";44;13;14;0;6;77
"1698";"360470249003";82;253;42;4;20;401
"1699";"360470249004";0;13;2;0;11;26
"1700";"360470250001";5;6;97;83;28;219
"1701";"360470250002";1;11;57;4;19;92
"1702";"360470251001";32;91;38;4;7;172
"1703";"360470251002";103;14;20;14;9;160
"1704";"360470251003";36;26;19;2;12;95
"1705";"360470252001";16;5;78;4;14;117
"1706";"360470252002";46;1;111;0;5;163
"1707";"360470252003";1;2;259;6;5;273
"1708";"360470252004";13;6;58;3;12;92
"1709";"360470253001";45;21;33;5;14;118
"1710";"360470253002";37;10;30;3;11;91
"1711";"360470253003";30;36;21;2;9;98
"1712";"360470254001";10;0;20;1;11;42
"1713";"360470254002";8;1;83;8;23;123
"1714";"360470254003";16;1;121;6;13;157
"1715";"360470255001";56;19;13;0;2;90
"1716";"360470255002";71;12;6;3;12;104
"1717";"360470256001";5;19;92;5;21;142
"1718";"360470256002";18;2;54;3;12;89
"1719";"360470257001";19;16;55;4;26;120
"1720";"360470257002";35;1;23;6;12;77
"1721";"360470257003";15;9;32;1;19;76
"1722";"360470258001";31;2;130;6;28;197
"1723";"360470258002";2;3;80;1;15;101
"1724";"360470258003";3;1;59;3;12;78
"1725";"360470259011";98;54;77;23;35;287
"1726";"360470259021";125;4;17;4;5;155
"1727";"360470260001";8;2;25;3;16;54
"1728";"360470260002";8;2;27;2;5;44
"1729";"360470260003";35;8;46;3;15;107
"1730";"360470261001";106;65;60;5;17;253
"1731";"360470261002";30;8;17;2;14;71
"1732";"360470261003";85;44;25;1;10;165
"1733";"360470261004";68;23;25;1;25;142
"1734";"360470261005";171;22;27;4;9;233
"1735";"360470262001";46;36;120;3;32;237
"1736";"360470262002";4;4;110;16;42;176
"1737";"360470263001";81;34;49;13;12;189
"1738";"360470264001";13;2;69;6;13;103
"1739";"360470264002";31;4;113;15;19;182
"1740";"360470264003";22;6;135;3;25;191
"1741";"360470264004";10;5;46;2;10;73
"1742";"360470265001";42;8;26;5;5;86
"1743";"360470265002";49;14;23;2;11;99
"1744";"360470265003";23;11;45;11;11;101
"1745";"360470265004";37;20;34;26;12;129
"1746";"360470266001";6;3;76;7;16;108
"1747";"360470266002";10;1;38;8;18;75
"1748";"360470266003";37;3;35;2;6;83
"1749";"360470267001";29;21;4;0;10;64
"1750";"360470267002";36;28;15;6;13;98
"1751";"360470267003";21;32;28;0;16;97
"1752";"360470267004";29;36;22;4;16;107
"1753";"360470268001";18;6;19;0;6;49
"1754";"360470268002";13;0;25;0;10;48
"1755";"360470268003";2;3;122;4;12;143
"1756";"360470268004";7;1;14;2;9;33
"1757";"360470269001";28;62;20;1;27;138
"1758";"360470269002";8;10;6;1;16;41
"1759";"360470269003";26;219;17;1;30;293
"1760";"360470270001";16;1;93;8;15;133
"1761";"360470270002";22;7;65;16;11;121
"1762";"360470271001";69;34;75;27;45;250
"1763";"360470271002";27;25;64;9;6;131
"1764";"360470272001";5;0;27;1;1;34
"1765";"360470272002";12;3;54;1;4;74
"1766";"360470272003";9;0;35;3;9;56
"1767";"360470273001";7;19;14;8;3;51
"1768";"360470273002";12;12;93;5;2;124
"1769";"360470273003";23;21;18;3;17;82
"1770";"360470274001";5;1;56;2;13;77
"1771";"360470274002";4;26;110;2;18;160
"1772";"360470275001";37;26;6;0;8;77
"1773";"360470275002";33;18;11;9;10;81
"1774";"360470275003";22;220;8;10;16;276
"1775";"360470275004";37;242;23;10;17;329
"1776";"360470276001";15;7;21;6;10;59
"1777";"360470276002";20;1;72;1;13;107
"1778";"360470276003";28;9;97;46;19;199
"1779";"360470277001";85;82;10;1;2;180
"1780";"360470277002";25;14;4;1;8;52
"1781";"360470277003";31;13;10;1;0;55
"1782";"360470277004";37;7;5;10;8;67
"1783";"360470278001";76;10;71;1;11;169
"1784";"360470278002";40;28;75;0;37;180
"1785";"360470279001";32;70;9;5;10;126
"1786";"360470279002";25;48;25;6;13;117
"1787";"360470279003";50;19;18;4;18;109
"1788";"360470279004";76;37;39;7;10;169
"1789";"360470280001";3;0;43;0;13;59
"1790";"360470280002";10;10;158;6;25;209
"1791";"360470281001";57;15;49;2;8;131
"1792";"360470281002";48;14;17;9;9;97
"1793";"360470281003";78;70;48;9;280;485
"1794";"360470282001";10;2;100;27;8;147
"1795";"360470282002";53;4;125;55;8;245
"1796";"360470282003";3;0;34;1;3;41
"1797";"360470283001";30;6;32;1;11;80
"1798";"360470283002";25;7;83;11;10;136
"1799";"360470283003";65;10;28;6;7;116
"1800";"360470284001";11;2;141;0;4;158
"1801";"360470284002";44;1;128;0;12;185
"1802";"360470284003";11;1;64;0;39;115
"1803";"360470285011";39;37;76;1;29;182
"1804";"360470285021";122;22;40;5;5;194
"1805";"360470286001";21;2;4;1;0;28
"1806";"360470286002";12;1;14;0;3;30
"1807";"360470286003";7;2;2;0;1;12
"1808";"360470286004";8;3;59;0;6;76
"1809";"360470286005";4;5;55;2;4;70
"1810";"360470287001";52;250;34;22;57;415
"1811";"360470287002";36;29;38;7;13;123
"1812";"360470287003";58;23;8;6;12;107
"1813";"360470288001";12;22;95;1;6;136
"1814";"360470288002";11;4;13;1;22;51
"1815";"360470288003";16;7;76;3;25;127
"1816";"360470289001";5;30;17;2;31;85
"1817";"360470289002";43;29;43;11;14;140
"1818";"360470289003";20;13;15;4;9;61
"1819";"360470289004";53;67;24;16;9;169
"1820";"360470290001";30;2;13;5;4;54
"1821";"360470290002";33;0;23;0;5;61
"1822";"360470290003";15;8;109;0;38;170
"1823";"360470291001";58;49;39;17;23;186
"1824";"360470291002";56;16;42;4;17;135
"1825";"360470291003";144;11;15;1;12;183
"1826";"360470292001";5;1;97;1;6;110
"1827";"360470292002";16;2;103;3;4;128
"1828";"360470293001";31;4;3;3;6;47
"1829";"360470293002";31;10;3;3;7;54
"1830";"360470293003";35;15;12;8;11;81
"1831";"360470293004";17;4;10;0;4;35
"1832";"360470294001";6;12;79;2;21;120
"1833";"360470295001";104;14;59;1;19;197
"1834";"360470295002";31;67;12;3;12;125
"1835";"360470295003";12;3;7;0;10;32
"1836";"360470295004";63;9;22;0;11;105
"1837";"360470296001";39;1;163;25;8;236
"1838";"360470296002";21;10;44;8;13;96
"1839";"360470296003";27;0;90;6;11;134
"1840";"360470296004";8;5;156;2;2;173
"1841";"360470297001";8;24;25;1;7;65
"1842";"360470297002";74;132;22;6;10;244
"1843";"360470297003";3;6;22;6;4;41
"1844";"360470298001";3;4;152;2;11;172
"1845";"360470298002";4;2;82;6;24;118
"1846";"360470298003";2;3;39;5;26;75
"1847";"360470299001";32;4;32;10;17;95
"1848";"360470299002";17;20;55;27;31;150
"1849";"360470300001";21;18;168;2;18;227
"1850";"360470300002";9;65;97;9;13;193
"1851";"360470301001";26;8;36;9;11;90
"1852";"360470301002";25;1;26;13;7;72
"1853";"360470301003";32;8;64;24;10;138
"1854";"360470302001";12;8;119;5;12;156
"1855";"360470302002";8;3;70;5;8;94
"1856";"360470302003";8;5;43;3;6;65
"1857";"360470303001";86;21;57;4;5;173
"1858";"360470303002";43;11;20;10;12;96
"1859";"360470303003";78;26;24;23;16;167
"1860";"360470304001";5;8;180;30;15;238
"1861";"360470304002";12;11;132;16;13;184
"1862";"360470304003";12;0;23;8;9;52
"1863";"360470305001";54;485;321;40;70;970
"1864";"360470305002";103;49;52;14;22;240
"1865";"360470305003";51;23;35;0;3;112
"1866";"360470305004";62;34;26;7;14;143
"1867";"360470306001";18;36;142;14;10;220
"1868";"360470307001";18;4;4;2;2;30
"1869";"360470307002";28;3;1;1;2;35
"1870";"360470307003";102;72;118;30;49;371
"1871";"360470308001";99;28;123;36;17;303
"1872";"360470309001";66;21;49;17;34;187
"1873";"360470309002";40;8;51;9;11;119
"1874";"360470311001";23;5;73;4;29;134
"1875";"360470311002";77;192;24;4;8;305
"1876";"360470311003";30;20;27;3;25;105
"1877";"360470313001";11;14;18;6;5;54
"1878";"360470313002";23;10;19;8;4;64
"1879";"360470313003";138;24;21;4;14;201
"1880";"360470313004";19;22;44;3;21;109
"1881";"360470314001";8;1;51;20;10;90
"1882";"360470314002";11;8;95;24;8;146
"1883";"360470314003";12;5;10;2;1;30
"1884";"360470314004";55;9;98;16;10;188
"1885";"360470315001";46;116;47;6;41;256
"1886";"360470315002";44;36;12;1;12;105
"1887";"360470315003";75;42;32;4;26;179
"1888";"360470315004";103;152;14;13;28;310
"1889";"360470317011";41;34;74;2;19;170
"1890";"360470317012";23;44;22;5;18;112
"1891";"360470317013";42;47;42;14;14;159
"1892";"360470317021";70;64;8;6;8;156
"1893";"360470317022";53;18;5;25;10;111
"1894";"360470317023";171;29;30;2;21;253
"1895";"360470319001";55;23;11;11;17;117
"1896";"360470319002";24;82;38;1;8;153
"1897";"360470319003";76;49;50;42;4;221
"1898";"360470321001";49;80;10;1;8;148
"1899";"360470321002";60;46;34;0;12;152
"1900";"360470321003";60;33;7;1;9;110
"1901";"360470321004";142;37;31;1;9;220
"1902";"360470323001";79;15;26;7;30;157
"1903";"360470323002";47;12;18;1;11;89
"1904";"360470323003";35;9;44;4;21;113
"1905";"360470325001";31;43;15;24;6;119
"1906";"360470325002";86;23;17;3;11;140
"1907";"360470325003";177;80;18;19;9;303
"1908";"360470326001";17;18;58;6;40;139
"1909";"360470326002";62;32;3;2;28;127
"1910";"360470326003";86;32;2;0;8;128
"1911";"360470326004";34;14;21;2;8;79
"1912";"360470326005";6;6;33;10;17;72
"1913";"360470327001";50;55;18;8;9;140
"1914";"360470327002";93;97;21;5;6;222
"1915";"360470327003";17;58;19;3;13;110
"1916";"360470328001";5;2;14;3;13;37
"1917";"360470328002";6;5;17;3;1;32
"1918";"360470328003";135;2;2;1;4;144
"1919";"360470328004";76;2;16;9;11;114
"1920";"360470329001";50;23;49;10;6;138
"1921";"360470329002";104;11;15;3;4;137
"1922";"360470329003";78;195;5;0;10;288
"1923";"360470329004";41;21;2;3;24;91
"1924";"360470330001";62;6;6;2;6;82
"1925";"360470330002";19;2;5;0;1;27
"1926";"360470330003";73;18;14;12;5;122
"1927";"360470331001";196;9;24;1;0;230
"1928";"360470331002";28;24;14;14;2;82
"1929";"360470331003";13;3;138;4;1;159
"1930";"360470333001";75;10;20;3;0;108
"1931";"360470333002";35;7;27;1;9;79
"1932";"360470333003";68;10;14;5;4;101
"1933";"360470335001";19;6;41;2;7;75
"1934";"360470335002";9;7;33;10;2;61
"1935";"360470335003";12;7;88;17;5;129
"1936";"360470336001";3;2;2;1;13;21
"1937";"360470336002";1;0;5;1;16;23
"1938";"360470336003";2;0;5;0;3;10
"1939";"360470336004";25;2;8;1;4;40
"1940";"360470336005";19;6;6;1;23;55
"1941";"360470337001";20;7;16;8;6;57
"1942";"360470337002";53;17;30;17;6;123
"1943";"360470337003";28;9;59;6;9;111
"1944";"360470339001";121;34;59;2;7;223
"1945";"360470339002";151;95;42;4;7;299
"1946";"360470339003";27;29;9;0;2;67
"1947";"360470339004";74;8;16;4;11;113
"1948";"360470340001";14;5;6;5;4;34
"1949";"360470340002";0;13;10;1;2;26
"1950";"360470341001";34;12;8;5;2;61
"1951";"360470341002";89;12;10;2;2;115
"1952";"360470341003";79;26;11;12;12;140
"1953";"360470342001";69;3;5;4;23;104
"1954";"360470342002";61;5;30;5;15;116
"1955";"360470342003";48;9;3;1;5;66
"1956";"360470342004";8;2;0;0;1;11
"1957";"360470343001";105;12;5;3;15;140
"1958";"360470343002";26;9;32;8;10;85
"1959";"360470343003";70;171;11;4;4;260
"1960";"360470345001";29;26;47;6;12;120
"1961";"360470345002";45;32;64;43;10;194
"1962";"360470347001";45;24;16;3;1;89
"1963";"360470347002";27;5;35;6;12;85
"1964";"360470347003";69;29;39;0;16;153
"1965";"360470348001";17;8;216;74;59;374
"1966";"360470348002";25;6;53;8;65;157
"1967";"360470349001";61;65;5;0;7;138
"1968";"360470349002";38;4;25;5;8;80
"1969";"360470349003";47;29;95;1;12;184
"1970";"360470349004";10;3;4;0;11;28
"1971";"360470350001";0;3;0;1;1;5
"1972";"360470350002";4;29;18;7;31;89
"1973";"360470351001";99;80;47;4;14;244
"1974";"360470351002";65;13;21;1;20;120
"1975";"360470351003";71;49;49;10;31;210
"1976";"360470352001";1;43;24;1;39;108
"1977";"360470353001";49;76;40;2;8;175
"1978";"360470353002";98;20;15;2;8;143
"1979";"360470353003";178;32;56;8;7;281
"1980";"360470354001";3;1;13;5;3;25
"1981";"360470354002";78;7;36;3;6;130
"1982";"360470354003";1;9;24;0;8;42
"1983";"360470355001";140;31;45;8;10;234
"1984";"360470355002";40;13;18;0;5;76
"1985";"360470355003";57;42;28;9;6;142
"1986";"360470356011";7;1;8;1;1;18
"1987";"360470356021";13;1;12;1;4;31
"1988";"360470356022";7;1;13;1;2;24
"1989";"360470356023";25;4;23;1;7;60
"1990";"360470357001";107;50;41;5;8;211
"1991";"360470359001";79;17;91;5;17;209
"1992";"360470359002";31;15;41;0;6;93
"1993";"360470359003";84;52;15;9;16;176
"1994";"360470359004";180;12;14;2;3;211
"1995";"360470360011";10;18;3;1;11;43
"1996";"360470360012";9;3;6;0;3;21
"1997";"360470360013";27;6;21;0;4;58
"1998";"360470360021";19;230;12;0;9;270
"1999";"360470360022";21;15;8;1;34;79
"2000";"360470361001";14;5;44;3;2;68
"2001";"360470361002";19;13;14;14;20;80
"2002";"360470361003";30;14;17;7;5;73
"2003";"360470362001";24;15;68;1;26;134
"2004";"360470362002";23;3;71;1;17;115
"2005";"360470362003";21;5;47;0;11;84
"2006";"360470363001";24;4;18;3;11;60
"2007";"360470363002";59;18;42;15;4;138
"2008";"360470363003";35;16;39;15;11;116
"2009";"360470363004";26;6;22;6;1;61
"2010";"360470364001";19;6;124;5;16;170
"2011";"360470364002";23;2;94;6;18;143
"2012";"360470365011";20;7;53;3;4;87
"2013";"360470365012";52;4;119;27;10;212
"2014";"360470365021";32;25;72;56;30;215
"2015";"360470366001";7;4;39;8;21;79
"2016";"360470366002";25;11;37;18;9;100
"2017";"360470366003";14;5;78;2;13;112
"2018";"360470367001";75;34;52;55;35;251
"2019";"360470367002";22;4;22;13;15;76
"2020";"360470369001";43;18;10;10;16;97
"2021";"360470369002";54;9;29;15;28;135
"2022";"360470369003";61;26;29;12;29;157
"2023";"360470369004";69;14;72;4;27;186
"2024";"360470370001";4;5;55;12;12;88
"2025";"360470370002";3;0;32;2;5;42
"2026";"360470370003";6;2;73;3;7;91
"2027";"360470370004";8;1;22;2;0;33
"2028";"360470371001";22;28;33;8;3;94
"2029";"360470371002";27;6;15;4;6;58
"2030";"360470371003";13;1;32;1;3;50
"2031";"360470371004";14;1;66;2;13;96
"2032";"360470371005";10;4;11;18;11;54
"2033";"360470373001";19;7;6;3;14;49
"2034";"360470373002";16;7;26;9;8;66
"2035";"360470373003";56;62;31;2;14;165
"2036";"360470373004";136;74;29;8;14;261
"2037";"360470374011";7;3;102;4;9;125
"2038";"360470374012";15;1;91;5;8;120
"2039";"360470374013";15;2;51;8;11;87
"2040";"360470374021";9;3;704;40;7;763
"2041";"360470374022";16;36;4;3;3;62
"2042";"360470374023";17;3;3;1;2;26
"2043";"360470374024";9;0;93;4;5;111
"2044";"360470375001";35;10;25;18;12;100
"2045";"360470375002";105;23;23;12;34;197
"2046";"360470375003";45;17;8;4;11;85
"2047";"360470377001";47;51;24;2;36;160
"2048";"360470377002";51;23;17;15;14;120
"2049";"360470377003";53;65;14;5;17;154
"2050";"360470377004";36;20;45;13;8;122
"2051";"360470379001";28;16;13;8;7;72
"2052";"360470379002";36;48;105;13;22;224
"2053";"360470379003";17;9;38;23;20;107
"2054";"360470381001";40;8;44;8;9;109
"2055";"360470381002";31;16;8;7;3;65
"2056";"360470381003";67;42;33;10;17;169
"2057";"360470381004";23;64;3;2;5;97
"2058";"360470382001";20;4;80;4;9;117
"2059";"360470382002";77;26;21;10;0;134
"2060";"360470382003";27;6;0;2;3;38
"2061";"360470383001";111;36;45;5;3;200
"2062";"360470383002";68;49;36;2;8;163
"2063";"360470383003";27;14;30;16;17;104
"2064";"360470383004";25;14;8;6;11;64
"2065";"360470385001";29;20;38;5;9;101
"2066";"360470385002";18;7;29;6;3;63
"2067";"360470385003";66;17;45;5;8;141
"2068";"360470385004";8;6;50;7;5;76
"2069";"360470386001";25;4;113;36;55;233
"2070";"360470386002";15;16;49;19;34;133
"2071";"360470387001";34;14;24;8;48;128
"2072";"360470387002";16;7;22;8;3;56
"2073";"360470387003";7;8;36;12;11;74
"2074";"360470387004";26;28;31;2;14;101
"2075";"360470388001";18;0;6;3;1;28
"2076";"360470388002";4;3;130;10;18;165
"2077";"360470388003";17;1;75;7;12;112
"2078";"360470388004";0;0;40;2;2;44
"2079";"360470389001";74;70;48;13;33;238
"2080";"360470389002";77;143;26;3;26;275
"2081";"360470389003";30;36;29;13;48;156
"2082";"360470390001";14;2;51;32;12;111
"2083";"360470390002";0;1;38;5;5;49
"2084";"360470391001";51;27;43;16;12;149
"2085";"360470391002";184;43;49;4;36;316
"2086";"360470392001";7;4;70;25;8;114
"2087";"360470392002";35;1;54;6;8;104
"2088";"360470393001";117;27;53;11;23;231
"2089";"360470393002";50;32;50;18;52;202
"2090";"360470393003";67;89;51;4;60;271
"2091";"360470394001";11;4;35;2;4;56
"2092";"360470394002";1;1;31;5;8;46
"2093";"360470394003";2;2;32;16;4;56
"2094";"360470395001";32;23;49;2;19;125
"2095";"360470395002";110;11;28;9;27;185
"2096";"360470395003";56;20;32;2;21;131
"2097";"360470396001";6;0;60;5;8;79
"2098";"360470396002";1;1;29;7;8;46
"2099";"360470397001";49;17;48;0;16;130
"2100";"360470397002";28;28;49;3;28;136
"2101";"360470397003";51;55;47;9;23;185
"2102";"360470398001";8;10;105;47;68;238
"2103";"360470398002";9;7;29;22;27;94
"2104";"360470399001";112;9;107;11;27;266
"2105";"360470399002";101;9;20;20;15;165
"2106";"360470399003";42;10;12;2;10;76
"2107";"360470400001";9;4;33;22;31;99
"2108";"360470400002";3;1;34;1;15;54
"2109";"360470400003";9;7;60;1;25;102
"2110";"360470401001";18;5;23;5;7;58
"2111";"360470401002";37;25;18;6;14;100
"2112";"360470401003";32;11;97;1;24;165
"2113";"360470402001";12;12;112;17;17;170
"2114";"360470402002";15;7;146;29;18;215
"2115";"360470403001";48;14;41;40;26;169
"2116";"360470403002";37;7;51;12;19;126
"2117";"360470403003";26;26;30;7;16;105
"2118";"360470404001";4;5;63;2;5;79
"2119";"360470404002";4;2;43;5;14;68
"2120";"360470405001";9;10;116;88;23;246
"2121";"360470405002";19;12;7;7;4;49
"2122";"360470406001";40;5;157;4;15;221
"2123";"360470406002";14;6;39;2;6;67
"2124";"360470406003";33;2;35;5;9;84
"2125";"360470407001";0;1;3;10;0;14
"2126";"360470408001";8;7;35;1;3;54
"2127";"360470408002";10;4;60;4;11;89
"2128";"360470408003";3;2;53;3;10;71
"2129";"360470409001";139;24;41;16;31;251
"2130";"360470409002";58;134;42;7;15;256
"2131";"360470409003";36;24;55;5;8;128
"2132";"360470410001";10;46;188;4;4;252
"2133";"360470410002";3;2;55;5;6;71
"2134";"360470411001";105;49;29;6;11;200
"2135";"360470411002";38;10;35;1;7;91
"2136";"360470411003";17;4;17;0;2;40
"2137";"360470412001";10;18;55;6;42;131
"2138";"360470412002";12;2;367;20;12;413
"2139";"360470413001";65;11;31;11;22;140
"2140";"360470413002";54;31;67;1;13;166
"2141";"360470413003";55;28;73;2;11;169
"2142";"360470414011";5;12;22;8;9;56
"2143";"360470414012";1;1;41;1;4;48
"2144";"360470414021";138;1;15;0;14;168
"2145";"360470414022";25;1;17;6;3;52
"2146";"360470415001";78;20;40;9;26;173
"2147";"360470415002";131;37;88;9;25;290
"2148";"360470415003";73;2;20;6;5;106
"2149";"360470416001";11;4;54;5;2;76
"2150";"360470416002";25;1;65;2;2;95
"2151";"360470417001";8;11;10;1;3;33
"2152";"360470417002";10;6;18;6;2;42
"2153";"360470417003";47;24;23;5;10;109
"2154";"360470417004";54;53;21;13;17;158
"2155";"360470418001";9;23;32;5;7;76
"2156";"360470418002";2;2;27;0;0;31
"2157";"360470419001";110;53;65;8;18;254
"2158";"360470419002";40;17;61;2;10;130
"2159";"360470419003";44;18;22;13;18;115
"2160";"360470420001";6;3;77;5;10;101
"2161";"360470420002";0;2;33;4;7;46
"2162";"360470421001";48;38;11;11;4;112
"2163";"360470421002";43;30;24;1;26;124
"2164";"360470421003";62;34;38;17;36;187
"2165";"360470421004";55;62;106;15;19;257
"2166";"360470422001";25;5;52;3;5;90
"2167";"360470422002";4;14;77;11;20;126
"2168";"360470422003";15;1;22;7;12;57
"2169";"360470423001";72;48;88;12;39;259
"2170";"360470423002";109;98;109;32;23;371
"2171";"360470423003";52;32;13;5;9;111
"2172";"360470424001";9;9;50;10;19;97
"2173";"360470424002";23;7;46;17;16;109
"2174";"360470424003";17;2;62;7;8;96
"2175";"360470425001";25;25;23;2;11;86
"2176";"360470425002";29;9;62;3;18;121
"2177";"360470425003";29;155;16;4;21;225
"2178";"360470426001";12;2;83;9;4;110
"2179";"360470426002";8;6;149;8;11;182
"2180";"360470426003";4;7;51;7;8;77
"2181";"360470427001";102;285;18;3;34;442
"2182";"360470427002";92;83;28;4;16;223
"2183";"360470427003";164;59;37;11;22;293
"2184";"360470427004";58;50;32;5;19;164
"2185";"360470428001";10;3;101;3;13;130
"2186";"360470428002";24;3;84;5;19;135
"2187";"360470428003";7;4;53;3;7;74
"2188";"360470429001";205;251;55;0;39;550
"2189";"360470429002";141;69;9;1;22;242
"2190";"360470429003";75;40;24;0;23;162
"2191";"360470429004";130;94;7;0;24;255
"2192";"360470430001";3;11;27;1;15;57
"2193";"360470430002";18;7;99;29;10;163
"2194";"360470430003";34;6;98;4;23;165
"2195";"360470431001";65;71;75;5;69;285
"2196";"360470431002";94;67;23;8;35;227
"2197";"360470431003";45;68;19;3;33;168
"2198";"360470431004";84;163;10;2;59;318
"2199";"360470432001";14;2;173;1;4;194
"2200";"360470432002";13;19;74;4;27;137
"2201";"360470432003";11;14;58;7;16;106
"2202";"360470433001";20;19;8;1;6;54
"2203";"360470433002";124;75;34;4;38;275
"2204";"360470433003";72;70;22;18;33;215
"2205";"360470434001";19;27;64;11;9;130
"2206";"360470434002";11;1;45;4;9;70
"2207";"360470434003";38;5;58;7;7;115
"2208";"360470435001";81;18;18;3;10;130
"2209";"360470435002";52;42;37;9;31;171
"2210";"360470435003";48;59;24;1;16;148
"2211";"360470436001";12;3;86;2;8;111
"2212";"360470436002";4;0;33;0;15;52
"2213";"360470436003";17;1;87;8;10;123
"2214";"360470437001";42;23;37;1;7;110
"2215";"360470437002";97;81;15;7;20;220
"2216";"360470437003";96;111;21;5;43;276
"2217";"360470437004";159;163;28;0;12;362
"2218";"360470438001";11;5;26;9;5;56
"2219";"360470438002";36;2;86;21;34;179
"2220";"360470439001";46;89;134;7;30;306
"2221";"360470439002";42;8;68;1;16;135
"2222";"360470439003";47;53;134;9;35;278
"2223";"360470440001";11;0;25;1;5;42
"2224";"360470440002";53;8;105;15;8;189
"2225";"360470440003";17;4;86;40;44;191
"2226";"360470441001";93;99;52;3;62;309
"2227";"360470441002";66;53;46;1;29;195
"2228";"360470441003";300;102;33;2;11;448
"2229";"360470442001";26;7;45;19;7;104
"2230";"360470442002";3;1;39;14;0;57
"2231";"360470443001";16;20;13;0;3;52
"2232";"360470443002";74;50;56;2;56;238
"2233";"360470443003";96;28;31;0;29;184
"2234";"360470443004";36;3;23;0;23;85
"2235";"360470444001";1;2;39;4;7;53
"2236";"360470444002";12;1;33;2;5;53
"2237";"360470444003";21;2;43;2;21;89
"2238";"360470445001";82;39;50;1;18;190
"2239";"360470445002";73;64;86;33;12;268
"2240";"360470445003";87;170;46;2;20;325
"2241";"360470446001";4;2;90;13;16;125
"2242";"360470446002";13;4;97;10;5;129
"2243";"360470447001";75;133;39;4;21;272
"2244";"360470447002";16;123;72;5;31;247
"2245";"360470448001";4;15;52;5;8;84
"2246";"360470448002";7;9;33;6;11;66
"2247";"360470449001";9;14;6;8;4;41
"2248";"360470449002";244;133;30;2;3;412
"2249";"360470449003";8;32;122;35;14;211
"2250";"360470449004";5;128;163;110;37;443
"2251";"360470450001";4;10;46;27;12;99
"2252";"360470452001";2;1;55;9;4;71
"2253";"360470452002";8;1;51;15;7;82
"2254";"360470453001";57;77;132;32;51;349
"2255";"360470453002";67;210;73;3;17;370
"2256";"360470454001";7;91;29;7;18;152
"2257";"360470454002";7;6;31;9;4;57
"2258";"360470456001";11;10;44;4;30;99
"2259";"360470456002";9;9;63;6;7;94
"2260";"360470458001";6;0;42;9;10;67
"2261";"360470458002";0;2;23;10;5;40
"2262";"360470460001";21;6;71;9;10;117
"2263";"360470460002";10;8;40;3;17;78
"2264";"360470460003";10;7;86;10;26;139
"2265";"360470462011";20;5;152;18;11;206
"2266";"360470462012";21;13;201;19;16;270
"2267";"360470462021";7;2;67;12;5;93
"2268";"360470462022";18;6;77;8;24;133
"2269";"360470464001";1;1;26;8;18;54
"2270";"360470464002";5;0;23;8;20;56
"2271";"360470468001";1;208;160;13;15;397
"2272";"360470470001";2;3;36;3;4;48
"2273";"360470470002";2;3;41;9;1;56
"2274";"360470472001";0;1;7;14;0;22
"2275";"360470472002";3;25;53;4;10;95
"2276";"360470472003";2;0;17;10;3;32
"2277";"360470474001";0;4;14;4;3;25
"2278";"360470474002";2;1;19;2;1;25
"2279";"360470476001";3;10;35;21;23;92
"2280";"360470476002";2;4;24;0;0;30
"2281";"360470476003";1;1;40;3;0;45
"2282";"360470477001";105;52;150;25;30;362
"2283";"360470477002";40;52;102;19;34;247
"2284";"360470478001";16;9;79;13;42;159
"2285";"360470478002";2;0;23;7;4;36
"2286";"360470478003";12;4;58;19;30;123
"2287";"360470480001";3;1;34;1;7;46
"2288";"360470480002";17;5;142;24;34;222
"2289";"360470481001";19;16;29;1;7;72
"2290";"360470481002";14;108;43;18;13;196
"2291";"360470481003";68;38;67;10;20;203
"2292";"360470482001";7;6;121;30;18;182
"2293";"360470482002";29;10;42;4;30;115
"2294";"360470482003";24;2;91;1;7;125
"2295";"360470482004";112;8;204;1;2;327
"2296";"360470484001";53;33;102;3;14;205
"2297";"360470484002";22;41;352;10;9;434
"2298";"360470484003";12;3;23;6;2;46
"2299";"360470485001";91;134;267;31;66;589
"2300";"360470485002";143;211;203;11;34;602
"2301";"360470486001";8;37;80;0;13;138
"2302";"360470486002";406;11;40;11;24;492
"2303";"360470486003";6;9;79;9;15;118
"2304";"360470488001";33;23;85;3;19;163
"2305";"360470488002";6;4;221;15;7;253
"2306";"360470488003";12;16;95;13;8;144
"2307";"360470489001";114;5;0;0;3;122
"2308";"360470489002";36;3;1;1;5;46
"2309";"360470489003";99;7;3;0;1;110
"2310";"360470490001";43;16;62;7;6;134
"2311";"360470490002";79;14;144;10;14;261
"2312";"360470490003";63;6;84;6;13;172
"2313";"360470491001";3;12;4;0;1;20
"2314";"360470491002";29;78;15;0;63;185
"2315";"360470491003";61;62;21;4;24;172
"2316";"360470491004";6;4;10;4;3;27
"2317";"360470492001";10;6;44;38;5;103
"2318";"360470492002";24;11;72;25;20;152
"2319";"360470492003";10;16;63;36;14;139
"2320";"360470493001";72;20;4;0;4;100
"2321";"360470493002";164;77;17;1;15;274
"2322";"360470493003";32;60;39;4;17;152
"2323";"360470493004";55;24;2;0;5;86
"2324";"360470493005";17;49;8;2;11;87
"2325";"360470494001";40;42;118;27;3;230
"2326";"360470494002";46;9;65;1;8;129
"2327";"360470494003";9;12;35;0;1;57
"2328";"360470494004";1;3;21;1;2;28
"2329";"360470495001";30;25;28;2;16;101
"2330";"360470495002";40;21;36;2;21;120
"2331";"360470495003";27;67;29;10;12;145
"2332";"360470496001";20;20;40;8;23;111
"2333";"360470496002";7;5;60;15;17;104
"2334";"360470496003";35;10;74;26;13;158
"2335";"360470497001";18;14;48;7;6;93
"2336";"360470497002";23;28;58;8;16;133
"2337";"360470497003";16;12;45;5;18;96
"2338";"360470498001";44;17;75;26;15;177
"2339";"360470498002";24;5;91;17;15;152
"2340";"360470498003";2;1;73;28;5;109
"2341";"360470499001";16;7;8;4;10;45
"2342";"360470499002";22;8;57;3;18;108
"2343";"360470500001";3;4;48;8;6;69
"2344";"360470500002";78;12;36;15;22;163
"2345";"360470500003";12;2;39;20;6;79
"2346";"360470501001";38;3;11;6;16;74
"2347";"360470501002";37;17;13;7;16;90
"2348";"360470501003";42;190;56;8;42;338
"2349";"360470502021";0;11;19;4;8;42
"2350";"360470502022";13;8;46;7;27;101
"2351";"360470503001";25;80;49;5;18;177
"2352";"360470503002";59;42;71;12;24;208
"2353";"360470503003";23;21;25;12;17;98
"2354";"360470504001";2;4;13;10;6;35
"2355";"360470504002";23;11;60;9;11;114
"2356";"360470504003";52;15;84;10;25;186
"2357";"360470505001";33;17;5;1;9;65
"2358";"360470505002";59;91;28;4;15;197
"2359";"360470505003";23;61;7;3;16;110
"2360";"360470506001";129;44;22;1;10;206
"2361";"360470506002";49;25;42;4;12;132
"2362";"360470506003";111;22;12;5;10;160
"2363";"360470506004";65;6;12;10;28;121
"2364";"360470507001";2;9;103;20;62;196
"2365";"360470508011";39;25;0;6;7;77
"2366";"360470508012";118;53;10;1;41;223
"2367";"360470508031";132;76;42;3;21;274
"2368";"360470508041";101;47;30;4;10;192
"2369";"360470508042";81;40;32;10;18;181
"2370";"360470508043";83;33;34;3;12;165
"2371";"360470509001";15;169;41;11;14;250
"2372";"360470509002";2;7;13;4;3;29
"2373";"360470510011";35;7;11;40;6;99
"2374";"360470510012";270;123;17;6;20;436
"2375";"360470510021";96;71;29;11;13;220
"2376";"360470510022";36;20;6;1;3;66
"2377";"360470510023";30;31;9;4;1;75
"2378";"360470511001";30;12;9;0;5;56
"2379";"360470511002";103;79;24;10;16;232
"2380";"360470511003";25;60;48;16;41;190
"2381";"360470512001";65;46;32;72;15;230
"2382";"360470512002";79;27;10;27;2;145
"2383";"360470512003";77;16;18;20;3;134
"2384";"360470512004";25;12;20;4;4;65
"2385";"360470513001";32;151;99;5;38;325
"2386";"360470513002";12;26;14;14;13;79
"2387";"360470513003";92;250;104;15;47;508
"2388";"360470513004";28;81;6;4;6;125
"2389";"360470514001";7;12;73;8;6;106
"2390";"360470514002";79;19;26;2;11;137
"2391";"360470514003";123;33;32;1;26;215
"2392";"360470514004";84;7;23;11;26;151
"2393";"360470515001";47;52;44;5;38;186
"2394";"360470516011";51;20;44;2;10;127
"2395";"360470516012";171;25;33;4;17;250
"2396";"360470516013";108;75;79;7;34;303
"2397";"360470516021";106;103;24;3;5;241
"2398";"360470516022";92;244;38;7;57;438
"2399";"360470517001";71;54;10;2;12;149
"2400";"360470517002";32;175;22;5;22;256
"2401";"360470518001";35;6;66;7;4;118
"2402";"360470518002";20;17;47;16;4;104
"2403";"360470518003";23;9;19;14;3;68
"2404";"360470519001";76;50;54;4;17;201
"2405";"360470519002";46;32;65;11;56;210
"2406";"360470519003";61;167;44;8;37;317
"2407";"360470520001";56;13;59;7;19;154
"2408";"360470520002";40;19;89;8;15;171
"2409";"360470520003";14;7;20;0;3;44
"2410";"360470523001";48;187;27;6;13;281
"2411";"360470523002";47;231;14;0;15;307
"2412";"360470523003";44;38;19;2;13;116
"2413";"360470523004";12;18;14;1;5;50
"2414";"360470523005";22;103;1;0;12;138
"2415";"360470525001";100;51;23;4;19;197
"2416";"360470525002";23;21;23;3;15;85
"2417";"360470526001";22;37;47;19;18;143
"2418";"360470526002";79;13;203;16;31;342
"2419";"360470526003";0;0;50;1;4;55
"2420";"360470527001";34;19;91;4;13;161
"2421";"360470527002";122;40;9;0;2;173
"2422";"360470527003";42;38;28;8;25;141
"2423";"360470527004";21;56;14;2;16;109
"2424";"360470527005";71;147;19;0;10;247
"2425";"360470527006";60;284;32;5;13;394
"2426";"360470527007";11;35;9;2;7;64
"2427";"360470528001";29;9;45;1;4;88
"2428";"360470528002";1;4;127;10;36;178
"2429";"360470529001";0;4;39;12;8;63
"2430";"360470529002";22;14;12;2;6;56
"2431";"360470529003";14;29;26;3;26;98
"2432";"360470530001";15;3;17;15;9;59
"2433";"360470530002";46;3;46;2;4;101
"2434";"360470530003";14;7;114;9;23;167
"2435";"360470531001";20;6;40;3;13;82
"2436";"360470531002";10;10;21;0;2;43
"2437";"360470531003";2;4;2;0;3;11
"2438";"360470531004";0;1;7;2;2;12
"2439";"360470532001";14;9;41;3;18;85
"2440";"360470532002";2;2;42;7;11;64
"2441";"360470533001";0;2;6;1;5;14
"2442";"360470533002";0;0;2;1;0;3
"2443";"360470533003";0;0;3;0;0;3
"2444";"360470533004";3;0;0;0;2;5
"2445";"360470533005";0;4;33;7;3;47
"2446";"360470534001";20;13;50;1;4;88
"2447";"360470534002";7;1;11;1;3;23
"2448";"360470534003";3;1;29;4;4;41
"2449";"360470534004";5;3;14;2;6;30
"2450";"360470535001";3;0;10;4;3;20
"2451";"360470535002";0;0;2;2;0;4
"2452";"360470535003";0;5;10;2;6;23
"2453";"360470535004";0;12;9;5;5;31
"2454";"360470537001";1;1;6;4;0;12
"2455";"360470537002";1;3;27;2;9;42
"2456";"360470538001";30;19;48;3;6;106
"2457";"360470538002";149;3;41;9;7;209
"2458";"360470538003";9;30;80;6;9;134
"2459";"360470539001";1;2;10;6;3;22
"2460";"360470539002";2;2;12;0;1;17
"2461";"360470542001";24;4;69;1;3;101
"2462";"360470542002";28;11;66;9;21;135
"2463";"360470542003";2;2;40;11;3;58
"2464";"360470543001";2;13;30;16;1;62
"2465";"360470543002";42;26;64;30;25;187
"2466";"360470544001";50;1;82;12;4;149
"2467";"360470544002";6;2;160;4;2;174
"2468";"360470544003";1;0;90;2;4;97
"2469";"360470545001";0;0;8;2;0;10
"2470";"360470545002";0;5;3;1;0;9
"2471";"360470545003";12;27;1;3;5;48
"2472";"360470545004";0;0;0;4;0;4
"2473";"360470545005";74;26;6;0;6;112
"2474";"360470545006";45;8;6;0;3;62
"2475";"360470546001";7;6;46;6;2;67
"2476";"360470546002";28;2;220;1;4;255
"2477";"360470546003";10;9;57;4;2;82
"2478";"360470547001";37;30;12;8;9;96
"2479";"360470547002";5;3;65;2;8;83
"2480";"360470547003";13;34;64;3;4;118
"2481";"360470548001";8;6;26;21;2;63
"2482";"360470548002";0;3;37;37;6;83
"2483";"360470549001";38;34;50;6;8;136
"2484";"360470549002";39;210;97;5;21;372
"2485";"360470550001";9;1;33;13;2;58
"2486";"360470550002";25;3;90;25;5;148
"2487";"360470550003";17;3;75;0;7;102
"2488";"360470551001";35;158;65;12;13;283
"2489";"360470551002";33;29;33;2;22;119
"2490";"360470551003";67;266;21;5;23;382
"2491";"360470551004";39;40;4;4;6;93
"2492";"360470552001";12;2;39;1;8;62
"2493";"360470552002";22;16;38;1;5;82
"2494";"360470552003";20;16;64;13;29;142
"2495";"360470553001";49;196;33;10;31;319
"2496";"360470553002";29;93;58;12;20;212
"2497";"360470553003";40;163;69;13;37;322
"2498";"360470554001";18;3;39;14;14;88
"2499";"360470554002";32;4;12;1;12;61
"2500";"360470554003";4;8;43;5;11;71
"2501";"360470555001";289;320;243;15;49;916
"2502";"360470556001";8;13;49;6;13;89
"2503";"360470556002";4;2;62;0;3;71
"2504";"360470556003";11;7;38;2;21;79
"2505";"360470557001";25;9;33;2;14;83
"2506";"360470557002";45;138;83;8;20;294
"2507";"360470558001";10;2;45;2;6;65
"2508";"360470558002";10;212;86;5;14;327
"2509";"360470560001";2;2;78;29;13;124
"2510";"360470560002";80;4;34;1;9;128
"2511";"360470560003";5;1;28;4;3;41
"2512";"360470561001";38;32;63;15;19;167
"2513";"360470561002";8;4;16;8;17;53
"2514";"360470561003";6;55;37;13;26;137
"2515";"360470561004";24;20;55;3;12;114
"2516";"360470562001";1;0;26;39;4;70
"2517";"360470562002";5;1;49;66;2;123
"2518";"360470563001";79;50;81;5;23;238
"2519";"360470563002";42;191;59;4;22;318
"2520";"360470563003";20;12;75;9;11;127
"2521";"360470563004";17;43;97;5;34;196
"2522";"360470564001";17;0;14;5;11;47
"2523";"360470564002";2;0;23;13;7;45
"2524";"360470564003";1;0;11;7;3;22
"2525";"360470565001";42;163;118;13;46;382
"2526";"360470565002";19;2;24;14;17;76
"2527";"360470565003";36;38;12;4;26;116
"2528";"360470566001";6;4;55;11;9;85
"2529";"360470566002";1;3;20;14;4;42
"2530";"360470568001";1;0;48;25;7;81
"2531";"360470568002";0;0;40;16;1;57
"2532";"360470569001";56;121;6;1;26;210
"2533";"360470569002";24;48;54;5;25;156
"2534";"360470570001";12;2;9;10;6;39
"2535";"360470570002";5;1;8;7;0;21
"2536";"360470570003";0;0;7;10;1;18
"2537";"360470570004";33;7;32;45;12;129
"2538";"360470571001";29;73;30;2;11;145
"2539";"360470571002";13;8;20;2;9;52
"2540";"360470571003";20;9;6;4;16;55
"2541";"360470571004";7;5;12;1;14;39
"2542";"360470572001";211;25;7;22;7;272
"2543";"360470572002";219;25;12;28;10;294
"2544";"360470573001";14;16;48;16;11;105
"2545";"360470573002";15;8;20;3;5;51
"2546";"360470573003";18;5;40;2;11;76
"2547";"360470574001";9;32;35;25;15;116
"2548";"360470574002";9;3;21;12;9;54
"2549";"360470575001";23;15;16;10;15;79
"2550";"360470575002";34;77;18;2;21;152
"2551";"360470575003";18;7;31;11;21;88
"2552";"360470575004";35;14;34;0;15;98
"2553";"360470576001";31;3;31;10;25;100
"2554";"360470576002";6;5;43;12;17;83
"2555";"360470578001";50;7;64;10;12;143
"2556";"360470578002";39;6;52;7;35;139
"2557";"360470579001";35;32;40;0;11;118
"2558";"360470579002";8;12;153;26;19;218
"2559";"360470580001";29;4;32;1;27;93
"2560";"360470580002";8;5;57;3;13;86
"2561";"360470582001";7;4;46;1;8;66
"2562";"360470582002";3;2;13;2;7;27
"2563";"360470582003";16;2;54;6;19;97
"2564";"360470584001";50;2;48;6;4;110
"2565";"360470584002";34;5;115;16;16;186
"2566";"360470586001";112;4;35;12;7;170
"2567";"360470586002";5;1;59;4;5;74
"2568";"360470588001";51;3;128;25;13;220
"2569";"360470588002";16;5;11;0;7;39
"2570";"360470589001";14;4;60;11;18;107
"2571";"360470589002";19;51;12;3;7;92
"2572";"360470590001";10;43;122;17;20;212
"2573";"360470591001";24;4;17;1;11;57
"2574";"360470591002";15;22;10;5;6;58
"2575";"360470591003";22;20;21;1;10;74
"2576";"360470591004";10;24;19;1;16;70
"2577";"360470592001";26;1;67;0;11;105
"2578";"360470592002";44;10;91;14;9;168
"2579";"360470592003";18;8;28;3;10;67
"2580";"360470593001";21;5;63;11;8;108
"2581";"360470593002";36;15;14;9;10;84
"2582";"360470594011";0;0;22;9;36;67
"2583";"360470594012";10;0;50;21;11;92
"2584";"360470594013";3;3;73;70;13;162
"2585";"360470594014";10;9;58;45;9;131
"2586";"360470594015";12;0;40;6;11;69
"2587";"360470594016";77;1;43;24;2;147
"2588";"360470594021";8;9;21;8;29;75
"2589";"360470594022";37;5;130;33;1;206
"2590";"360470594023";3;1;118;23;4;149
"2591";"360470594024";7;0;43;5;4;59
"2592";"360470596001";16;1;11;11;2;41
"2593";"360470596002";1;0;4;1;1;7
"2594";"360470596003";3;9;138;36;9;195
"2595";"360470598001";12;2;38;24;7;83
"2596";"360470598002";18;1;50;22;10;101
"2597";"360470600001";3;3;37;14;8;65
"2598";"360470600002";2;0;110;52;15;179
"2599";"360470600003";8;2;122;153;8;293
"2600";"360470600004";3;1;78;12;13;107
"2601";"360470600005";43;1;33;4;17;98
"2602";"360470606001";28;5;24;1;39;97
"2603";"360470606002";18;1;45;4;7;75
"2604";"360470608001";42;26;65;14;22;169
"2605";"360470608002";33;0;45;31;17;126
"2606";"360470608003";68;61;58;11;13;211
"2607";"360470610021";19;2;72;0;2;95
"2608";"360470610022";59;10;18;1;7;95
"2609";"360470610031";8;2;29;1;12;52
"2610";"360470610032";39;2;45;1;33;120
"2611";"360470610041";28;8;30;1;38;105
"2612";"360470610042";36;1;173;0;14;224
"2613";"360470610043";19;3;70;3;12;107
"2614";"360470610044";110;19;26;0;2;157
"2615";"360470610045";12;1;18;0;4;35
"2616";"360470612001";6;16;61;5;19;107
"2617";"360470616001";25;16;76;5;14;136
"2618";"360470620001";7;11;33;4;9;64
"2619";"360470620002";0;8;21;6;2;37
"2620";"360470622001";25;5;81;17;15;143
"2621";"360470622002";27;31;117;47;34;256
"2622";"360470626001";11;2;61;6;8;88
"2623";"360470626002";3;7;55;50;20;135
"2624";"360470628001";5;6;26;47;27;111
"2625";"360470628002";7;8;76;46;32;169
"2626";"360470628003";15;0;41;25;12;93
"2627";"360470628004";7;6;37;34;13;97
"2628";"360470632001";27;1;15;9;3;55
"2629";"360470632002";1;1;21;4;3;30
"2630";"360470636001";26;3;84;49;9;171
"2631";"360470638001";1;1;17;3;2;24
"2632";"360470638002";0;2;30;15;4;51
"2633";"360470640001";4;6;33;21;1;65
"2634";"360470640002";8;8;49;33;5;103
"2635";"360470642001";6;6;47;24;12;95
"2636";"360470642002";4;0;32;13;7;56
"2637";"360470644001";8;6;77;24;9;124
"2638";"360470644002";10;3;40;47;13;113
"2639";"360470646001";0;1;33;20;9;63
"2640";"360470646002";4;8;118;43;17;190
"2641";"360470648001";26;2;102;104;22;256
"2642";"360470648002";3;1;40;30;7;81
"2643";"360470650001";3;3;28;21;17;72
"2644";"360470650002";16;2;45;49;9;121
"2645";"360470652001";7;34;75;44;13;173
"2646";"360470654001";1;1;21;6;1;30
"2647";"360470654002";4;1;26;12;7;50
"2648";"360470656001";4;12;31;20;6;73
"2649";"360470656002";1;1;26;9;2;39
"2650";"360470658001";6;0;26;4;19;55
"2651";"360470658002";2;6;51;26;5;90
"2652";"360470660001";7;1;28;13;2;51
"2653";"360470660002";1;0;25;18;5;49
"2654";"360470662001";4;14;76;39;24;157
"2655";"360470666001";13;34;36;38;8;129
"2656";"360470670001";11;6;50;45;1;113
"2657";"360470670002";48;3;118;78;15;262
"2658";"360470672001";57;18;131;221;27;454
"2659";"360470674001";2;9;31;80;7;129
"2660";"360470674002";27;4;68;93;5;197
"2661";"360470676001";11;4;48;47;4;114
"2662";"360470676002";4;4;66;59;11;144
"2663";"360470678001";20;2;84;85;6;197
"2664";"360470678002";32;7;62;136;5;242
"2665";"360470680001";32;5;54;61;7;159
"2666";"360470680002";32;47;75;58;13;225
"2667";"360470682001";27;21;30;95;11;184
"2668";"360470682002";19;4;42;71;4;140
"2669";"360470686001";1;2;38;25;13;79
"2670";"360470686002";5;2;26;33;5;71
"2671";"360470688001";8;1;42;30;7;88
"2672";"360470688002";4;0;18;15;1;38
"2673";"360470690001";10;6;79;47;8;150
"2674";"360470690002";18;9;83;83;7;200
"2675";"360470692001";33;12;99;193;12;349
"2676";"360470692002";7;1;163;169;3;343
"2677";"360470696011";100;15;160;66;13;354
"2678";"360470696012";26;5;198;53;45;327
"2679";"360470696021";6;4;70;50;22;152
"2680";"360470696022";42;10;81;144;13;290
"2681";"360470696023";39;8;94;51;17;209
"2682";"360470698001";12;0;14;9;5;40
"2683";"360470698002";39;15;90;124;19;287
"2684";"360470700001";6;4;10;9;0;29
"2685";"360470700002";11;1;135;65;17;229
"2686";"360470702011";3;5;33;53;5;99
"2687";"360470702012";5;1;8;33;4;51
"2688";"360470702013";20;1;4;12;3;40
"2689";"360470702014";4;1;136;56;14;211
"2690";"360470702015";16;0;121;43;21;201
"2691";"360470702021";0;2;1;1;3;7
"2692";"360470706001";10;5;93;52;19;179
"2693";"360470706002";6;17;33;14;19;89
"2694";"360470720001";17;4;109;250;17;397
"2695";"360470722001";25;26;90;57;13;211
"2696";"360470722002";34;10;57;86;19;206
"2697";"360470724001";11;4;24;8;7;54
"2698";"360470724002";14;5;73;77;10;179
"2699";"360470726001";13;8;101;103;13;238
"2700";"360470728001";68;12;77;18;8;183
"2701";"360470728002";16;6;46;47;16;131
"2702";"360470730001";28;16;66;36;20;166
"2703";"360470730002";12;4;27;32;7;82
"2704";"360470732001";32;4;72;21;8;137
"2705";"360470732002";33;4;45;17;5;104
"2706";"360470734001";10;3;21;11;10;55
"2707";"360470734002";6;10;74;18;5;113
"2708";"360470736001";50;3;11;23;4;91
"2709";"360470736002";11;0;27;8;10;56
"2710";"360470736003";19;2;43;14;14;92
"2711";"360470738001";18;4;103;24;13;162
"2712";"360470738002";56;1;165;15;7;244
"2713";"360470738003";28;18;258;26;7;337
"2714";"360470740001";30;20;168;37;11;266
"2715";"360470740002";64;16;99;22;24;225
"2716";"360470742001";23;4;152;15;17;211
"2717";"360470742002";58;5;51;4;7;125
"2718";"360470744001";8;4;66;8;4;90
"2719";"360470744002";2;8;56;9;1;76
"2720";"360470746001";39;4;125;34;10;212
"2721";"360470746002";2;3;70;4;12;91
"2722";"360470748001";4;6;81;7;9;107
"2723";"360470748002";0;0;19;21;0;40
"2724";"360470750001";2;4;44;18;18;86
"2725";"360470750002";42;5;27;13;1;88
"2726";"360470752001";0;2;42;5;4;53
"2727";"360470754001";0;0;20;8;1;29
"2728";"360470754002";0;1;33;6;1;41
"2729";"360470756001";7;4;51;7;13;82
"2730";"360470756002";5;0;29;4;4;42
"2731";"360470758001";3;1;92;6;3;105
"2732";"360470758002";58;2;48;5;8;121
"2733";"360470760001";0;0;44;1;4;49
"2734";"360470760002";16;0;25;3;4;48
"2735";"360470760003";14;3;18;0;10;45
"2736";"360470762001";68;2;14;8;0;92
"2737";"360470762002";11;3;74;6;10;104
"2738";"360470762003";69;6;19;0;3;97
"2739";"360470764001";58;6;86;6;8;164
"2740";"360470764002";20;1;28;2;2;53
"2741";"360470764003";13;27;60;5;5;110
"2742";"360470766001";161;7;112;10;3;293
"2743";"360470768001";8;5;58;11;9;91
"2744";"360470768002";10;4;120;4;8;146
"2745";"360470768003";14;4;102;3;19;142
"2746";"360470770001";38;14;57;12;3;124
"2747";"360470770002";33;20;162;43;39;297
"2748";"360470772001";42;7;125;29;3;206
"2749";"360470772002";82;11;66;13;4;176
"2750";"360470774001";13;3;41;3;21;81
"2751";"360470774002";34;7;45;2;24;112
"2752";"360470776001";15;2;9;4;2;32
"2753";"360470776002";13;1;20;7;4;45
"2754";"360470776003";5;1;68;15;13;102
"2755";"360470780001";16;0;24;12;7;59
"2756";"360470780002";24;2;36;9;5;76
"2757";"360470782001";37;5;38;30;7;117
"2758";"360470782002";158;7;67;7;11;250
"2759";"360470784001";51;3;61;11;11;137
"2760";"360470784002";14;12;55;7;6;94
"2761";"360470786001";46;21;29;5;21;122
"2762";"360470786002";20;6;16;8;28;78
"2763";"360470786003";112;12;92;3;12;231
"2764";"360470788001";21;14;60;17;4;116
"2765";"360470788002";37;5;38;5;11;96
"2766";"360470788003";10;14;37;20;9;90
"2767";"360470790001";87;82;53;9;12;243
"2768";"360470790002";76;58;72;40;23;269
"2769";"360470790003";35;10;36;11;15;107
"2770";"360470790004";19;7;30;23;10;89
"2771";"360470792001";206;83;127;28;13;457
"2772";"360470792002";30;14;33;19;13;109
"2773";"360470792003";41;69;76;46;53;285
"2774";"360470794001";27;25;64;38;32;186
"2775";"360470794002";22;7;48;28;9;114
"2776";"360470796011";35;94;37;4;21;191
"2777";"360470796012";109;16;65;1;14;205
"2778";"360470796021";132;91;60;4;24;311
"2779";"360470796022";70;146;50;3;29;298
"2780";"360470798011";29;75;67;2;7;180
"2781";"360470798012";70;28;88;4;35;225
"2782";"360470798021";74;61;28;1;25;189
"2783";"360470798022";141;215;6;3;26;391
"2784";"360470798023";138;263;11;24;21;457
"2785";"360470800001";197;184;36;1;22;440
"2786";"360470800002";34;41;58;14;16;163
"2787";"360470800003";28;11;29;8;14;90
"2788";"360470802001";154;41;65;31;14;305
"2789";"360470802002";96;92;41;2;18;249
"2790";"360470802003";137;19;38;4;8;206
"2791";"360470804001";34;67;55;8;10;174
"2792";"360470804002";119;42;21;3;6;191
"2793";"360470804003";9;43;73;10;20;155
"2794";"360470806001";34;20;55;11;19;139
"2795";"360470806002";22;9;68;7;33;139
"2796";"360470808001";24;16;33;18;17;108
"2797";"360470810001";41;140;85;10;9;285
"2798";"360470810002";7;8;60;4;0;79
"2799";"360470814001";34;5;48;6;5;98
"2800";"360470814002";100;36;96;11;7;250
"2801";"360470816001";17;4;89;4;15;129
"2802";"360470816002";54;17;51;6;9;137
"2803";"360470818001";103;87;60;4;21;275
"2804";"360470818002";22;3;48;3;12;88
"2805";"360470818003";67;91;73;10;8;249
"2806";"360470820001";99;21;76;4;18;218
"2807";"360470820002";131;41;70;4;15;261
"2808";"360470820003";180;28;61;3;8;280
"2809";"360470822001";28;17;94;2;7;148
"2810";"360470822002";210;153;36;3;12;414
"2811";"360470822003";219;106;97;7;9;438
"2812";"360470822004";42;14;75;5;16;152
"2813";"360470824001";43;14;87;7;6;157
"2814";"360470824002";15;12;19;3;8;57
"2815";"360470824003";33;5;64;38;8;148
"2816";"360470824004";14;15;89;11;17;146
"2817";"360470826001";28;10;54;16;10;118
"2818";"360470826002";21;26;101;30;19;197
"2819";"360470826003";173;86;67;25;18;369
"2820";"360470826004";58;38;43;16;13;168
"2821";"360470828001";37;18;18;9;12;94
"2822";"360470828002";44;61;70;15;27;217
"2823";"360470828003";78;85;146;15;29;353
"2824";"360470830001";56;6;151;19;8;240
"2825";"360470830002";12;4;62;32;7;117
"2826";"360470830003";53;0;26;0;2;81
"2827";"360470830004";46;1;3;0;3;53
"2828";"360470832001";25;5;56;15;12;113
"2829";"360470832002";7;3;50;22;10;92
"2830";"360470834001";34;1;28;13;9;85
"2831";"360470834002";16;1;30;7;5;59
"2832";"360470836001";24;3;33;20;8;88
"2833";"360470836002";15;8;53;28;9;113
"2834";"360470838001";23;11;49;17;6;106
"2835";"360470838002";31;4;43;21;14;113
"2836";"360470840001";24;26;88;59;8;205
"2837";"360470840002";4;4;67;56;6;137
"2838";"360470846001";25;21;56;76;13;191
"2839";"360470846002";60;5;67;50;13;195
"2840";"360470848001";13;1;50;21;4;89
"2841";"360470848002";9;2;49;17;5;82
"2842";"360470850001";13;1;58;67;13;152
"2843";"360470852001";2;8;2;0;0;12
"2844";"360470854001";41;8;39;22;4;114
"2845";"360470854002";32;2;59;22;5;120
"2846";"360470856001";52;27;26;11;13;129
"2847";"360470856002";25;11;29;26;11;102
"2848";"360470856003";43;30;78;11;7;169
"2849";"360470858001";17;10;21;21;8;77
"2850";"360470858002";96;115;53;21;10;295
"2851";"360470860001";35;11;46;7;15;114
"2852";"360470860002";14;6;93;1;21;135
"2853";"360470860003";9;5;14;10;29;67
"2854";"360470862001";41;3;39;0;1;84
"2855";"360470862002";18;10;75;7;13;123
"2856";"360470862003";29;3;26;11;5;74
"2857";"360470864001";65;12;82;42;12;213
"2858";"360470864002";9;11;45;16;10;91
"2859";"360470866001";33;12;107;17;8;177
"2860";"360470866002";38;23;51;16;3;131
"2861";"360470866003";45;9;23;7;7;91
"2862";"360470868001";46;18;42;12;14;132
"2863";"360470868002";26;40;90;30;10;196
"2864";"360470868003";94;21;48;30;23;216
"2865";"360470870001";7;6;33;8;2;56
"2866";"360470870002";15;30;76;9;9;139
"2867";"360470870003";12;4;34;6;6;62
"2868";"360470872001";7;11;40;13;1;72
"2869";"360470872002";17;1;26;6;5;55
"2870";"360470872003";24;6;34;11;13;88
"2871";"360470874011";20;71;133;33;6;263
"2872";"360470874012";41;11;26;12;10;100
"2873";"360470876001";23;72;55;21;4;175
"2874";"360470876002";31;4;38;18;3;94
"2875";"360470878001";7;4;28;20;10;69
"2876";"360470878002";0;0;6;1;12;19
"2877";"360470878003";11;13;38;7;21;90
"2878";"360470880001";16;12;66;26;13;133
"2879";"360470880002";5;4;1;3;0;13
"2880";"360470880003";62;14;39;15;5;135
"2881";"360470882001";77;16;73;2;6;174
"2882";"360470882002";24;17;30;6;17;94
"2883";"360470882003";25;10;22;6;9;72
"2884";"360470882004";14;15;60;20;12;121
"2885";"360470884001";55;21;55;13;10;154
"2886";"360470884002";33;19;62;15;13;142
"2887";"360470884003";61;18;69;5;16;169
"2888";"360470886001";37;2;54;4;5;102
"2889";"360470886002";80;15;72;6;8;181
"2890";"360470886003";45;9;116;36;18;224
"2891";"360470888001";43;5;80;2;17;147
"2892";"360470888002";8;2;71;17;10;108
"2893";"360470888003";18;6;54;46;9;133
"2894";"360470890001";25;3;59;3;4;94
"2895";"360470890002";44;9;38;3;7;101
"2896";"360470890003";22;2;21;11;5;61
"2897";"360470890004";39;4;48;2;14;107
"2898";"360470890005";11;3;41;1;7;63
"2899";"360470890006";21;1;9;0;8;39
"2900";"360470892001";35;9;25;4;7;80
"2901";"360470892002";34;39;28;2;17;120
"2902";"360470892003";72;16;6;2;9;105
"2903";"360470892004";9;0;4;8;7;28
"2904";"360470894001";13;3;11;9;4;40
"2905";"360470894002";31;6;34;4;6;81
"2906";"360470894003";14;2;13;0;12;41
"2907";"360470894004";55;17;53;11;6;142
"2908";"360470896001";17;6;50;14;12;99
"2909";"360470896002";120;15;80;18;17;250
"2910";"360470896003";44;1;41;17;11;114
"2911";"360470898001";10;2;18;15;5;50
"2912";"360470898002";25;4;77;18;15;139
"2913";"360470900001";4;0;15;1;2;22
"2914";"360470900002";7;3;5;2;5;22
"2915";"360470900003";27;15;10;3;12;67
"2916";"360470900004";4;6;42;10;4;66
"2917";"360470900005";25;2;12;11;7;57
"2918";"360470900006";35;24;19;2;2;82
"2919";"360470900007";20;2;3;0;1;26
"2920";"360470902001";38;6;2;3;8;57
"2921";"360470902002";7;0;6;0;1;14
"2922";"360470902003";5;6;24;2;1;38
"2923";"360470902004";34;7;29;6;9;85
"2924";"360470902005";6;1;29;6;7;49
"2925";"360470906001";10;4;3;4;9;30
"2926";"360470906002";38;12;27;51;20;148
"2927";"360470906003";34;3;5;0;4;46
"2928";"360470908001";50;29;89;57;34;259
"2929";"360470908002";9;1;2;0;3;15
"2930";"360470908003";10;3;5;0;11;29
"2931";"360470910001";31;36;1;0;4;72
"2932";"360470910002";67;15;4;1;2;89
"2933";"360470910003";26;1;2;0;1;30
"2934";"360470910004";4;5;28;4;5;46
"2935";"360470912001";61;7;4;4;5;81
"2936";"360470912002";47;15;2;2;2;68
"2937";"360470912003";78;5;5;1;3;92
"2938";"360470916001";8;5;10;2;3;28
"2939";"360470916002";25;10;27;5;3;70
"2940";"360470916003";10;2;29;10;6;57
"2941";"360470916004";32;11;44;8;6;101
"2942";"360470918001";16;6;12;5;8;47
"2943";"360470918002";21;2;43;7;4;77
"2944";"360470920001";5;12;10;6;4;37
"2945";"360470920002";93;15;26;10;7;151
"2946";"360470920003";10;3;42;34;56;145
"2947";"360470922001";36;9;45;13;8;111
"2948";"360470922002";11;4;55;35;4;109
"2949";"360470924001";24;10;28;5;31;98
"2950";"360470924002";17;8;43;11;9;88
"2951";"360470924003";6;2;22;9;4;43
"2952";"360470928001";24;6;80;17;4;131
"2953";"360470928002";33;1;83;93;12;222
"2954";"360470930001";11;3;52;11;2;79
"2955";"360470930002";18;1;94;68;6;187
"2956";"360470932001";18;1;152;121;14;306
"2957";"360470934001";11;7;52;26;8;104
"2958";"360470934002";10;16;38;47;11;122
"2959";"360470936001";28;2;22;14;6;72
"2960";"360470936002";77;5;19;14;5;120
"2961";"360470938001";16;3;26;3;6;54
"2962";"360470938002";12;0;47;15;12;86
"2963";"360470944011";7;4;17;98;1;127
"2964";"360470944012";12;10;41;42;5;110
"2965";"360470944013";34;15;61;55;4;169
"2966";"360470944014";13;8;11;15;3;50
"2967";"360470944021";58;34;13;4;11;120
"2968";"360470946001";5;1;22;8;6;42
"2969";"360470946002";1;3;10;6;4;24
"2970";"360470946003";14;4;57;141;3;219
"2971";"360470950001";51;11;74;14;11;161
"2972";"360470950002";14;3;60;51;2;130
"2973";"360470954001";2;3;39;24;8;76
"2974";"360470954002";14;5;40;10;12;81
"2975";"360470954003";35;7;70;16;5;133
"2976";"360470956001";23;4;47;27;5;106
"2977";"360470956002";54;2;142;25;10;233
"2978";"360470958001";23;6;47;35;4;115
"2979";"360470958002";19;3;210;47;19;298
"2980";"360470960001";3;10;60;121;6;200
"2981";"360470962001";33;5;73;55;4;170
"2982";"360470964001";34;6;55;72;8;175
"2983";"360470964002";49;24;97;66;5;241
"2984";"360470966001";12;1;75;19;15;122
"2985";"360470966002";36;2;49;11;7;105
"2986";"360470968001";33;47;33;23;9;145
"2987";"360470968002";19;0;69;22;7;117
"2988";"360470970001";37;1;39;28;5;110
"2989";"360470970002";28;1;63;38;2;132
"2990";"360470974001";25;4;45;21;15;110
"2991";"360470974002";33;19;106;7;13;178
"2992";"360470982001";106;16;8;10;4;144
"2993";"360470982002";54;22;3;9;6;94
"2994";"360470984001";32;6;77;43;14;172
"2995";"360470986001";13;5;36;9;20;83
"2996";"360470986002";21;0;45;9;8;83
"2997";"360470988001";62;4;27;6;10;109
"2998";"360470988002";14;1;37;2;4;58
"2999";"360470990001";48;24;75;18;8;173
"3000";"360470992001";25;19;121;38;17;220
"3001";"360470994001";36;8;104;84;15;247
"3002";"360470996001";34;3;119;25;5;186
"3003";"360470996002";18;5;75;21;11;130
"3004";"360470998001";61;3;169;27;10;270
"3005";"360470998002";20;7;123;12;7;169
"3006";"360471004001";14;1;83;30;3;131
"3007";"360471006001";8;2;97;17;14;138
"3008";"360471006002";25;3;59;52;7;146
"3009";"360471008001";19;6;45;35;1;106
"3010";"360471008002";10;1;79;54;4;148
"3011";"360471010001";36;25;49;14;5;129
"3012";"360471010002";13;2;78;61;5;159
"3013";"360471012001";4;2;62;27;8;103
"3014";"360471012002";11;9;64;19;4;107
"3015";"360471014001";43;3;24;20;8;98
"3016";"360471014002";11;5;9;10;4;39
"3017";"360471016001";25;1;36;45;6;113
"3018";"360471018001";35;3;13;12;5;68
"3019";"360471020001";31;6;50;49;12;148
"3020";"360471022001";41;6;115;65;23;250
"3021";"360471024001";23;5;81;54;8;171
"3022";"360471026001";70;7;180;35;22;314
"3023";"360471028001";15;13;79;33;5;145
"3024";"360471028002";1;2;53;22;8;86
"3025";"360471034001";178;25;32;20;5;260
"3026";"360471058011";1;0;2;1;4;8
"3027";"360471058012";4;1;23;13;0;41
"3028";"360471058013";9;1;1;4;6;21
"3029";"360471058041";5;0;49;3;0;57
"3030";"360471058042";2;0;4;5;1;12
"3031";"360471058043";3;1;6;2;1;13
"3032";"360471058044";21;1;21;1;2;46
"3033";"360471070001";63;22;69;92;8;254
"3034";"360471078001";10;10;52;12;9;93
"3035";"360471078002";4;22;9;26;5;66
"3036";"360471078003";2;2;31;5;2;42
"3037";"360471078004";4;3;4;17;1;29
"3038";"360471098001";111;11;100;41;11;274
"3039";"360471098002";12;5;118;102;27;264
"3040";"360471104001";15;11;101;75;20;222
"3041";"360471104002";34;7;38;57;10;146
"3042";"360471104003";26;5;45;12;8;96
"3043";"360471104004";9;0;32;20;13;74
"3044";"360471106001";117;6;2;2;1;128
"3045";"360471106002";67;2;0;9;7;85
"3046";"360471110001";141;31;5;8;41;226
"3047";"360471110002";82;8;1;1;1;93
"3048";"360471116001";30;11;64;8;6;119
"3049";"360471116002";20;15;79;46;30;190
"3050";"360471118001";51;8;35;57;15;166
"3051";"360471118002";41;12;72;31;14;170
"3052";"360471120001";15;8;26;12;14;75
"3053";"360471120002";24;9;61;20;23;137
"3054";"360471122001";79;20;85;14;23;221
"3055";"360471122002";24;16;66;6;17;129
"3056";"360471124001";11;3;30;22;10;76
"3057";"360471124002";16;5;23;20;27;91
"3058";"360471124003";27;2;16;13;16;74
"3059";"360471126001";33;1;5;19;9;67
"3060";"360471126002";19;2;17;4;12;54
"3061";"360471126003";21;6;42;15;66;150
"3062";"360471128001";24;2;53;16;29;124
"3063";"360471128002";44;9;17;8;33;111
"3064";"360471128003";97;17;58;22;20;214
"3065";"360471130001";6;1;14;4;1;26
"3066";"360471130002";36;6;26;2;3;73
"3067";"360471130003";80;3;21;6;5;115
"3068";"360471130004";12;4;55;26;9;106
"3069";"360471132001";16;8;47;6;11;88
"3070";"360471132002";15;4;61;38;5;123
"3071";"360471134001";9;1;13;1;5;29
"3072";"360471134002";34;18;4;0;2;58
"3073";"360471134003";11;4;6;4;16;41
"3074";"360471142011";12;2;108;34;8;164
"3075";"360471142012";9;10;223;124;20;386
"3076";"360471142021";34;14;160;14;19;241
"3077";"360471142022";38;4;28;7;7;84
"3078";"360471144001";29;5;71;47;35;187
"3079";"360471144002";26;2;23;23;16;90
"3080";"360471144003";5;1;18;16;7;47
"3081";"360471144004";18;3;8;7;2;38
"3082";"360471146001";78;54;81;26;25;264
"3083";"360471146002";22;121;104;43;27;317
"3084";"360471150001";49;6;35;15;26;131
"3085";"360471150002";15;6;47;23;6;97
"3086";"360471150003";14;4;57;13;14;102
"3087";"360471152001";17;5;70;68;12;172
"3088";"360471152002";40;9;66;25;14;154
"3089";"360471152003";90;12;18;9;25;154
"3090";"360471156001";23;3;42;5;11;84
"3091";"360471156002";96;5;7;2;2;112
"3092";"360471156003";34;7;2;5;0;48
"3093";"360471156004";7;2;13;10;4;36
"3094";"360471158001";23;4;33;7;14;81
"3095";"360471158002";29;12;13;6;8;68
"3096";"360471158003";36;10;12;2;44;104
"3097";"360471160001";9;7;6;11;4;37
"3098";"360471160002";20;5;6;8;4;43
"3099";"360471160003";71;18;22;24;7;142
"3100";"360471162001";22;5;13;3;19;62
"3101";"360471162002";4;1;14;9;6;34
"3102";"360471162003";4;0;62;8;3;77
"3103";"360471164001";12;5;25;24;8;74
"3104";"360471164002";3;3;32;5;3;46
"3105";"360471164003";18;3;32;8;8;69
"3106";"360471166001";12;5;37;11;17;82
"3107";"360471166002";31;8;49;11;9;108
"3108";"360471166003";19;9;24;22;21;95
"3109";"360471168001";22;15;67;56;20;180
"3110";"360471168002";20;3;95;38;27;183
"3111";"360471170001";25;50;47;11;11;144
"3112";"360471170002";74;47;48;40;31;240
"3113";"360471172011";67;19;173;29;14;302
"3114";"360471172012";113;11;60;12;16;212
"3115";"360471172021";15;4;86;15;15;135
"3116";"360471172022";78;27;78;24;22;229
"3117";"360471174001";255;217;158;105;38;773
"3118";"360471174002";24;40;113;35;126;338
"3119";"360471176011";144;45;116;31;79;415
"3120";"360471176012";79;53;51;7;30;220
"3121";"360471176021";77;40;230;51;24;422
"3122";"360471176022";82;33;96;15;39;265
"3123";"360471178001";48;20;106;38;40;252
"3124";"360471180001";4;37;41;46;18;146
"3125";"360471182011";47;27;196;7;14;291
"3126";"360471182012";28;16;94;10;23;171
"3127";"360471182021";79;62;118;8;15;282
"3128";"360471182022";19;43;134;17;23;236
"3129";"360471184001";49;41;101;24;17;232
"3130";"360471184002";42;73;54;34;39;242
"3131";"360471184003";30;18;45;12;21;126
"3132";"360471186001";27;9;326;22;6;390
"3133";"360471186002";15;16;47;49;22;149
"3134";"360471188001";171;114;60;3;31;379
"3135";"360471188002";43;25;18;8;41;135
"3136";"360471188003";19;3;44;3;35;104
"3137";"360471190001";43;11;124;24;15;217
"3138";"360471190002";25;1;50;12;47;135
"3139";"360471192001";102;49;157;55;23;386
"3140";"360471192002";47;18;43;16;22;146
"3141";"360471192003";41;17;175;60;11;304
"3142";"360471194001";26;6;27;9;27;95
"3143";"360471194002";27;7;103;12;13;162
"3144";"360471194003";56;9;95;24;18;202
"3145";"360471196001";30;7;103;32;17;189
"3146";"360471196002";7;2;46;15;33;103
"3147";"360471196003";34;3;81;10;32;160
"3148";"360471196004";19;4;109;21;19;172
"3149";"360471198001";15;7;66;31;25;144
"3150";"360471198002";10;20;52;28;23;133
"3151";"360471198003";13;9;114;108;53;297
"3152";"360471200001";9;2;34;27;19;91
"3153";"360471200002";24;5;92;7;12;140
"3154";"360471202001";26;11;25;11;15;88
"3155";"360471202002";23;35;14;5;13;90
"3156";"360471208001";19;0;75;20;15;129
"3157";"360471208002";87;13;157;35;20;312
"3158";"360471208003";7;4;1;5;3;20
"3159";"360471208004";4;0;2;5;2;13
"3160";"360471208005";30;6;57;60;7;160
"3161";"360471210001";83;2;0;0;0;85
"3162";"360471210002";14;0;0;0;0;14
"3163";"360471214001";23;6;5;5;1;40
"3164";"360471214002";29;3;7;6;3;48
"3165";"360471220001";65;38;108;147;17;375
"3166";"360471220002";173;32;138;92;30;465
"3167";"360471237001";12;28;86;9;19;154
"3168";"360471237002";11;5;58;13;16;103
"3169";"360471237003";23;16;84;10;29;162
"3170";"360471502001";5;2;32;5;3;47
"3171";"360471502002";3;6;28;8;8;53
"3172";"360471502003";14;8;44;30;16;112
"3173";"360471522001";24;9;73;71;20;197
"3174";"360471522002";14;8;309;35;45;411
"3175";"360471522003";6;10;93;24;16;149
"3176";"360594043002";2;0;0;0;0;2
"3177";"360594103004";10;0;1;0;0;11
"3178";"360610001001";0;0;1;0;1;2
"3179";"360610002011";82;10;7;3;2;104
"3180";"360610002012";53;28;13;3;4;101
"3181";"360610002020";0;0;0;1;0;1
"3182";"360610002021";33;10;8;0;18;69
"3183";"360610002022";13;10;11;0;13;47
"3184";"360610002023";239;47;3;1;8;298
"3185";"360610002024";128;15;3;1;6;153
"3186";"360610002025";22;25;11;6;8;72
"3187";"360610005001";0;2;0;0;0;2
"3188";"360610006001";15;81;19;3;41;159
"3189";"360610006002";98;43;60;7;7;215
"3190";"360610006003";26;40;23;15;34;138
"3191";"360610006004";18;16;10;0;16;60
"3192";"360610006005";27;24;27;4;1;83
"3193";"360610006006";11;41;85;0;1;138
"3194";"360610007001";83;202;121;8;138;552
"3195";"360610008001";11;10;31;7;23;82
"3196";"360610008002";34;5;14;1;25;79
"3197";"360610008003";24;7;14;2;24;71
"3198";"360610008004";1;3;3;0;9;16
"3199";"360610008005";2;13;11;0;10;36
"3200";"360610008006";23;94;33;4;49;203
"3201";"360610009001";27;133;168;5;94;427
"3202";"360610010011";20;7;15;4;5;51
"3203";"360610010021";39;0;0;0;1;40
"3204";"360610010022";5;0;4;0;0;9
"3205";"360610010023";79;4;26;3;7;119
"3206";"360610012001";116;18;9;6;16;165
"3207";"360610012002";13;4;4;3;10;34
"3208";"360610012003";28;9;13;0;4;54
"3209";"360610013001";8;29;54;8;72;171
"3210";"360610013002";37;57;102;6;106;308
"3211";"360610014011";4;101;27;0;12;144
"3212";"360610014012";3;26;16;0;8;53
"3213";"360610014021";64;86;24;4;34;212
"3214";"360610014022";76;162;14;1;64;317
"3215";"360610015010";0;0;0;0;1;1
"3216";"360610015011";15;134;102;6;74;331
"3217";"360610015012";10;10;59;3;22;104
"3218";"360610015013";26;29;35;1;17;108
"3219";"360610015020";0;1;0;0;0;1
"3220";"360610015021";67;94;195;3;195;554
"3221";"360610015022";17;94;81;5;58;255
"3222";"360610016001";22;63;92;5;38;220
"3223";"360610016002";8;7;0;2;29;46
"3224";"360610016003";8;81;24;1;28;142
"3225";"360610016004";98;37;6;1;83;225
"3226";"360610016005";47;370;160;7;104;688
"3227";"360610018001";177;51;6;1;59;294
"3228";"360610018002";19;84;9;5;100;217
"3229";"360610018003";66;300;13;4;96;479
"3230";"360610018004";9;39;6;3;17;74
"3231";"360610018005";13;82;13;2;67;177
"3232";"360610018006";21;139;2;2;32;196
"3233";"360610018007";45;249;5;4;39;342
"3234";"360610020001";37;3;4;3;0;47
"3235";"360610020002";45;13;3;0;4;65
"3236";"360610020003";47;13;32;1;0;93
"3237";"360610021001";189;64;93;10;150;506
"3238";"360610021002";19;77;47;10;60;213
"3239";"360610022011";252;84;7;5;27;375
"3240";"360610022012";33;70;22;2;37;164
"3241";"360610022013";171;4;1;0;11;187
"3242";"360610022014";7;0;2;3;4;16
"3243";"360610022021";294;293;23;9;55;674
"3244";"360610024000";0;1;0;0;0;1
"3245";"360610024001";217;37;6;1;12;273
"3246";"360610024002";73;21;4;1;2;101
"3247";"360610025001";70;14;14;2;16;116
"3248";"360610025002";42;3;8;1;10;64
"3249";"360610025003";47;2;4;0;4;57
"3250";"360610026011";153;96;13;18;28;308
"3251";"360610026012";133;128;29;14;24;328
"3252";"360610026021";87;30;52;15;18;202
"3253";"360610026022";221;101;20;12;26;380
"3254";"360610027001";6;30;169;7;12;224
"3255";"360610028001";15;10;5;0;7;37
"3256";"360610028002";36;9;21;5;17;88
"3257";"360610028003";95;208;7;7;30;347
"3258";"360610028004";30;45;20;12;32;139
"3259";"360610029001";7;14;48;3;30;102
"3260";"360610029002";2;8;14;0;17;41
"3261";"360610029003";15;52;8;1;11;87
"3262";"360610029004";2;15;55;7;13;92
"3263";"360610030011";60;213;11;1;49;334
"3264";"360610030012";48;243;7;5;85;388
"3265";"360610030013";113;46;25;6;42;232
"3266";"360610030014";140;100;12;8;33;293
"3267";"360610030021";69;73;13;7;41;203
"3268";"360610030022";101;223;10;6;64;404
"3269";"360610031001";26;135;200;4;97;462
"3270";"360610032001";151;239;48;12;61;511
"3271";"360610032002";56;130;9;2;39;236
"3272";"360610032003";10;53;31;3;45;142
"3273";"360610032004";18;21;10;3;11;63
"3274";"360610032005";36;70;12;5;17;140
"3275";"360610032006";165;137;7;17;45;371
"3276";"360610032007";41;98;8;12;19;178
"3277";"360610033001";48;86;90;9;105;338
"3278";"360610033002";28;20;42;6;26;122
"3279";"360610033003";11;63;84;2;20;180
"3280";"360610034001";71;148;36;2;42;299
"3281";"360610034002";177;237;42;11;34;501
"3282";"360610034003";109;213;64;17;60;463
"3283";"360610034004";97;56;35;6;121;315
"3284";"360610036011";6;47;1;1;7;62
"3285";"360610036012";61;159;9;2;30;261
"3286";"360610036013";34;174;13;1;44;266
"3287";"360610036021";37;79;19;1;43;179
"3288";"360610036022";30;85;22;11;37;185
"3289";"360610037001";11;164;77;2;22;276
"3290";"360610037002";10;14;142;6;31;203
"3291";"360610037003";16;57;59;2;49;183
"3292";"360610038001";90;253;22;14;75;454
"3293";"360610038002";11;10;1;2;14;38
"3294";"360610038003";49;55;23;7;38;172
"3295";"360610038004";37;91;2;10;25;165
"3296";"360610038005";49;17;8;5;25;104
"3297";"360610038006";39;30;4;2;16;91
"3298";"360610038007";78;62;11;6;37;194
"3299";"360610039001";33;1321;50;3;22;1429
"3300";"360610039002";18;13;9;0;17;57
"3301";"360610039003";2;0;3;0;1;6
"3302";"360610039004";19;37;26;8;47;137
"3303";"360610040001";82;63;5;9;62;221
"3304";"360610040002";31;7;5;7;10;60
"3305";"360610040003";21;62;9;3;29;124
"3306";"360610040004";52;23;2;2;13;92
"3307";"360610040005";69;58;9;6;21;163
"3308";"360610040006";56;62;27;4;46;195
"3309";"360610041001";30;31;4;3;35;103
"3310";"360610041002";31;10;6;1;22;70
"3311";"360610041003";25;32;16;0;15;88
"3312";"360610041004";48;66;3;2;8;127
"3313";"360610041005";6;25;24;1;23;79
"3314";"360610041006";23;59;7;1;23;113
"3315";"360610042001";36;49;29;9;66;189
"3316";"360610042002";44;34;16;5;22;121
"3317";"360610043001";45;113;14;10;71;253
"3318";"360610043002";17;100;3;1;38;159
"3319";"360610043003";58;86;48;16;63;271
"3320";"360610044001";5;15;17;1;7;45
"3321";"360610044002";9;3;10;1;1;24
"3322";"360610044003";0;1;5;0;1;7
"3323";"360610044004";14;2;6;0;27;49
"3324";"360610044005";6;0;10;0;2;18
"3325";"360610044006";6;2;1;1;2;12
"3326";"360610044007";5;1;12;0;32;50
"3327";"360610044008";6;2;4;0;9;21
"3328";"360610045001";81;165;35;2;85;368
"3329";"360610047001";53;84;8;0;16;161
"3330";"360610047002";73;177;31;8;89;378
"3331";"360610048001";4;4;8;1;8;25
"3332";"360610048002";5;8;6;0;4;23
"3333";"360610048003";1;22;4;1;8;36
"3334";"360610048004";54;46;26;1;29;156
"3335";"360610048005";50;21;13;1;20;105
"3336";"360610048006";62;8;4;1;14;89
"3337";"360610048007";1;5;1;0;6;13
"3338";"360610049001";81;277;40;2;78;478
"3339";"360610049002";50;88;7;7;31;183
"3340";"360610049003";48;87;4;3;27;169
"3341";"360610050001";5;28;16;0;13;62
"3342";"360610050002";19;51;17;2;32;121
"3343";"360610050003";9;26;20;3;93;151
"3344";"360610050004";5;20;11;1;128;165
"3345";"360610050005";34;33;4;1;28;100
"3346";"360610052001";17;102;18;0;152;289
"3347";"360610052002";44;199;52;5;149;449
"3348";"360610054001";36;90;27;14;100;267
"3349";"360610054002";5;6;30;1;17;59
"3350";"360610054003";7;17;5;2;22;53
"3351";"360610055011";20;220;21;2;37;300
"3352";"360610055012";2;8;14;0;9;33
"3353";"360610055013";8;11;10;2;9;40
"3354";"360610055021";40;58;6;4;17;125
"3355";"360610055022";51;122;49;9;62;293
"3356";"360610056001";45;51;24;2;60;182
"3357";"360610056002";9;72;20;0;94;195
"3358";"360610056003";12;20;2;0;17;51
"3359";"360610057001";3;23;11;1;21;59
"3360";"360610057002";25;100;13;4;87;229
"3361";"360610058001";32;199;45;5;174;455
"3362";"360610059001";18;6;2;0;23;49
"3363";"360610059002";3;76;3;1;3;86
"3364";"360610059003";44;56;2;4;38;144
"3365";"360610059004";3;4;2;0;9;18
"3366";"360610059005";6;23;3;1;10;43
"3367";"360610060001";127;2;8;0;6;143
"3368";"360610060002";2;7;3;0;14;26
"3369";"360610060003";0;1;1;0;2;4
"3370";"360610061001";34;63;22;4;54;177
"3371";"360610061002";15;12;7;3;22;59
"3372";"360610061003";14;120;60;8;153;355
"3373";"360610062001";3;20;25;4;56;108
"3374";"360610062002";4;6;7;1;2;20
"3375";"360610063001";17;26;13;4;47;107
"3376";"360610063002";23;22;14;3;17;79
"3377";"360610063003";22;26;21;3;22;94
"3378";"360610063004";5;15;1;0;12;33
"3379";"360610063005";4;27;3;2;13;49
"3380";"360610064001";16;26;14;4;37;97
"3381";"360610064002";258;13;7;0;5;283
"3382";"360610064003";2;13;9;1;3;28
"3383";"360610064004";26;15;17;1;27;86
"3384";"360610064005";31;10;8;0;17;66
"3385";"360610064006";1;7;11;0;18;37
"3386";"360610065001";31;85;9;6;51;182
"3387";"360610065002";44;144;13;2;29;232
"3388";"360610065003";13;81;4;4;50;152
"3389";"360610065004";43;135;1;1;103;283
"3390";"360610065005";44;106;20;0;18;188
"3391";"360610066001";79;39;8;0;34;160
"3392";"360610066002";22;40;4;1;51;118
"3393";"360610066003";43;23;6;0;112;184
"3394";"360610066004";10;5;12;2;20;49
"3395";"360610066005";15;108;2;2;8;135
"3396";"360610066006";3;1;10;0;6;20
"3397";"360610066007";8;2;5;0;6;21
"3398";"360610066008";88;19;18;1;62;188
"3399";"360610066009";6;7;3;1;27;44
"3400";"360610067001";48;83;6;3;41;181
"3401";"360610067002";29;90;33;4;41;197
"3402";"360610067003";23;18;10;6;21;78
"3403";"360610067004";57;14;9;7;24;111
"3404";"360610068001";12;52;19;1;31;115
"3405";"360610068002";4;55;8;0;25;92
"3406";"360610068003";12;57;12;1;12;94
"3407";"360610068004";186;25;11;3;15;240
"3408";"360610068005";14;25;10;1;11;61
"3409";"360610068006";34;51;6;0;18;109
"3410";"360610069001";21;134;59;6;36;256
"3411";"360610070001";48;91;8;2;32;181
"3412";"360610070002";41;132;14;1;132;320
"3413";"360610070003";48;20;22;2;38;130
"3414";"360610070004";5;21;10;0;13;49
"3415";"360610070005";1;1;14;0;5;21
"3416";"360610070006";28;9;8;0;16;61
"3417";"360610071001";4;4;2;0;38;48
"3418";"360610071002";10;7;4;4;56;81
"3419";"360610071003";6;39;6;7;45;103
"3420";"360610071004";57;29;13;9;10;118
"3421";"360610071005";15;67;6;2;49;139
"3422";"360610072001";8;4;9;0;7;28
"3423";"360610072002";42;20;60;2;78;202
"3424";"360610072003";26;38;9;3;42;118
"3425";"360610072004";35;52;6;5;59;157
"3426";"360610072005";8;8;11;0;23;50
"3427";"360610072006";13;7;0;0;30;50
"3428";"360610072007";8;5;5;0;24;42
"3429";"360610073001";25;12;8;8;7;60
"3430";"360610073002";24;39;1;2;18;84
"3431";"360610073003";33;72;13;5;10;133
"3432";"360610073004";101;60;5;5;29;200
"3433";"360610073005";17;7;58;2;2;86
"3434";"360610073006";38;63;10;6;17;134
"3435";"360610074001";14;49;22;1;110;196
"3436";"360610074002";10;25;12;0;35;82
"3437";"360610074003";28;106;35;8;83;260
"3438";"360610075001";14;30;37;1;21;103
"3439";"360610075002";27;19;17;7;16;86
"3440";"360610075003";30;22;9;11;10;82
"3441";"360610076001";19;67;50;2;272;410
"3442";"360610076002";19;51;58;7;109;244
"3443";"360610077001";49;149;12;7;70;287
"3444";"360610077002";36;29;3;4;9;81
"3445";"360610077003";34;103;17;12;50;216
"3446";"360610077004";20;36;12;0;23;91
"3447";"360610077005";14;10;2;3;13;42
"3448";"360610078001";8;49;4;0;8;69
"3449";"360610078002";14;149;7;3;13;186
"3450";"360610078003";6;34;1;0;7;48
"3451";"360610078004";23;49;14;2;24;112
"3452";"360610078005";16;26;2;0;20;64
"3453";"360610078006";16;45;1;0;9;71
"3454";"360610078007";11;38;4;0;2;55
"3455";"360610079001";11;115;46;0;59;231
"3456";"360610079002";6;14;10;1;3;34
"3457";"360610079003";18;24;24;8;29;103
"3458";"360610079004";3;16;4;0;17;40
"3459";"360610080001";10;79;10;2;43;144
"3460";"360610080002";7;33;27;4;66;137
"3461";"360610080003";27;3;25;10;9;74
"3462";"360610080004";8;7;12;2;7;36
"3463";"360610080005";6;7;23;0;11;47
"3464";"360610081001";18;16;4;3;29;70
"3465";"360610081002";24;20;15;4;15;78
"3466";"360610081003";7;14;24;0;25;70
"3467";"360610081004";12;35;15;16;90;168
"3468";"360610081005";29;6;15;7;18;75
"3469";"360610081006";20;22;8;3;28;81
"3470";"360610082001";20;54;30;2;108;214
"3471";"360610082002";9;23;41;0;60;133
"3472";"360610082003";4;12;9;0;9;34
"3473";"360610083001";14;35;28;4;25;106
"3474";"360610083002";13;30;14;3;9;69
"3475";"360610083003";53;46;46;3;24;172
"3476";"360610084001";0;10;18;0;45;73
"3477";"360610084002";12;126;57;5;150;350
"3478";"360610086010";0;0;0;0;3;3
"3479";"360610086011";5;7;9;1;27;49
"3480";"360610086012";8;8;11;0;34;61
"3481";"360610086021";0;6;6;0;32;44
"3482";"360610086030";0;0;1;0;0;1
"3483";"360610086031";3;5;6;2;2;18
"3484";"360610086032";0;6;8;1;6;21
"3485";"360610086033";2;7;9;0;1;19
"3486";"360610086034";26;5;10;2;6;49
"3487";"360610087001";29;61;20;2;25;137
"3488";"360610087002";29;29;8;4;9;79
"3489";"360610087003";9;8;9;0;10;36
"3490";"360610087004";20;65;8;5;16;114
"3491";"360610087005";19;9;4;0;11;43
"3492";"360610088001";20;33;47;1;43;144
"3493";"360610088002";15;54;7;7;11;94
"3494";"360610088003";3;10;14;3;5;35
"3495";"360610088004";1;12;2;0;4;19
"3496";"360610088005";0;2;14;0;8;24
"3497";"360610088006";2;5;3;0;3;13
"3498";"360610088007";4;1;4;0;5;14
"3499";"360610089001";33;26;6;6;3;74
"3500";"360610089002";15;30;15;6;13;79
"3501";"360610089003";63;17;16;2;13;111
"3502";"360610089004";27;7;8;0;13;55
"3503";"360610089005";12;4;4;6;13;39
"3504";"360610090001";61;24;169;0;25;279
"3505";"360610090002";35;6;29;0;7;77
"3506";"360610090003";2;111;179;1;7;300
"3507";"360610090004";8;23;16;1;7;55
"3508";"360610090005";12;11;6;0;5;34
"3509";"360610090006";7;3;3;0;8;21
"3510";"360610091001";59;65;22;3;103;252
"3511";"360610091002";39;29;7;2;30;107
"3512";"360610091003";12;3;4;0;39;58
"3513";"360610091004";28;44;4;3;37;116
"3514";"360610092001";19;18;49;2;272;360
"3515";"360610093001";4;7;10;8;7;36
"3516";"360610093002";10;69;12;4;65;160
"3517";"360610093003";3;11;10;7;11;42
"3518";"360610093004";18;4;2;0;5;29
"3519";"360610093005";26;13;4;1;6;50
"3520";"360610093006";44;44;2;0;5;95
"3521";"360610093007";21;8;2;5;6;42
"3522";"360610094001";1;150;56;4;514;725
"3523";"360610095001";49;133;46;5;123;356
"3524";"360610095002";18;18;30;4;52;122
"3525";"360610096001";10;233;117;3;491;854
"3526";"360610097001";5;4;21;3;20;53
"3527";"360610097002";103;15;16;4;27;165
"3528";"360610097003";1;0;2;0;1;4
"3529";"360610097004";283;12;6;2;11;314
"3530";"360610098001";5;17;4;0;19;45
"3531";"360610098002";22;74;5;1;10;112
"3532";"360610098003";31;25;19;3;15;93
"3533";"360610098004";8;4;27;1;4;44
"3534";"360610098005";13;7;1;1;6;28
"3535";"360610098006";47;48;72;2;13;182
"3536";"360610098007";15;8;36;0;15;74
"3537";"360610099001";81;255;223;14;164;737
"3538";"360610100001";5;17;22;3;101;148
"3539";"360610100002";13;26;18;2;68;127
"3540";"360610101001";19;98;49;0;331;497
"3541";"360610102001";8;25;68;1;175;277
"3542";"360610103001";82;25;85;1;57;250
"3543";"360610104001";13;46;98;1;259;417
"3544";"360610106011";8;5;9;1;7;30
"3545";"360610106012";34;4;19;0;8;65
"3546";"360610106013";3;8;5;0;2;18
"3547";"360610106014";1;8;2;0;3;14
"3548";"360610106015";3;1;1;0;3;8
"3549";"360610106016";0;3;42;0;5;50
"3550";"360610106021";7;17;4;1;14;43
"3551";"360610106022";4;57;13;3;34;111
"3552";"360610106023";2;12;14;0;6;34
"3553";"360610108001";4;78;4;0;4;90
"3554";"360610108002";4;5;6;1;2;18
"3555";"360610108003";2;19;2;0;7;30
"3556";"360610108004";1;1;4;0;1;7
"3557";"360610108005";46;13;7;0;7;73
"3558";"360610108006";8;22;8;0;17;55
"3559";"360610108007";5;16;10;1;29;61
"3560";"360610109001";7;152;49;2;364;574
"3561";"360610110001";5;17;2;2;2;28
"3562";"360610110002";7;9;10;0;6;32
"3563";"360610110003";33;50;24;2;22;131
"3564";"360610110004";4;47;5;2;10;68
"3565";"360610110005";7;48;3;1;5;64
"3566";"360610110006";28;23;20;7;32;110
"3567";"360610111001";60;47;26;0;69;202
"3568";"360610111002";10;16;8;1;18;53
"3569";"360610111003";53;8;21;0;27;109
"3570";"360610112011";4;11;40;3;83;141
"3571";"360610112021";0;12;25;0;57;94
"3572";"360610112031";2;8;6;0;112;128
"3573";"360610112032";1;3;6;0;30;40
"3574";"360610113001";12;150;115;4;840;1121
"3575";"360610114011";2;13;10;1;22;48
"3576";"360610114012";3;4;27;2;23;59
"3577";"360610114021";21;20;17;1;68;127
"3578";"360610114022";12;11;16;0;47;86
"3579";"360610115001";15;64;22;0;179;280
"3580";"360610115002";29;60;15;0;60;164
"3581";"360610116001";1;9;9;1;14;34
"3582";"360610116002";10;5;46;1;8;70
"3583";"360610116003";10;27;9;0;7;53
"3584";"360610117001";18;40;43;6;16;123
"3585";"360610118001";2;5;2;0;4;13
"3586";"360610118002";1;8;2;0;4;15
"3587";"360610118003";2;3;17;0;8;30
"3588";"360610118004";48;13;34;1;18;114
"3589";"360610118005";5;10;10;0;7;32
"3590";"360610118006";17;12;10;2;7;48
"3591";"360610118007";7;0;7;0;3;17
"3592";"360610118008";1;2;5;1;5;14
"3593";"360610119001";8;131;25;2;101;267
"3594";"360610119002";43;40;55;0;110;248
"3595";"360610120001";2;14;13;0;12;41
"3596";"360610120002";0;5;6;1;12;24
"3597";"360610120003";12;4;29;8;21;74
"3598";"360610120004";4;22;15;1;25;67
"3599";"360610121001";52;37;39;3;58;189
"3600";"360610121002";4;4;3;0;13;24
"3601";"360610121003";46;15;10;3;39;113
"3602";"360610121004";32;61;27;2;28;150
"3603";"360610121005";156;95;9;0;18;278
"3604";"360610121006";20;15;2;1;17;55
"3605";"360610122001";20;14;14;0;5;53
"3606";"360610122002";0;2;5;0;5;12
"3607";"360610122003";7;1;10;1;11;30
"3608";"360610122004";1;6;17;0;4;28
"3609";"360610124001";22;19;15;2;12;70
"3610";"360610124002";19;13;7;1;3;43
"3611";"360610124003";1;8;17;1;0;27
"3612";"360610124004";10;7;8;3;5;33
"3613";"360610124005";0;7;1;0;1;9
"3614";"360610124006";2;2;3;0;6;13
"3615";"360610124007";1;8;5;2;0;16
"3616";"360610124008";0;2;5;0;2;9
"3617";"360610125001";9;38;35;2;181;265
"3618";"360610125002";17;248;37;2;79;383
"3619";"360610126001";39;41;24;2;30;136
"3620";"360610126002";4;12;13;0;7;36
"3621";"360610126003";2;2;10;0;11;25
"3622";"360610126004";7;10;9;0;8;34
"3623";"360610126005";1;3;11;0;6;21
"3624";"360610126006";15;14;11;1;8;49
"3625";"360610126007";21;2;11;0;7;41
"3626";"360610126008";20;8;25;0;4;57
"3627";"360610127001";14;28;12;1;16;71
"3628";"360610127002";62;61;11;1;40;175
"3629";"360610127003";62;49;15;1;30;157
"3630";"360610127004";44;58;99;9;34;244
"3631";"360610127005";5;43;10;2;29;89
"3632";"360610128001";5;45;31;6;26;113
"3633";"360610128002";2;3;3;0;8;16
"3634";"360610128003";6;0;7;3;7;23
"3635";"360610128004";2;7;46;2;13;70
"3636";"360610128005";15;5;8;0;8;36
"3637";"360610129000";0;0;0;0;1;1
"3638";"360610129001";56;176;103;22;50;407
"3639";"360610129002";112;212;267;4;56;651
"3640";"360610130001";2;3;22;0;3;30
"3641";"360610130002";8;0;18;3;18;47
"3642";"360610130003";1;4;11;0;21;37
"3643";"360610130004";3;4;20;0;9;36
"3644";"360610131001";6;30;65;3;66;170
"3645";"360610131002";15;54;22;2;89;182
"3646";"360610132001";20;7;6;1;5;39
"3647";"360610132002";24;12;3;0;58;97
"3648";"360610132003";11;4;10;1;7;33
"3649";"360610132004";23;51;13;3;39;129
"3650";"360610132005";26;9;5;0;7;47
"3651";"360610132006";11;11;5;0;4;31
"3652";"360610132007";1;4;7;0;11;23
"3653";"360610133001";10;14;1;2;11;38
"3654";"360610133002";28;45;12;1;31;117
"3655";"360610133003";60;92;31;0;26;209
"3656";"360610133004";10;24;36;3;20;93
"3657";"360610133005";6;26;24;0;23;79
"3658";"360610134001";14;48;8;1;13;84
"3659";"360610134002";15;8;6;1;11;41
"3660";"360610134003";12;8;6;1;12;39
"3661";"360610134004";0;21;2;1;6;30
"3662";"360610134005";17;125;17;1;5;165
"3663";"360610134006";8;5;11;0;27;51
"3664";"360610134007";25;33;8;1;13;80
"3665";"360610134008";4;24;13;0;58;99
"3666";"360610134009";15;37;13;2;9;76
"3667";"360610135001";36;35;52;2;40;165
"3668";"360610135002";25;42;72;8;35;182
"3669";"360610136001";35;19;7;1;9;71
"3670";"360610136002";29;9;8;3;5;54
"3671";"360610136003";16;8;10;0;6;40
"3672";"360610136004";37;7;29;0;14;87
"3673";"360610136005";8;9;57;5;19;98
"3674";"360610136006";4;3;9;1;3;20
"3675";"360610136007";29;9;14;5;1;58
"3676";"360610136008";28;4;20;1;8;61
"3677";"360610137001";4;14;22;1;19;60
"3678";"360610137002";12;31;48;1;61;153
"3679";"360610137003";15;151;41;1;105;313
"3680";"360610137004";7;45;35;3;90;180
"3681";"360610137005";3;7;33;2;41;86
"3682";"360610137006";6;119;24;0;23;172
"3683";"360610138001";23;8;5;5;9;50
"3684";"360610138002";30;16;10;1;17;74
"3685";"360610138003";27;13;5;1;13;59
"3686";"360610138004";48;36;12;1;23;120
"3687";"360610138005";7;4;6;4;4;25
"3688";"360610138006";55;20;5;1;5;86
"3689";"360610138007";7;2;31;5;23;68
"3690";"360610138008";90;4;12;8;4;118
"3691";"360610138009";5;11;14;0;3;33
"3692";"360610139001";22;8;7;0;35;72
"3693";"360610139002";12;14;16;0;19;61
"3694";"360610139003";69;43;65;3;15;195
"3695";"360610139004";7;8;11;8;16;50
"3696";"360610139005";11;65;20;2;18;116
"3697";"360610139006";3;16;6;0;52;77
"3698";"360610139007";14;9;89;0;50;162
"3699";"360610140001";27;16;11;0;8;62
"3700";"360610140002";40;20;11;0;8;79
"3701";"360610140003";7;43;17;0;18;85
"3702";"360610140004";0;8;12;2;2;24
"3703";"360610140005";7;10;14;0;15;46
"3704";"360610140006";8;6;11;1;3;29
"3705";"360610142001";4;0;3;1;7;15
"3706";"360610142002";4;8;20;0;3;35
"3707";"360610142003";0;6;2;0;2;10
"3708";"360610142004";3;0;9;1;3;16
"3709";"360610142005";13;15;10;0;3;41
"3710";"360610142006";1;72;16;0;5;94
"3711";"360610143001";24;298;84;7;85;498
"3712";"360610144011";7;1;8;0;6;22
"3713";"360610144012";10;2;1;1;0;14
"3714";"360610144013";4;3;12;0;2;21
"3715";"360610144014";6;1;4;3;10;24
"3716";"360610144021";8;2;5;0;2;17
"3717";"360610144022";22;4;4;0;5;35
"3718";"360610144023";21;5;1;2;2;31
"3719";"360610144024";38;9;18;2;19;86
"3720";"360610144025";22;4;8;0;4;38
"3721";"360610145001";6;15;38;1;17;77
"3722";"360610145002";2;3;5;0;12;22
"3723";"360610145003";7;106;58;4;476;651
"3724";"360610145004";4;57;34;0;12;107
"3725";"360610146011";4;27;6;1;6;44
"3726";"360610146012";17;125;3;1;7;153
"3727";"360610146013";14;156;9;2;20;201
"3728";"360610146014";51;69;8;5;11;144
"3729";"360610146021";14;309;295;7;15;640
"3730";"360610146022";9;6;6;0;5;26
"3731";"360610146023";15;12;7;2;6;42
"3732";"360610146024";35;15;5;0;21;76
"3733";"360610146025";7;6;19;1;9;42
"3734";"360610146026";8;6;9;1;11;35
"3735";"360610147001";17;12;83;3;24;139
"3736";"360610148011";1;31;9;1;30;72
"3737";"360610148012";5;19;55;1;35;115
"3738";"360610148021";43;19;13;1;13;89
"3739";"360610148022";5;11;18;1;64;99
"3740";"360610148023";6;16;12;1;10;45
"3741";"360610148024";5;20;19;0;1;45
"3742";"360610148025";1;6;11;0;21;39
"3743";"360610149001";0;40;30;3;195;268
"3744";"360610149002";2;3;6;0;12;23
"3745";"360610149003";13;14;18;1;24;70
"3746";"360610149004";2;15;8;0;225;250
"3747";"360610149005";2;4;6;1;67;80
"3748";"360610150011";7;4;3;0;1;15
"3749";"360610150012";1;6;8;2;0;17
"3750";"360610150021";1;7;10;0;3;21
"3751";"360610150022";1;1;2;0;1;5
"3752";"360610150023";1;0;7;1;2;11
"3753";"360610150024";10;2;21;1;8;42
"3754";"360610151001";21;40;25;1;7;94
"3755";"360610151002";127;11;11;0;16;165
"3756";"360610151003";18;4;7;1;6;36
"3757";"360610151004";16;25;31;3;18;93
"3758";"360610152000";0;1;0;0;0;1
"3759";"360610152001";43;4;4;0;3;54
"3760";"360610152002";179;14;8;0;9;210
"3761";"360610152003";2;6;11;0;4;23
"3762";"360610152004";4;6;6;1;0;17
"3763";"360610152005";1;1;10;0;2;14
"3764";"360610152006";4;3;12;2;4;25
"3765";"360610153001";10;9;10;0;74;103
"3766";"360610153002";8;11;21;5;46;91
"3767";"360610153003";5;15;21;1;158;200
"3768";"360610153004";12;6;32;0;110;160
"3769";"360610153005";16;4;6;0;17;43
"3770";"360610153006";15;8;93;3;77;196
"3771";"360610153007";6;77;41;1;15;140
"3772";"360610154001";33;21;9;2;12;77
"3773";"360610154002";8;6;2;2;8;26
"3774";"360610154003";27;9;6;3;11;56
"3775";"360610154004";10;3;8;0;8;29
"3776";"360610154005";52;304;5;0;4;365
"3777";"360610154006";58;22;3;1;13;97
"3778";"360610154007";1;10;3;0;6;20
"3779";"360610154008";9;6;3;1;9;28
"3780";"360610154009";3;2;7;1;11;24
"3781";"360610155001";4;1;1;0;5;11
"3782";"360610155002";1;2;14;2;5;24
"3783";"360610155003";0;2;6;6;2;16
"3784";"360610155004";0;1;9;0;2;12
"3785";"360610155005";0;1;5;0;0;6
"3786";"360610155006";15;14;29;3;11;72
"3787";"360610156011";18;15;4;0;5;42
"3788";"360610156012";12;41;17;6;3;79
"3789";"360610156013";10;11;5;1;11;38
"3790";"360610156014";5;2;9;0;17;33
"3791";"360610156021";37;14;32;1;31;115
"3792";"360610157001";22;23;39;0;3;87
"3793";"360610157002";22;5;22;2;8;59
"3794";"360610157003";22;31;11;0;8;72
"3795";"360610157004";12;4;7;0;14;37
"3796";"360610157005";11;18;3;2;22;56
"3797";"360610157006";24;39;5;11;35;114
"3798";"360610157007";9;17;12;8;77;123
"3799";"360610157008";8;2;6;1;20;37
"3800";"360610158011";3;82;28;3;3;119
"3801";"360610158012";48;25;6;1;4;84
"3802";"360610158013";3;25;7;0;6;41
"3803";"360610158014";9;10;9;6;15;49
"3804";"360610158021";10;2;19;1;18;50
"3805";"360610158022";59;23;45;0;6;133
"3806";"360610159001";7;13;15;0;2;37
"3807";"360610159002";5;2;26;3;6;42
"3808";"360610159003";8;2;16;2;3;31
"3809";"360610159004";5;2;7;1;72;87
"3810";"360610159005";22;70;5;1;70;168
"3811";"360610159006";24;60;22;4;48;158
"3812";"360610159007";2;19;2;1;27;51
"3813";"360610160011";3;2;1;1;3;10
"3814";"360610160012";5;6;8;0;15;34
"3815";"360610160013";2;2;14;0;4;22
"3816";"360610160014";3;1;6;0;3;13
"3817";"360610160021";3;7;200;0;5;215
"3818";"360610160022";12;35;22;0;4;73
"3819";"360610161001";23;19;9;0;7;58
"3820";"360610161002";10;5;3;1;4;23
"3821";"360610161003";19;14;20;4;19;76
"3822";"360610161004";22;15;122;0;11;170
"3823";"360610161005";14;10;41;0;32;97
"3824";"360610161006";28;4;8;1;6;47
"3825";"360610162001";16;4;7;2;10;39
"3826";"360610162002";12;1;12;1;2;28
"3827";"360610162003";84;19;2;1;2;108
"3828";"360610162004";88;32;7;2;7;136
"3829";"360610162005";52;40;45;1;8;146
"3830";"360610163000";0;0;0;0;1;1
"3831";"360610163001";19;6;17;2;2;46
"3832";"360610163002";8;13;22;4;7;54
"3833";"360610163003";39;4;3;5;32;83
"3834";"360610163004";7;9;14;4;14;48
"3835";"360610163005";5;10;17;3;56;91
"3836";"360610164001";38;28;7;6;2;81
"3837";"360610164002";92;95;14;1;6;208
"3838";"360610164003";70;11;9;3;5;98
"3839";"360610164004";40;12;4;1;6;63
"3840";"360610165001";10;11;43;1;19;84
"3841";"360610165002";4;7;5;0;3;19
"3842";"360610165003";8;9;6;2;5;30
"3843";"360610165004";16;13;3;2;5;39
"3844";"360610165005";19;21;9;4;3;56
"3845";"360610166001";30;28;7;2;21;88
"3846";"360610166002";45;26;18;1;2;92
"3847";"360610166003";21;55;11;0;6;93
"3848";"360610166004";36;29;9;1;5;80
"3849";"360610166005";11;23;3;2;0;39
"3850";"360610166006";159;49;6;0;8;222
"3851";"360610167001";14;17;49;1;11;92
"3852";"360610167002";7;3;28;0;6;44
"3853";"360610167003";0;16;21;1;53;91
"3854";"360610167004";27;39;16;4;36;122
"3855";"360610167005";14;33;18;5;12;82
"3856";"360610168001";467;8;3;1;3;482
"3857";"360610168002";144;16;29;0;9;198
"3858";"360610168003";9;33;16;0;9;67
"3859";"360610169001";23;6;6;0;23;58
"3860";"360610169002";9;38;6;0;10;63
"3861";"360610169003";27;49;19;1;20;116
"3862";"360610169004";31;25;32;1;18;107
"3863";"360610169005";11;11;15;0;16;53
"3864";"360610169006";50;2;6;3;1;62
"3865";"360610170001";6;4;31;1;6;48
"3866";"360610170002";322;23;16;0;12;373
"3867";"360610170003";27;35;9;1;10;82
"3868";"360610170004";8;41;23;1;19;92
"3869";"360610170005";34;150;63;1;18;266
"3870";"360610171001";11;9;15;0;43;78
"3871";"360610171002";3;13;6;0;68;90
"3872";"360610171003";47;16;15;2;49;129
"3873";"360610171004";3;9;4;0;3;19
"3874";"360610171005";20;10;10;0;10;50
"3875";"360610171006";11;5;6;2;7;31
"3876";"360610172001";51;71;49;4;35;210
"3877";"360610172002";66;17;9;0;3;95
"3878";"360610172003";20;7;17;2;6;52
"3879";"360610172004";38;133;13;2;22;208
"3880";"360610172005";15;53;12;1;12;93
"3881";"360610173001";11;50;6;0;7;74
"3882";"360610173002";17;8;4;0;7;36
"3883";"360610173003";82;50;10;3;10;155
"3884";"360610173004";45;26;9;3;7;90
"3885";"360610173005";11;2;10;1;7;31
"3886";"360610173006";12;7;4;1;5;29
"3887";"360610173007";11;6;6;1;13;37
"3888";"360610174011";48;9;8;0;6;71
"3889";"360610174012";24;35;4;0;4;67
"3890";"360610174013";53;96;13;0;18;180
"3891";"360610174021";84;40;9;1;21;155
"3892";"360610175001";9;13;17;0;13;52
"3893";"360610175002";13;19;33;0;8;73
"3894";"360610175003";17;7;6;0;15;45
"3895";"360610175004";3;12;11;0;15;41
"3896";"360610175005";11;9;27;0;11;58
"3897";"360610175006";19;15;5;2;10;51
"3898";"360610175007";13;18;12;1;25;69
"3899";"360610177001";53;4;5;1;3;66
"3900";"360610177002";36;18;15;1;3;73
"3901";"360610177003";14;19;14;1;10;58
"3902";"360610177004";287;29;6;1;2;325
"3903";"360610177005";29;13;10;2;3;57
"3904";"360610177006";310;4;2;0;4;320
"3905";"360610177007";5;3;9;0;3;20
"3906";"360610177008";41;5;11;1;2;60
"3907";"360610178001";20;70;33;23;21;167
"3908";"360610178002";33;31;99;5;13;181
"3909";"360610178003";42;46;41;5;20;154
"3910";"360610179001";12;9;15;2;7;45
"3911";"360610179002";1;3;3;1;1;9
"3912";"360610179003";10;7;19;0;3;39
"3913";"360610179004";16;35;11;0;27;89
"3914";"360610179005";34;5;5;0;15;59
"3915";"360610179006";61;101;13;2;12;189
"3916";"360610179007";10;11;35;2;18;76
"3917";"360610180001";64;48;12;3;14;141
"3918";"360610180002";109;83;45;2;18;257
"3919";"360610180003";48;67;34;11;19;179
"3920";"360610180004";63;13;4;0;1;81
"3921";"360610181001";30;14;7;1;12;64
"3922";"360610181002";18;7;1;1;12;39
"3923";"360610181003";19;14;4;0;9;46
"3924";"360610181004";18;15;11;0;1;45
"3925";"360610181005";12;4;4;0;2;22
"3926";"360610181006";19;3;6;3;9;40
"3927";"360610182001";108;49;4;1;17;179
"3928";"360610182002";68;16;6;0;10;100
"3929";"360610182003";34;48;7;2;46;137
"3930";"360610182004";60;30;12;1;4;107
"3931";"360610182005";114;48;3;0;7;172
"3932";"360610183001";37;20;9;1;8;75
"3933";"360610183002";9;3;2;0;2;16
"3934";"360610183003";172;58;7;0;6;243
"3935";"360610183004";9;26;10;1;51;97
"3936";"360610183005";0;17;8;0;52;77
"3937";"360610183006";98;62;7;0;40;207
"3938";"360610183007";28;48;52;2;32;162
"3939";"360610184001";84;92;39;2;23;240
"3940";"360610184002";10;21;24;0;11;66
"3941";"360610184003";97;7;8;0;1;113
"3942";"360610184004";135;25;7;0;1;168
"3943";"360610185001";9;9;8;0;2;28
"3944";"360610185002";49;32;27;0;40;148
"3945";"360610185003";0;5;5;0;2;12
"3946";"360610186001";84;49;11;1;10;155
"3947";"360610186002";81;115;9;0;34;239
"3948";"360610186003";151;69;4;0;3;227
"3949";"360610187001";35;11;8;1;7;62
"3950";"360610187002";24;4;7;0;1;36
"3951";"360610187003";6;5;5;3;6;25
"3952";"360610187004";12;14;2;3;16;47
"3953";"360610187005";23;38;20;2;13;96
"3954";"360610187006";31;47;19;0;33;130
"3955";"360610188001";149;68;21;1;19;258
"3956";"360610188002";123;131;77;4;15;350
"3957";"360610188003";41;98;24;3;27;193
"3958";"360610188004";31;42;12;0;11;96
"3959";"360610189001";27;31;13;3;14;88
"3960";"360610189002";63;64;5;6;9;147
"3961";"360610189003";211;8;4;1;2;226
"3962";"360610189004";21;63;11;4;8;107
"3963";"360610189005";16;17;15;1;35;84
"3964";"360610189006";123;24;19;1;3;170
"3965";"360610190001";106;109;42;17;33;307
"3966";"360610191001";24;6;18;1;15;64
"3967";"360610191002";15;13;23;1;12;64
"3968";"360610191003";3;5;7;0;2;17
"3969";"360610191004";15;13;9;2;9;48
"3970";"360610191005";14;78;34;1;47;174
"3971";"360610191006";10;31;11;2;34;88
"3972";"360610192001";461;131;33;11;11;647
"3973";"360610192002";42;16;4;2;1;65
"3974";"360610193001";23;47;14;0;13;97
"3975";"360610193002";42;160;4;0;15;221
"3976";"360610193003";98;54;6;2;9;169
"3977";"360610193004";44;90;32;4;16;186
"3978";"360610193005";58;283;14;1;16;372
"3979";"360610193006";40;38;18;1;25;122
"3980";"360610194001";105;17;31;7;11;171
"3981";"360610194002";18;17;17;12;7;71
"3982";"360610194003";25;28;15;1;12;81
"3983";"360610194004";54;19;3;3;5;84
"3984";"360610195001";7;6;18;7;23;61
"3985";"360610195002";58;117;25;3;14;217
"3986";"360610195003";79;81;15;2;27;204
"3987";"360610195004";18;19;16;0;8;61
"3988";"360610195005";9;7;10;0;8;34
"3989";"360610196001";80;38;13;0;4;135
"3990";"360610196002";35;11;15;0;19;80
"3991";"360610196003";71;37;70;2;123;303
"3992";"360610197011";52;48;49;11;70;230
"3993";"360610197021";43;61;32;0;39;175
"3994";"360610198001";24;69;23;8;165;289
"3995";"360610198002";2;52;10;2;55;121
"3996";"360610199001";10;17;21;3;14;65
"3997";"360610199002";8;14;14;1;63;100
"3998";"360610199003";17;4;15;2;13;51
"3999";"360610199004";21;6;13;1;3;44
"4000";"360610199005";11;14;26;2;39;92
"4001";"360610199006";11;35;12;1;55;114
"4002";"360610200001";122;27;4;2;17;172
"4003";"360610200002";80;307;90;9;93;579
"4004";"360610201011";2;6;18;2;18;46
"4005";"360610201021";21;76;17;2;22;138
"4006";"360610201022";34;86;10;3;25;158
"4007";"360610201023";8;34;0;1;3;46
"4008";"360610201024";20;44;3;1;9;77
"4009";"360610203001";2;12;7;3;0;24
"4010";"360610203002";0;5;20;3;33;61
"4011";"360610205001";4;7;5;3;27;46
"4012";"360610205002";22;0;9;1;12;44
"4013";"360610205003";3;4;23;0;25;55
"4014";"360610206001";79;168;19;4;26;296
"4015";"360610206002";175;105;34;9;38;361
"4016";"360610207011";5;3;3;0;1;12
"4017";"360610207012";8;5;3;1;3;20
"4018";"360610208001";98;66;12;5;7;188
"4019";"360610208002";279;96;19;10;17;421
"4020";"360610208003";33;36;49;3;15;136
"4021";"360610209011";15;17;21;8;38;99
"4022";"360610209012";120;35;2;0;10;167
"4023";"360610210001";18;18;19;3;5;63
"4024";"360610210002";37;4;3;1;2;47
"4025";"360610210003";141;33;8;1;11;194
"4026";"360610210004";132;9;5;1;33;180
"4027";"360610211001";10;33;30;0;13;86
"4028";"360610211002";20;34;4;0;8;66
"4029";"360610211003";40;82;49;1;12;184
"4030";"360610211004";28;9;3;2;5;47
"4031";"360610211005";31;17;2;1;1;52
"4032";"360610211006";4;10;6;1;3;24
"4033";"360610211007";9;10;12;1;1;33
"4034";"360610212001";20;38;72;5;27;162
"4035";"360610212002";1;2;5;0;11;19
"4036";"360610212003";7;4;10;0;2;23
"4037";"360610212004";12;22;5;1;5;45
"4038";"360610213031";54;9;7;0;10;80
"4039";"360610213032";7;7;36;2;12;64
"4040";"360610213033";170;91;2;0;9;272
"4041";"360610213034";62;84;12;0;10;168
"4042";"360610214001";12;31;22;0;6;71
"4043";"360610214002";25;16;3;1;23;68
"4044";"360610215001";48;106;26;0;31;211
"4045";"360610215002";86;93;29;5;20;233
"4046";"360610216001";47;134;19;2;46;248
"4047";"360610216002";29;119;5;4;11;168
"4048";"360610216003";52;176;7;0;23;258
"4049";"360610216004";80;97;10;2;7;196
"4050";"360610216005";93;68;23;3;32;219
"4051";"360610217031";13;48;22;1;13;97
"4052";"360610218001";37;100;12;3;13;165
"4053";"360610218002";314;209;24;2;24;573
"4054";"360610218003";62;173;25;1;18;279
"4055";"360610218004";55;171;15;1;29;271
"4056";"360610219001";99;36;20;2;22;179
"4057";"360610219002";81;120;21;32;4;258
"4058";"360610219003";131;10;14;1;6;162
"4059";"360610219004";49;9;26;2;5;91
"4060";"360610220001";48;43;6;0;7;104
"4061";"360610220002";72;48;16;3;9;148
"4062";"360610220003";43;21;1;0;6;71
"4063";"360610220004";88;80;12;3;16;199
"4064";"360610220005";77;94;9;1;10;191
"4065";"360610221021";67;64;20;3;17;171
"4066";"360610221022";5;25;43;7;34;114
"4067";"360610222001";32;87;34;4;50;207
"4068";"360610222002";60;169;35;3;53;320
"4069";"360610223011";408;189;4;1;14;616
"4070";"360610223012";238;181;26;3;30;478
"4071";"360610223013";466;505;23;1;6;1001
"4072";"360610223014";239;213;3;1;12;468
"4073";"360610223021";35;49;20;1;9;114
"4074";"360610224001";88;48;12;1;16;165
"4075";"360610224002";103;109;75;2;22;311
"4076";"360610224003";330;64;8;0;2;404
"4077";"360610224004";192;11;8;1;9;221
"4078";"360610225001";214;206;26;2;31;479
"4079";"360610225002";45;15;22;0;18;100
"4080";"360610225003";86;258;20;1;42;407
"4081";"360610225004";48;82;9;0;13;152
"4082";"360610225005";291;219;17;1;15;543
"4083";"360610226001";114;175;33;22;18;362
"4084";"360610226002";88;51;22;5;25;191
"4085";"360610226003";67;109;27;0;19;222
"4086";"360610227001";62;63;27;2;27;181
"4087";"360610227002";81;6;41;3;18;149
"4088";"360610227003";172;43;67;4;10;296
"4089";"360610228001";106;109;15;2;37;269
"4090";"360610228002";39;44;21;1;19;124
"4091";"360610228003";49;119;5;0;10;183
"4092";"360610228004";12;24;14;1;13;64
"4093";"360610229001";11;10;1;0;5;27
"4094";"360610229002";54;124;14;0;9;201
"4095";"360610229003";170;219;15;7;29;440
"4096";"360610229004";128;158;3;0;13;302
"4097";"360610229005";143;136;4;0;19;302
"4098";"360610230001";104;42;8;3;2;159
"4099";"360610230002";159;40;7;1;8;215
"4100";"360610230003";38;56;38;3;16;151
"4101";"360610230004";269;110;89;2;34;504
"4102";"360610230005";58;38;2;0;12;110
"4103";"360610231001";61;55;32;0;21;169
"4104";"360610231002";120;131;38;4;18;311
"4105";"360610231003";93;127;53;3;28;304
"4106";"360610232001";69;9;18;0;13;109
"4107";"360610232002";230;48;21;4;9;312
"4108";"360610232003";114;21;2;5;6;148
"4109";"360610232004";116;169;12;2;25;324
"4110";"360610233001";129;143;19;4;27;322
"4111";"360610233002";117;101;25;3;19;265
"4112";"360610233003";185;113;26;0;15;339
"4113";"360610234001";195;347;9;9;19;579
"4114";"360610234002";162;135;22;11;16;346
"4115";"360610235011";108;9;12;0;5;134
"4116";"360610235012";298;228;12;0;19;557
"4117";"360610235013";67;15;18;0;4;104
"4118";"360610235014";120;151;28;3;8;310
"4119";"360610235021";94;67;22;3;25;211
"4120";"360610236001";52;14;18;2;12;98
"4121";"360610236002";271;27;4;0;12;314
"4122";"360610236003";24;16;1;0;3;44
"4123";"360610236004";69;11;5;0;9;94
"4124";"360610237001";180;306;12;3;21;522
"4125";"360610237002";211;214;28;3;13;469
"4126";"360610237003";76;136;21;2;12;247
"4127";"360610238011";11;3;1;3;12;30
"4128";"360610238021";10;2;2;0;1;15
"4129";"360610238022";12;2;0;0;6;20
"4130";"360610239001";49;36;13;1;24;123
"4131";"360610239002";135;86;4;1;10;236
"4132";"360610240001";1;7;7;0;6;21
"4133";"360610241001";21;16;6;1;14;58
"4134";"360610241002";33;28;10;0;13;84
"4135";"360610241003";95;203;0;3;6;307
"4136";"360610241004";228;248;13;1;14;504
"4137";"360610241005";78;49;7;0;8;142
"4138";"360610242001";81;20;73;3;19;196
"4139";"360610242002";39;7;20;1;8;75
"4140";"360610242003";15;14;35;2;34;100
"4141";"360610243011";36;65;5;0;7;113
"4142";"360610243012";67;28;107;2;24;228
"4143";"360610243013";9;22;1;1;13;46
"4144";"360610243021";175;27;27;8;16;253
"4145";"360610243023";307;8;4;0;6;325
"4146";"360610245001";204;107;19;0;10;340
"4147";"360610245002";47;64;2;0;5;118
"4148";"360610245003";75;165;10;2;8;260
"4149";"360610245004";120;89;30;0;35;274
"4150";"360610245005";78;77;72;2;26;255
"4151";"360610245006";96;79;30;1;26;232
"4152";"360610245007";78;191;2;0;14;285
"4153";"360610247001";30;71;29;2;5;137
"4154";"360610247002";101;178;7;2;12;300
"4155";"360610247003";59;89;1;0;0;149
"4156";"360610247004";47;104;27;0;20;198
"4157";"360610247005";89;42;22;2;10;165
"4158";"360610249001";69;50;29;1;7;156
"4159";"360610251001";64;79;34;7;24;208
"4160";"360610251002";75;119;43;0;22;259
"4161";"360610253001";89;181;6;0;5;281
"4162";"360610253002";95;217;4;4;9;329
"4163";"360610253003";81;233;12;0;12;338
"4164";"360610253004";53;68;14;2;24;161
"4165";"360610253005";173;109;39;1;15;337
"4166";"360610253006";130;21;41;9;8;209
"4167";"360610255001";14;8;32;8;5;67
"4168";"360610255002";74;58;48;0;16;196
"4169";"360610255003";103;36;22;0;14;175
"4170";"360610255004";30;3;4;1;4;42
"4171";"360610257001";50;56;40;0;43;189
"4172";"360610257002";15;23;42;0;7;87
"4173";"360610257003";37;74;9;3;12;135
"4174";"360610259001";250;243;78;7;15;593
"4175";"360610259002";24;107;131;3;9;274
"4176";"360610261001";129;193;22;0;17;361
"4177";"360610261002";45;242;5;7;11;310
"4178";"360610261003";77;14;1;0;5;97
"4179";"360610261004";113;87;10;0;11;221
"4180";"360610261005";52;297;135;7;13;504
"4181";"360610261006";44;207;3;2;9;265
"4182";"360610261007";37;163;12;10;13;235
"4183";"360610263001";53;100;21;1;19;194
"4184";"360610263002";168;56;1;2;10;237
"4185";"360610263003";87;142;45;4;10;288
"4186";"360610263004";66;80;23;1;23;193
"4187";"360610263005";199;90;25;1;11;326
"4188";"360610265001";58;23;2;0;3;86
"4189";"360610265002";454;40;57;0;19;570
"4190";"360610265003";7;18;19;2;9;55
"4191";"360610265004";212;121;10;0;23;366
"4192";"360610265005";49;14;4;0;18;85
"4193";"360610267001";361;43;17;9;4;434
"4194";"360610269001";49;30;5;1;12;97
"4195";"360610269002";80;90;16;0;5;191
"4196";"360610269003";19;9;29;2;8;67
"4197";"360610269004";66;252;22;10;16;366
"4198";"360610269005";73;76;34;2;18;203
"4199";"360610269006";95;93;5;4;8;205
"4200";"360610271001";91;108;8;0;8;215
"4201";"360610271002";100;199;15;3;21;338
"4202";"360610271003";58;41;92;6;15;212
"4203";"360610271004";232;45;70;1;14;362
"4204";"360610271005";61;3;10;1;6;81
"4205";"360610273001";74;41;92;5;7;219
"4206";"360610273002";21;21;21;0;6;69
"4207";"360610273003";45;111;32;0;23;211
"4208";"360610273004";33;17;7;0;14;71
"4209";"360610275000";0;0;0;0;1;1
"4210";"360610275001";5;12;32;3;1;53
"4211";"360610275002";3;4;10;0;1;18
"4212";"360610277001";72;164;31;1;9;277
"4213";"360610277002";70;65;1;3;5;144
"4214";"360610277003";79;204;10;4;11;308
"4215";"360610277004";35;53;2;0;7;97
"4216";"360610279001";65;28;19;0;10;122
"4217";"360610279002";590;123;14;1;11;739
"4218";"360610279003";128;139;19;10;7;303
"4219";"360610279004";239;183;26;14;13;475
"4220";"360610279005";224;46;31;1;12;314
"4221";"360610279006";47;31;26;0;0;104
"4222";"360610279007";36;38;13;0;1;88
"4223";"360610281001";4;3;5;14;10;36
"4224";"360610281002";62;45;88;1;13;209
"4225";"360610283001";6;150;7;0;9;172
"4226";"360610283002";306;291;45;3;25;670
"4227";"360610283003";83;35;12;0;7;137
"4228";"360610283004";119;649;57;0;11;836
"4229";"360610285001";93;454;212;2;17;778
"4230";"360610285002";121;209;5;3;10;348
"4231";"360610285003";84;188;9;0;0;281
"4232";"360610285004";330;558;12;3;12;915
"4233";"360610287001";108;213;59;6;23;409
"4234";"360610287002";102;77;7;2;9;197
"4235";"360610287003";118;467;27;5;18;635
"4236";"360610291001";157;190;2;0;19;368
"4237";"360610291002";49;34;17;0;5;105
"4238";"360610291003";168;35;6;4;10;223
"4239";"360610291004";141;89;19;1;11;261
"4240";"360610291005";53;102;10;2;6;173
"4241";"360610291006";85;116;2;0;10;213
"4242";"360610291007";72;388;16;0;12;488
"4243";"360610293001";233;206;15;5;5;464
"4244";"360610293002";81;98;6;0;12;197
"4245";"360610293003";224;288;29;5;19;565
"4246";"360610293004";125;282;20;0;20;447
"4247";"360610293005";77;110;5;5;8;205
"4248";"360610295001";60;199;51;4;4;318
"4249";"360610295002";72;376;66;1;13;528
"4250";"360610295003";171;81;67;0;8;327
"4251";"360610295004";141;44;37;1;8;231
"4252";"360610297001";24;149;34;10;13;230
"4253";"360610299001";326;6;12;1;13;358
"4254";"360610299002";26;119;45;15;34;239
"4255";"360610303001";154;355;38;6;16;569
"4256";"360610303002";115;67;17;0;26;225
"4257";"360610303003";46;105;35;9;11;206
"4258";"360610307001";98;178;61;5;15;357
"4259";"360610307002";4;7;73;1;0;85
"4260";"360610307003";176;84;32;1;6;299
"4261";"360610309001";233;56;29;1;13;332
"4262";"360610309002";52;20;51;0;10;133
"4263";"360610309003";190;42;43;1;7;283
"4264";"360610309004";148;116;153;3;14;434
"4265";"360610311001";22;111;39;7;12;191
"4266";"360610317031";7;13;33;1;10;64
"4267";"360610317032";0;12;25;2;6;45
"4268";"360610317041";9;58;63;1;14;145
"4269";"360610317042";5;9;8;3;2;27
"4270";"360610317043";11;53;107;5;3;179
"4271";"360610317044";15;13;83;6;12;129
"4272";"360610319001";0;3;14;0;8;25
"4273";"360810001001";61;207;390;38;28;724
"4274";"360810002001";48;6;138;22;28;242
"4275";"360810002002";195;55;107;48;26;431
"4276";"360810004001";64;18;171;22;21;296
"4277";"360810004002";30;8;157;80;13;288
"4278";"360810004003";45;10;248;52;24;379
"4279";"360810006001";23;5;73;16;24;141
"4280";"360810006002";19;6;97;34;21;177
"4281";"360810006003";61;10;188;122;19;400
"4282";"360810007001";24;23;55;8;10;120
"4283";"360810007002";10;25;75;16;10;136
"4284";"360810007003";12;25;251;11;10;309
"4285";"360810007004";24;110;194;31;71;430
"4286";"360810008001";108;27;83;43;33;294
"4287";"360810008002";44;7;183;45;16;295
"4288";"360810010001";17;10;44;9;19;99
"4289";"360810010002";45;11;171;19;17;263
"4290";"360810012001";38;8;99;25;25;195
"4291";"360810012002";33;4;96;43;15;191
"4292";"360810012003";82;14;90;26;60;272
"4293";"360810014001";33;11;270;114;11;439
"4294";"360810014002";46;8;53;22;35;164
"4295";"360810014003";26;13;102;45;37;223
"4296";"360810016001";55;6;46;17;18;142
"4297";"360810016002";216;18;44;21;21;320
"4298";"360810018001";62;9;65;30;20;186
"4299";"360810018002";164;14;151;30;20;379
"4300";"360810019001";27;61;454;86;65;693
"4301";"360810020001";53;25;125;63;26;292
"4302";"360810022001";18;3;111;12;20;164
"4303";"360810022002";49;14;70;27;22;182
"4304";"360810024001";30;3;78;16;9;136
"4305";"360810024002";47;10;244;15;17;333
"4306";"360810025001";44;7;8;1;0;60
"4307";"360810025002";13;4;3;0;0;20
"4308";"360810025003";82;4;1;0;5;92
"4309";"360810025004";115;7;57;6;3;188
"4310";"360810025005";79;2;8;1;1;91
"4311";"360810025006";90;13;7;1;3;114
"4312";"360810026001";10;34;49;28;19;140
"4313";"360810026002";64;12;41;15;32;164
"4314";"360810028001";93;14;96;44;40;287
"4315";"360810028002";52;21;105;40;30;248
"4316";"360810030001";25;3;111;38;17;194
"4317";"360810031001";24;111;64;7;10;216
"4318";"360810031002";10;14;163;18;24;229
"4319";"360810032001";51;11;115;43;35;255
"4320";"360810033001";29;128;219;2;28;406
"4321";"360810033002";4;5;117;35;12;173
"4322";"360810033003";10;9;64;29;5;117
"4323";"360810033004";3;7;97;30;10;147
"4324";"360810034001";19;7;126;42;16;210
"4325";"360810034002";29;23;90;45;20;207
"4326";"360810036001";33;18;131;58;28;268
"4327";"360810036002";73;18;99;61;32;283
"4328";"360810037001";112;18;96;7;1;234
"4329";"360810038001";32;7;67;23;21;150
"4330";"360810038002";57;15;83;17;21;193
"4331";"360810039001";12;12;135;67;23;249
"4332";"360810040011";26;46;181;22;9;284
"4333";"360810040012";14;4;98;19;13;148
"4334";"360810040021";25;3;80;31;37;176
"4335";"360810042001";28;8;138;77;63;314
"4336";"360810042002";5;1;83;16;14;119
"4337";"360810042003";42;16;34;16;21;129
"4338";"360810043001";157;95;39;39;17;347
"4339";"360810043002";1;1;49;27;8;86
"4340";"360810044011";22;11;54;42;34;163
"4341";"360810044012";27;3;136;39;17;222
"4342";"360810045001";6;13;57;28;15;119
"4343";"360810045002";2;1;5;13;1;22
"4344";"360810045003";3;15;11;2;1;32
"4345";"360810047001";23;11;65;7;13;119
"4346";"360810047002";172;35;6;0;6;219
"4347";"360810050001";2;0;7;4;0;13
"4348";"360810051001";17;53;53;5;9;137
"4349";"360810051002";11;8;73;31;16;139
"4350";"360810052001";35;28;163;39;53;318
"4351";"360810052002";20;17;86;40;17;180
"4352";"360810053001";10;7;57;1;25;100
"4353";"360810053002";63;2;159;3;11;238
"4354";"360810053003";24;4;25;0;22;75
"4355";"360810053004";17;11;83;1;19;131
"4356";"360810054001";4;8;46;18;10;86
"4357";"360810054002";25;8;80;18;24;155
"4358";"360810054003";59;95;125;37;54;370
"4359";"360810054004";65;13;125;57;67;327
"4360";"360810055001";30;153;516;56;21;776
"4361";"360810057001";178;46;45;3;18;290
"4362";"360810057002";7;19;36;4;14;80
"4363";"360810057003";18;177;69;11;8;283
"4364";"360810058001";20;12;92;74;30;228
"4365";"360810058002";4;5;18;15;5;47
"4366";"360810058003";16;5;29;34;19;103
"4367";"360810058004";27;26;105;35;7;200
"4368";"360810059001";20;41;64;1;17;143
"4369";"360810059002";44;8;52;2;8;114
"4370";"360810059003";34;57;60;3;19;173
"4371";"360810061001";17;35;39;1;10;102
"4372";"360810061002";41;87;16;0;23;167
"4373";"360810061003";32;46;20;2;26;126
"4374";"360810061004";17;15;33;1;7;73
"4375";"360810062011";8;3;17;3;2;33
"4376";"360810062012";62;11;142;24;33;272
"4377";"360810062021";0;2;15;21;10;48
"4378";"360810062022";20;2;63;10;10;105
"4379";"360810062023";38;1;39;39;34;151
"4380";"360810062024";20;0;52;12;7;91
"4381";"360810062025";33;3;34;23;9;102
"4382";"360810062026";31;7;67;26;9;140
"4383";"360810062027";31;5;115;24;15;190
"4384";"360810063001";19;10;43;2;15;89
"4385";"360810063002";21;23;24;7;17;92
"4386";"360810063003";35;22;20;1;13;91
"4387";"360810063004";14;56;39;3;23;135
"4388";"360810065011";28;59;13;0;13;113
"4389";"360810065012";6;3;63;7;9;88
"4390";"360810065013";27;4;29;4;2;66
"4391";"360810065021";20;138;62;3;26;249
"4392";"360810065022";18;4;63;5;20;110
"4393";"360810065023";89;55;96;2;17;259
"4394";"360810069001";26;17;71;2;12;128
"4395";"360810069002";82;25;144;7;16;274
"4396";"360810069003";21;45;42;3;18;129
"4397";"360810071001";9;108;94;2;12;225
"4398";"360810071002";8;2;5;0;6;21
"4399";"360810071003";12;12;126;1;9;160
"4400";"360810071004";29;417;74;1;61;582
"4401";"360810073001";37;25;58;0;23;143
"4402";"360810073002";10;3;15;1;2;31
"4403";"360810073003";38;13;61;0;8;120
"4404";"360810075001";29;9;36;3;10;87
"4405";"360810075002";35;57;26;2;16;136
"4406";"360810075003";8;2;9;0;3;22
"4407";"360810077001";18;11;70;8;20;127
"4408";"360810079001";82;25;117;29;24;277
"4409";"360810079002";7;9;83;8;8;115
"4410";"360810081001";26;18;105;26;19;194
"4411";"360810083001";18;7;249;13;12;299
"4412";"360810083002";83;58;113;35;35;324
"4413";"360810085001";30;22;186;54;13;305
"4414";"360810085002";3;18;116;28;8;173
"4415";"360810086001";105;6;101;49;35;296
"4416";"360810086002";32;6;59;47;17;161
"4417";"360810087001";74;25;52;1;1;153
"4418";"360810087002";24;9;55;39;10;137
"4419";"360810087003";62;22;16;14;1;115
"4420";"360810088001";41;24;138;52;47;302
"4421";"360810088002";21;27;175;43;24;290
"4422";"360810091001";11;2;43;14;8;78
"4423";"360810091002";33;9;147;10;9;208
"4424";"360810094001";35;40;73;28;87;263
"4425";"360810094002";78;10;77;30;43;238
"4426";"360810095001";12;2;32;1;7;54
"4427";"360810095002";14;27;67;12;8;128
"4428";"360810096001";69;8;165;33;50;325
"4429";"360810096002";68;18;127;16;47;276
"4430";"360810097001";17;6;15;2;9;49
"4431";"360810097002";8;36;29;13;18;104
"4432";"360810097003";8;9;15;1;16;49
"4433";"360810097004";6;11;25;1;18;61
"4434";"360810098001";49;9;106;23;27;214
"4435";"360810098002";115;39;90;21;66;331
"4436";"360810099001";6;37;4;2;1;50
"4437";"360810100001";100;5;112;22;44;283
"4438";"360810100002";118;27;132;24;62;363
"4439";"360810101001";15;9;72;5;16;117
"4440";"360810101002";9;10;63;10;19;111
"4441";"360810102001";37;7;50;30;36;160
"4442";"360810102002";59;24;91;25;33;232
"4443";"360810103001";43;65;53;10;11;182
"4444";"360810103002";13;26;31;7;16;93
"4445";"360810103003";19;8;37;0;9;73
"4446";"360810103004";20;12;15;7;1;55
"4447";"360810104001";85;23;99;15;59;281
"4448";"360810104002";128;7;151;17;42;345
"4449";"360810105001";16;19;8;0;5;48
"4450";"360810105002";4;9;20;0;2;35
"4451";"360810105003";7;6;33;5;13;64
"4452";"360810105004";8;6;18;0;5;37
"4453";"360810106001";18;1;146;22;33;220
"4454";"360810106002";101;13;171;44;46;375
"4455";"360810107011";3;11;24;16;3;57
"4456";"360810108001";56;14;134;8;36;248
"4457";"360810108002";31;17;206;32;37;323
"4458";"360810110001";18;14;102;27;17;178
"4459";"360810110002";119;6;221;24;61;431
"4460";"360810111001";39;19;50;6;2;116
"4461";"360810111002";9;5;84;3;5;106
"4462";"360810112001";56;3;110;34;29;232
"4463";"360810112002";41;6;154;9;43;253
"4464";"360810113001";42;15;16;2;11;86
"4465";"360810113002";35;31;30;3;12;111
"4466";"360810113003";23;53;62;3;15;156
"4467";"360810114001";75;5;93;71;30;274
"4468";"360810115001";17;55;108;1;48;229
"4469";"360810115002";7;41;25;2;66;141
"4470";"360810116001";100;22;40;25;14;201
"4471";"360810116002";43;6;111;21;24;205
"4472";"360810117001";12;39;74;0;9;134
"4473";"360810117002";10;60;28;3;14;115
"4474";"360810117003";11;8;131;8;21;179
"4475";"360810117004";14;10;116;16;6;162
"4476";"360810118001";40;3;161;33;30;267
"4477";"360810118002";11;6;102;16;14;149
"4478";"360810119001";9;17;57;2;17;102
"4479";"360810119002";2;4;36;7;7;56
"4480";"360810120001";22;4;72;10;12;120
"4481";"360810120002";8;13;148;29;29;227
"4482";"360810121001";12;6;59;3;28;108
"4483";"360810121002";2;8;8;1;15;34
"4484";"360810122001";17;32;123;12;50;234
"4485";"360810122002";61;9;94;30;38;232
"4486";"360810123011";20;89;99;31;18;257
"4487";"360810123012";5;8;72;41;9;135
"4488";"360810123013";2;19;33;23;31;108
"4489";"360810124001";54;7;46;22;21;150
"4490";"360810124002";63;17;110;44;22;256
"4491";"360810125001";18;12;44;2;16;92
"4492";"360810125002";4;24;31;2;16;77
"4493";"360810126011";41;6;87;42;90;266
"4494";"360810126012";31;11;67;21;35;165
"4495";"360810126021";46;9;40;10;18;123
"4496";"360810126022";51;19;108;34;38;250
"4497";"360810128001";47;4;54;16;22;143
"4498";"360810128002";54;22;46;14;24;160
"4499";"360810130001";0;2;39;20;6;67
"4500";"360810130002";36;30;57;16;11;150
"4501";"360810132001";6;10;25;2;7;50
"4502";"360810132002";18;13;58;16;18;123
"4503";"360810134001";209;6;23;5;4;247
"4504";"360810134002";11;8;441;2;3;465
"4505";"360810134003";161;7;146;3;13;330
"4506";"360810134004";3;0;5;0;2;10
"4507";"360810135001";5;3;50;11;20;89
"4508";"360810136001";0;2;36;9;9;56
"4509";"360810136002";14;73;23;1;5;116
"4510";"360810137001";25;31;142;62;24;284
"4511";"360810138001";42;6;38;4;3;93
"4512";"360810138002";31;11;201;8;21;272
"4513";"360810140001";23;3;132;14;16;188
"4514";"360810140002";68;6;95;3;22;194
"4515";"360810141001";14;16;11;1;4;46
"4516";"360810141002";33;15;98;82;25;253
"4517";"360810142011";14;9;77;7;29;136
"4518";"360810142012";31;6;99;27;54;217
"4519";"360810142021";60;16;154;11;43;284
"4520";"360810142022";29;16;137;48;27;257
"4521";"360810143001";25;3;76;3;7;114
"4522";"360810143002";23;184;62;6;47;322
"4523";"360810144001";110;35;242;29;72;488
"4524";"360810145001";6;1;109;50;11;177
"4525";"360810145002";97;1;104;34;6;242
"4526";"360810147001";8;5;68;14;8;103
"4527";"360810147002";15;7;61;11;4;98
"4528";"360810147003";15;52;56;3;17;143
"4529";"360810148001";81;17;128;38;80;344
"4530";"360810149001";22;18;18;2;6;66
"4531";"360810149002";14;20;70;1;33;138
"4532";"360810150001";311;14;67;19;69;480
"4533";"360810150002";70;12;71;8;35;196
"4534";"360810151001";17;10;67;0;6;100
"4535";"360810151002";17;23;57;18;8;123
"4536";"360810152001";28;8;69;22;32;159
"4537";"360810152002";25;3;125;64;32;249
"4538";"360810153001";3;3;60;13;17;96
"4539";"360810153002";16;65;66;7;7;161
"4540";"360810154001";43;21;82;6;13;165
"4541";"360810154002";52;26;104;38;25;245
"4542";"360810155001";52;70;81;2;15;220
"4543";"360810155002";15;68;63;0;61;207
"4544";"360810156001";38;20;148;34;28;268
"4545";"360810156002";46;24;97;20;65;252
"4546";"360810157001";32;71;58;20;54;235
"4547";"360810158011";23;4;54;17;8;106
"4548";"360810158012";38;7;73;38;31;187
"4549";"360810158013";55;15;106;49;37;262
"4550";"360810158021";57;20;138;33;29;277
"4551";"360810158022";86;15;87;16;54;258
"4552";"360810158023";50;18;79;17;46;210
"4553";"360810159001";13;107;53;3;3;179
"4554";"360810159002";128;10;16;10;39;203
"4555";"360810159003";18;7;7;4;9;45
"4556";"360810159004";13;20;67;1;18;119
"4557";"360810161001";17;2;36;1;21;77
"4558";"360810161002";59;61;54;3;23;200
"4559";"360810163001";6;5;82;12;9;114
"4560";"360810163002";59;41;9;9;5;123
"4561";"360810163003";127;21;1;2;11;162
"4562";"360810164001";27;10;88;25;32;182
"4563";"360810164002";57;17;97;38;50;259
"4564";"360810166001";103;21;229;28;49;430
"4565";"360810166002";34;8;79;25;23;169
"4566";"360810168001";80;13;100;28;41;262
"4567";"360810168002";79;5;104;51;28;267
"4568";"360810169001";40;5;11;1;4;61
"4569";"360810169002";26;5;39;3;13;86
"4570";"360810169003";30;2;44;1;12;89
"4571";"360810169004";12;17;14;4;12;59
"4572";"360810170001";61;1;100;24;40;226
"4573";"360810170002";36;26;111;19;25;217
"4574";"360810171001";4;46;166;22;22;260
"4575";"360810172001";63;12;78;27;41;221
"4576";"360810172002";21;22;52;32;20;147
"4577";"360810174001";35;7;80;43;15;180
"4578";"360810174002";64;1;114;27;54;260
"4579";"360810176001";38;4;74;45;27;188
"4580";"360810176002";33;5;38;22;6;104
"4581";"360810178001";77;9;91;38;27;242
"4582";"360810178002";48;3;65;29;12;157
"4583";"360810179001";6;3;102;12;22;145
"4584";"360810179002";40;21;75;10;17;163
"4585";"360810180001";35;16;76;34;34;195
"4586";"360810181011";18;8;19;0;5;50
"4587";"360810181012";49;17;16;2;2;86
"4588";"360810181013";32;15;25;2;9;83
"4589";"360810181021";18;8;12;4;9;51
"4590";"360810181022";23;43;13;7;6;92
"4591";"360810181023";14;23;27;1;6;71
"4592";"360810182001";20;6;33;13;21;93
"4593";"360810182002";20;1;54;58;16;149
"4594";"360810183001";27;17;98;6;12;160
"4595";"360810183002";24;6;10;3;1;44
"4596";"360810183003";52;26;19;2;3;102
"4597";"360810183004";48;23;41;4;15;131
"4598";"360810183005";41;86;16;3;29;175
"4599";"360810184011";91;13;90;68;26;288
"4600";"360810184021";12;6;51;24;23;116
"4601";"360810184022";4;3;49;17;13;86
"4602";"360810185011";17;5;129;1;12;164
"4603";"360810185012";4;3;7;0;2;16
"4604";"360810185013";22;20;40;0;17;99
"4605";"360810185021";5;1;6;0;10;22
"4606";"360810185022";88;13;16;1;14;132
"4607";"360810185023";17;37;10;3;16;83
"4608";"360810186001";57;10;131;70;43;311
"4609";"360810187001";42;38;95;4;19;198
"4610";"360810187002";10;1;16;5;9;41
"4611";"360810187003";17;13;74;9;12;125
"4612";"360810188001";41;17;58;37;22;175
"4613";"360810189001";89;16;47;4;19;175
"4614";"360810189002";92;8;71;19;20;210
"4615";"360810189003";43;3;21;1;6;74
"4616";"360810190001";14;10;58;26;15;123
"4617";"360810190002";26;9;108;52;26;221
"4618";"360810192001";18;4;70;14;34;140
"4619";"360810192002";58;9;46;26;18;157
"4620";"360810194001";16;4;42;49;18;129
"4621";"360810194002";42;4;135;58;27;266
"4622";"360810196001";48;18;63;57;36;222
"4623";"360810196002";74;12;121;67;25;299
"4624";"360810198001";10;10;64;38;31;153
"4625";"360810198002";30;5;56;44;22;157
"4626";"360810198003";12;5;66;25;9;117
"4627";"360810199001";0;4;253;16;18;291
"4628";"360810199002";1;4;153;75;24;257
"4629";"360810202001";23;16;169;80;22;310
"4630";"360810204001";21;10;65;84;40;220
"4631";"360810204002";52;21;109;75;34;291
"4632";"360810205001";1;0;47;28;5;81
"4633";"360810205002";9;1;54;44;7;115
"4634";"360810206001";34;12;132;67;31;276
"4635";"360810208001";45;12;88;31;21;197
"4636";"360810208002";16;22;170;103;52;363
"4637";"360810212001";5;21;48;5;36;115
"4638";"360810212002";85;12;33;3;28;161
"4639";"360810214001";51;6;56;0;8;121
"4640";"360810214002";16;1;75;7;14;113
"4641";"360810214003";24;15;129;56;48;272
"4642";"360810216001";3;7;50;2;18;80
"4643";"360810216002";14;4;63;8;11;100
"4644";"360810216003";24;7;48;6;11;96
"4645";"360810219001";0;8;121;44;6;179
"4646";"360810220011";8;0;34;1;7;50
"4647";"360810220012";46;3;79;17;3;148
"4648";"360810220013";47;22;69;4;4;146
"4649";"360810220014";9;4;2;0;0;15
"4650";"360810220021";1;2;63;4;4;74
"4651";"360810220022";82;0;51;4;10;147
"4652";"360810220023";45;10;73;1;7;136
"4653";"360810220024";20;8;48;6;14;96
"4654";"360810229001";0;0;23;30;1;54
"4655";"360810230001";21;5;41;16;4;87
"4656";"360810230002";25;1;29;2;18;75
"4657";"360810232001";8;1;14;2;2;27
"4658";"360810232002";15;5;82;0;10;112
"4659";"360810232003";15;3;111;12;29;170
"4660";"360810235001";29;14;46;9;33;131
"4661";"360810235002";30;28;28;5;7;98
"4662";"360810235003";17;5;81;3;3;109
"4663";"360810235004";31;55;59;5;25;175
"4664";"360810236001";10;4;47;10;7;78
"4665";"360810236002";23;8;12;2;16;61
"4666";"360810238001";289;1;21;0;10;321
"4667";"360810238002";9;1;20;2;11;43
"4668";"360810238003";56;3;15;0;5;79
"4669";"360810238004";3;2;16;1;6;28
"4670";"360810240001";18;7;31;1;14;71
"4671";"360810240002";128;10;36;3;44;221
"4672";"360810240003";30;12;9;1;9;61
"4673";"360810243001";2;5;47;77;19;150
"4674";"360810243002";13;0;46;69;22;150
"4675";"360810243003";28;7;79;55;19;188
"4676";"360810243004";27;7;86;66;32;218
"4677";"360810245001";1;1;11;1;8;22
"4678";"360810245002";33;2;55;8;16;114
"4679";"360810245003";2;3;20;0;3;28
"4680";"360810245004";28;1;57;5;11;102
"4681";"360810246001";0;0;29;1;11;41
"4682";"360810247001";16;4;67;3;29;119
"4683";"360810249001";22;14;88;0;17;141
"4684";"360810249002";16;2;17;1;9;45
"4685";"360810249003";16;12;56;1;13;98
"4686";"360810251001";10;14;28;3;15;70
"4687";"360810251002";14;3;41;3;11;72
"4688";"360810251003";103;35;172;1;20;331
"4689";"360810251004";26;35;17;1;10;89
"4690";"360810253011";20;6;22;6;3;57
"4691";"360810253012";37;2;22;1;12;74
"4692";"360810253013";21;2;8;1;18;50
"4693";"360810253014";36;24;22;0;8;90
"4694";"360810253021";14;3;2;0;3;22
"4695";"360810253022";51;19;52;7;30;159
"4696";"360810254001";51;14;56;25;45;191
"4697";"360810254002";12;7;44;15;14;92
"4698";"360810254003";57;19;26;8;17;127
"4699";"360810254004";40;6;32;9;14;101
"4700";"360810254005";56;13;152;126;41;388
"4701";"360810254006";25;17;58;40;22;162
"4702";"360810255001";15;12;224;113;39;403
"4703";"360810257001";28;31;164;43;27;293
"4704";"360810258001";50;11;30;26;12;129
"4705";"360810258002";17;1;18;12;11;59
"4706";"360810259001";28;20;155;20;18;241
"4707";"360810259002";100;14;61;2;45;222
"4708";"360810260001";38;16;18;4;24;100
"4709";"360810260002";27;3;35;50;16;131
"4710";"360810261001";4;9;60;8;8;89
"4711";"360810261002";116;7;115;0;14;252
"4712";"360810261003";19;27;16;4;12;78
"4713";"360810261004";29;23;110;10;10;182
"4714";"360810262001";13;5;53;69;35;175
"4715";"360810263001";16;44;105;5;14;184
"4716";"360810263002";25;41;93;7;25;191
"4717";"360810263003";22;4;75;0;8;109
"4718";"360810264001";42;7;18;20;15;102
"4719";"360810264002";38;6;38;46;25;153
"4720";"360810265001";21;31;161;13;31;257
"4721";"360810265002";14;4;88;9;13;128
"4722";"360810266001";33;5;42;32;9;121
"4723";"360810267001";37;10;28;4;11;90
"4724";"360810267002";13;33;39;0;26;111
"4725";"360810267003";45;9;197;4;29;284
"4726";"360810269011";18;28;13;1;14;74
"4727";"360810269012";17;1;6;0;2;26
"4728";"360810269013";23;2;26;4;3;58
"4729";"360810269014";14;10;49;1;13;87
"4730";"360810269021";42;15;53;0;19;129
"4731";"360810269022";27;6;51;0;20;104
"4732";"360810270001";46;11;122;119;78;376
"4733";"360810271001";59;140;135;0;4;338
"4734";"360810271002";69;9;18;1;15;112
"4735";"360810271003";46;4;68;1;5;124
"4736";"360810271004";24;0;14;0;25;63
"4737";"360810271005";32;1;18;0;10;61
"4738";"360810272001";38;0;40;24;18;120
"4739";"360810272002";9;6;50;7;9;81
"4740";"360810273001";4;11;12;1;0;28
"4741";"360810273002";58;10;18;0;11;97
"4742";"360810273003";67;25;21;1;14;128
"4743";"360810273004";21;14;43;3;16;97
"4744";"360810273005";29;77;79;0;7;192
"4745";"360810274001";45;8;61;25;17;156
"4746";"360810275001";7;9;8;0;0;24
"4747";"360810275002";62;11;90;3;22;188
"4748";"360810275003";65;4;147;3;25;244
"4749";"360810276001";48;17;55;38;19;177
"4750";"360810277001";1;1;12;1;2;17
"4751";"360810277002";57;9;40;1;22;129
"4752";"360810277003";50;5;13;2;2;72
"4753";"360810277004";25;4;10;6;13;58
"4754";"360810277005";130;6;51;2;24;213
"4755";"360810278001";80;7;18;10;6;121
"4756";"360810278002";44;1;6;0;6;57
"4757";"360810279001";24;5;82;0;11;122
"4758";"360810279002";82;10;92;6;15;205
"4759";"360810279003";44;32;10;0;5;91
"4760";"360810279004";6;7;11;2;1;27
"4761";"360810280001";67;6;45;38;21;177
"4762";"360810281001";70;33;52;2;8;165
"4763";"360810281002";95;10;43;5;4;157
"4764";"360810281003";14;31;21;3;6;75
"4765";"360810281004";14;9;17;3;9;52
"4766";"360810282001";24;24;57;25;34;164
"4767";"360810283001";10;10;8;0;3;31
"4768";"360810283002";46;3;3;0;2;54
"4769";"360810283003";11;34;23;3;13;84
"4770";"360810283004";12;14;6;1;4;37
"4771";"360810283005";82;13;6;0;7;108
"4772";"360810284001";30;2;78;56;16;182
"4773";"360810284002";30;6;24;24;26;110
"4774";"360810285001";4;7;9;1;3;24
"4775";"360810285002";9;9;5;1;0;24
"4776";"360810285003";14;33;46;0;7;100
"4777";"360810285004";81;18;36;1;7;143
"4778";"360810287001";44;7;24;2;9;86
"4779";"360810287002";16;21;20;0;3;60
"4780";"360810287003";87;31;46;6;14;184
"4781";"360810287004";66;61;46;0;3;176
"4782";"360810288001";12;5;19;28;13;77
"4783";"360810288002";18;3;25;14;11;71
"4784";"360810288003";24;3;18;33;12;90
"4785";"360810288004";21;3;29;35;19;107
"4786";"360810289001";55;9;32;0;5;101
"4787";"360810289002";22;3;39;2;13;79
"4788";"360810289003";33;16;47;5;29;130
"4789";"360810291001";16;6;66;4;7;99
"4790";"360810291002";48;7;57;3;4;119
"4791";"360810291003";28;14;18;4;7;71
"4792";"360810291004";12;22;43;1;11;89
"4793";"360810293001";7;8;121;24;19;179
"4794";"360810294001";16;2;45;32;9;104
"4795";"360810294002";24;5;73;13;23;138
"4796";"360810294003";24;4;61;18;10;117
"4797";"360810294004";26;2;10;15;18;71
"4798";"360810294005";16;13;15;24;20;88
"4799";"360810294006";10;4;55;53;19;141
"4800";"360810295001";10;3;117;10;3;143
"4801";"360810295002";20;0;351;64;10;445
"4802";"360810297001";12;46;141;95;15;309
"4803";"360810297002";35;8;230;84;24;381
"4804";"360810299001";0;0;2;1;4;7
"4805";"360810306001";9;3;65;34;15;126
"4806";"360810306002";20;6;47;25;12;110
"4807";"360810306003";44;15;78;40;18;195
"4808";"360810306004";11;15;45;15;20;106
"4809";"360810309021";13;3;25;1;4;46
"4810";"360810309022";21;0;76;2;6;105
"4811";"360810309023";35;2;100;6;12;155
"4812";"360810309024";16;1;77;3;8;105
"4813";"360810309025";10;0;343;3;13;369
"4814";"360810309031";40;19;176;5;31;271
"4815";"360810309032";60;12;116;5;12;205
"4816";"360810309033";23;9;96;8;20;156
"4817";"360810309041";46;12;122;25;19;224
"4818";"360810309042";17;4;61;1;14;97
"4819";"360810317001";44;13;142;17;14;230
"4820";"360810317002";8;5;70;7;6;96
"4821";"360810317003";18;9;104;11;9;151
"4822";"360810317004";8;2;49;10;22;91
"4823";"360810320001";13;3;26;28;16;86
"4824";"360810320002";2;3;24;22;6;57
"4825";"360810320003";43;9;78;68;43;241
"4826";"360810320004";15;2;21;49;12;99
"4827";"360810327001";23;9;108;10;18;168
"4828";"360810327002";71;57;47;3;15;193
"4829";"360810328001";12;4;20;21;17;74
"4830";"360810328002";31;12;17;22;12;94
"4831";"360810329001";19;5;28;26;22;100
"4832";"360810329002";12;4;56;7;10;89
"4833";"360810329003";20;9;79;13;13;134
"4834";"360810330001";49;4;66;41;20;180
"4835";"360810330002";4;2;13;14;7;40
"4836";"360810330003";15;0;43;18;84;160
"4837";"360810330004";3;1;32;14;7;57
"4838";"360810330005";8;2;36;19;15;80
"4839";"360810331001";1;3;8;3;2;17
"4840";"360810334011";19;8;41;51;17;136
"4841";"360810334012";65;10;96;80;30;281
"4842";"360810334021";1;0;6;2;0;9
"4843";"360810334022";3;2;3;0;0;8
"4844";"360810334023";3;3;2;0;1;9
"4845";"360810334024";3;9;1;0;3;16
"4846";"360810334025";6;35;6;4;5;56
"4847";"360810334026";36;17;77;82;10;222
"4848";"360810337001";28;1;92;14;33;168
"4849";"360810337002";24;37;83;6;16;166
"4850";"360810339001";15;23;26;6;23;93
"4851";"360810339002";21;5;5;0;5;36
"4852";"360810339003";18;21;62;3;6;110
"4853";"360810347001";25;7;119;44;9;204
"4854";"360810347002";22;4;109;14;16;165
"4855";"360810351001";29;1;51;7;10;98
"4856";"360810351002";32;12;91;7;16;158
"4857";"360810351003";13;29;67;7;12;128
"4858";"360810352001";17;4;76;32;11;140
"4859";"360810352002";31;2;17;35;15;100
"4860";"360810353001";20;7;58;17;9;111
"4861";"360810353002";65;6;80;4;21;176
"4862";"360810357001";29;4;253;18;11;315
"4863";"360810357002";125;11;148;15;13;312
"4864";"360810357003";51;4;101;7;13;176
"4865";"360810358001";31;6;17;17;12;83
"4866";"360810358002";39;6;41;53;9;148
"4867";"360810358003";13;3;18;27;14;75
"4868";"360810358004";4;0;0;18;28;50
"4869";"360810361001";89;15;64;19;34;221
"4870";"360810361002";47;6;67;12;7;139
"4871";"360810363001";56;7;73;27;12;175
"4872";"360810363002";21;3;90;8;10;132
"4873";"360810365001";66;12;131;15;18;242
"4874";"360810365002";40;5;122;23;15;205
"4875";"360810366001";13;21;70;45;60;209
"4876";"360810366002";14;12;40;26;23;115
"4877";"360810367001";12;5;18;14;6;55
"4878";"360810367002";50;5;133;53;35;276
"4879";"360810368001";17;4;27;18;8;74
"4880";"360810368002";13;4;29;17;11;74
"4881";"360810371001";19;3;197;28;32;279
"4882";"360810373001";24;8;111;29;13;185
"4883";"360810373002";193;111;172;33;15;524
"4884";"360810375001";47;8;82;19;16;172
"4885";"360810375002";31;93;105;4;11;244
"4886";"360810376001";13;5;22;20;25;85
"4887";"360810376002";32;7;25;23;22;109
"4888";"360810376003";11;1;7;2;4;25
"4889";"360810376004";15;1;23;20;6;65
"4890";"360810376005";11;3;26;25;2;67
"4891";"360810377001";39;17;172;11;19;258
"4892";"360810377002";49;5;95;20;13;182
"4893";"360810379001";69;11;257;17;32;386
"4894";"360810379002";23;26;231;6;10;296
"4895";"360810379003";25;7;104;9;18;163
"4896";"360810381001";67;22;182;13;15;299
"4897";"360810381002";68;5;173;22;23;291
"4898";"360810381003";23;23;93;25;18;182
"4899";"360810383011";170;127;14;81;13;405
"4900";"360810383021";39;372;120;26;36;593
"4901";"360810384001";29;2;36;15;13;95
"4902";"360810384002";18;3;55;34;21;131
"4903";"360810394001";16;4;45;33;22;120
"4904";"360810394002";23;10;21;18;11;83
"4905";"360810394003";5;2;18;13;11;49
"4906";"360810398001";9;2;26;12;7;56
"4907";"360810398002";5;9;15;4;5;38
"4908";"360810399001";16;9;129;15;11;180
"4909";"360810399002";34;4;85;12;10;145
"4910";"360810399003";41;6;55;15;3;120
"4911";"360810400001";4;1;54;8;10;77
"4912";"360810400002";8;1;11;22;9;51
"4913";"360810401001";105;7;146;32;21;311
"4914";"360810401002";40;64;82;26;20;232
"4915";"360810401003";7;5;95;20;15;142
"4916";"360810402001";17;3;13;16;11;60
"4917";"360810402002";19;8;16;26;10;79
"4918";"360810403001";77;45;204;12;32;370
"4919";"360810403002";21;11;74;12;22;140
"4920";"360810403003";36;2;85;4;21;148
"4921";"360810404001";16;1;16;9;7;49
"4922";"360810404002";32;2;23;27;17;101
"4923";"360810404003";11;14;13;17;9;64
"4924";"360810404004";17;2;42;19;6;86
"4925";"360810405001";39;32;38;5;10;124
"4926";"360810405002";21;40;92;7;38;198
"4927";"360810407001";35;9;100;24;7;175
"4928";"360810407002";23;8;32;17;11;91
"4929";"360810407003";23;7;50;6;14;100
"4930";"360810407004";98;6;141;7;1;253
"4931";"360810407005";11;8;16;4;3;42
"4932";"360810409001";42;2;99;19;8;170
"4933";"360810409002";34;2;46;4;6;92
"4934";"360810409003";7;2;64;3;3;79
"4935";"360810409004";16;17;55;1;19;108
"4936";"360810411001";65;10;62;20;9;166
"4937";"360810411002";45;4;58;21;10;138
"4938";"360810413001";36;7;174;21;24;262
"4939";"360810413002";21;43;144;9;18;235
"4940";"360810414001";120;13;64;59;27;283
"4941";"360810414002";13;12;3;8;10;46
"4942";"360810414003";17;1;39;40;20;117
"4943";"360810415001";31;25;123;29;23;231
"4944";"360810415002";16;18;85;19;14;152
"4945";"360810424001";20;11;33;41;10;115
"4946";"360810424002";7;0;4;9;6;26
"4947";"360810424003";4;0;5;9;3;21
"4948";"360810426001";13;15;7;5;5;45
"4949";"360810427001";36;8;132;13;12;201
"4950";"360810427002";76;40;222;14;30;382
"4951";"360810432001";18;16;24;49;15;122
"4952";"360810434001";31;7;52;35;23;148
"4953";"360810437011";40;11;90;8;8;157
"4954";"360810437012";12;6;42;11;6;77
"4955";"360810437021";106;9;71;8;4;198
"4956";"360810437022";60;8;235;13;6;322
"4957";"360810437023";90;6;133;10;7;246
"4958";"360810439001";50;14;176;17;16;273
"4959";"360810439002";87;24;152;20;15;298
"4960";"360810440001";24;9;122;83;57;295
"4961";"360810440002";24;4;55;54;24;161
"4962";"360810440003";47;11;59;65;24;206
"4963";"360810443011";24;5;84;2;2;117
"4964";"360810443012";30;15;69;7;12;133
"4965";"360810443021";44;7;120;10;8;189
"4966";"360810443022";20;3;110;17;5;155
"4967";"360810443023";28;80;89;17;16;230
"4968";"360810444001";29;16;100;4;23;172
"4969";"360810444002";16;175;115;13;22;341
"4970";"360810444003";37;6;92;53;52;240
"4971";"360810446011";20;19;12;3;37;91
"4972";"360810446012";42;24;20;0;28;114
"4973";"360810446021";23;11;28;6;49;117
"4974";"360810446022";46;25;16;3;21;111
"4975";"360810448001";63;25;41;8;115;252
"4976";"360810448002";9;0;29;2;5;45
"4977";"360810450001";20;5;46;23;12;106
"4978";"360810450002";7;2;36;3;15;63
"4979";"360810452001";17;11;22;4;19;73
"4980";"360810454001";50;12;82;1;18;163
"4981";"360810454002";21;3;61;5;29;119
"4982";"360810455001";88;8;5;0;3;104
"4983";"360810455002";8;12;1;0;3;24
"4984";"360810455003";27;6;4;3;0;40
"4985";"360810455004";21;1;2;0;2;26
"4986";"360810455005";2;0;9;0;3;14
"4987";"360810455006";0;0;3;1;1;5
"4988";"360810456001";18;1;42;8;5;74
"4989";"360810457001";51;3;69;4;20;147
"4990";"360810457002";14;6;88;0;11;119
"4991";"360810458001";92;20;131;7;21;271
"4992";"360810459001";20;1;89;6;17;133
"4993";"360810459002";34;2;47;7;6;96
"4994";"360810460001";29;5;29;1;15;79
"4995";"360810460002";71;5;19;4;27;126
"4996";"360810460003";28;9;17;1;10;65
"4997";"360810461001";62;23;147;3;8;243
"4998";"360810462001";27;9;51;2;34;123
"4999";"360810462002";51;130;95;2;33;311
"5000";"360810462003";62;73;113;3;58;309
"5001";"360810463001";24;7;196;2;13;242
"5002";"360810463002";42;9;110;5;10;176
"5003";"360810464001";19;7;52;2;6;86
"5004";"360810465001";61;20;70;3;12;166
"5005";"360810465002";43;10;54;2;14;123
"5006";"360810466001";35;3;41;0;15;94
"5007";"360810466002";7;6;66;0;11;90
"5008";"360810467001";44;5;56;1;13;119
"5009";"360810467002";35;2;269;2;24;332
"5010";"360810467003";37;6;93;1;6;143
"5011";"360810467004";40;5;13;0;9;67
"5012";"360810468001";21;2;41;0;25;89
"5013";"360810468002";97;9;87;13;27;233
"5014";"360810469001";79;27;58;4;16;184
"5015";"360810469002";98;9;31;0;11;149
"5016";"360810469003";5;3;47;0;3;58
"5017";"360810469004";17;1;6;0;4;28
"5018";"360810469005";22;1;18;0;7;48
"5019";"360810470001";20;8;57;4;17;106
"5020";"360810470002";81;13;63;10;35;202
"5021";"360810471001";31;41;55;7;22;156
"5022";"360810471002";54;5;63;2;13;137
"5023";"360810472001";33;3;43;1;9;89
"5024";"360810472002";12;2;70;18;14;116
"5025";"360810472003";16;11;3;0;5;35
"5026";"360810473001";13;3;82;0;7;105
"5027";"360810473002";5;8;50;4;61;128
"5028";"360810473003";5;6;17;0;4;32
"5029";"360810475001";21;10;114;1;16;162
"5030";"360810475002";56;6;141;13;16;232
"5031";"360810476001";11;1;3;5;121;141
"5032";"360810476002";6;1;10;3;3;23
"5033";"360810478001";34;4;36;8;13;95
"5034";"360810478002";32;3;50;62;15;162
"5035";"360810478003";40;9;41;11;18;119
"5036";"360810479001";48;5;82;10;18;163
"5037";"360810479002";2;18;41;11;30;102
"5038";"360810479003";13;6;124;8;14;165
"5039";"360810480001";91;10;84;38;17;240
"5040";"360810480002";20;1;33;14;12;80
"5041";"360810481001";32;0;46;2;17;97
"5042";"360810481002";41;0;101;2;10;154
"5043";"360810481003";47;5;19;2;3;76
"5044";"360810481004";29;6;10;1;44;90
"5045";"360810482001";30;9;64;28;29;160
"5046";"360810483001";21;4;91;0;18;134
"5047";"360810483002";43;9;118;25;20;215
"5048";"360810484001";52;7;30;27;16;132
"5049";"360810484002";59;10;59;41;24;193
"5050";"360810484003";11;1;41;15;22;90
"5051";"360810484004";30;7;48;11;15;111
"5052";"360810485001";2;6;44;1;4;57
"5053";"360810485002";5;5;40;11;9;70
"5054";"360810485003";35;15;102;15;28;195
"5055";"360810489001";9;6;134;77;41;267
"5056";"360810489002";5;3;35;22;10;75
"5057";"360810492001";127;10;100;17;13;267
"5058";"360810492002";8;1;9;9;13;40
"5059";"360810492003";88;6;49;24;27;194
"5060";"360810493011";25;2;172;47;25;271
"5061";"360810493012";18;0;83;39;7;147
"5062";"360810493021";17;31;87;13;30;178
"5063";"360810493022";7;2;131;64;28;232
"5064";"360810495001";6;3;95;15;22;141
"5065";"360810496001";37;3;24;15;14;93
"5066";"360810496002";25;2;43;37;25;132
"5067";"360810496003";14;7;46;21;21;109
"5068";"360810497001";25;2;89;31;8;155
"5069";"360810497002";5;6;71;29;16;127
"5070";"360810499001";10;9;62;40;11;132
"5071";"360810499002";17;4;96;19;22;158
"5072";"360810499003";19;2;129;32;24;206
"5073";"360810500001";39;7;36;20;22;124
"5074";"360810500002";65;16;74;42;22;219
"5075";"360810502011";38;5;24;30;14;111
"5076";"360810502021";65;4;25;5;15;114
"5077";"360810504001";41;2;18;26;10;97
"5078";"360810504002";10;2;10;6;11;39
"5079";"360810505001";13;1;99;24;9;146
"5080";"360810506001";15;9;13;16;10;63
"5081";"360810506002";11;4;11;13;7;46
"5082";"360810507001";34;3;111;57;15;220
"5083";"360810507002";14;4;60;37;3;118
"5084";"360810508001";23;11;17;27;17;95
"5085";"360810508002";39;65;31;24;16;175
"5086";"360810510001";9;2;6;26;10;53
"5087";"360810510002";7;4;8;14;8;41
"5088";"360810511001";8;8;120;40;17;193
"5089";"360810511002";0;2;153;24;13;192
"5090";"360810512001";0;1;17;21;9;48
"5091";"360810512002";21;3;18;18;9;69
"5092";"360810512003";5;2;29;29;6;71
"5093";"360810513001";36;1;160;32;19;248
"5094";"360810513002";24;4;103;33;11;175
"5095";"360810515001";4;2;112;25;17;160
"5096";"360810515002";21;5;71;8;5;110
"5097";"360810515003";6;1;75;51;17;150
"5098";"360810516001";8;0;30;21;3;62
"5099";"360810516002";6;5;27;20;13;71
"5100";"360810517001";7;3;78;19;16;123
"5101";"360810517002";16;3;69;50;12;150
"5102";"360810518001";41;15;8;5;5;74
"5103";"360810518002";5;1;21;29;15;71
"5104";"360810520001";19;7;38;30;20;114
"5105";"360810521001";6;8;39;8;9;70
"5106";"360810521002";8;6;134;44;17;209
"5107";"360810522001";37;8;23;21;9;98
"5108";"360810524001";24;2;13;4;9;52
"5109";"360810524002";10;1;33;25;25;94
"5110";"360810525001";3;2;150;54;30;239
"5111";"360810525002";9;17;150;83;16;275
"5112";"360810526001";8;2;32;15;17;74
"5113";"360810526002";8;2;27;17;12;66
"5114";"360810528001";65;15;37;23;16;156
"5115";"360810530001";3;4;9;6;3;25
"5116";"360810530002";12;3;13;23;3;54
"5117";"360810531001";17;8;177;109;23;334
"5118";"360810531002";6;1;87;16;5;115
"5119";"360810531003";3;12;81;26;13;135
"5120";"360810532001";14;8;47;17;5;91
"5121";"360810532002";8;10;19;14;9;60
"5122";"360810534011";22;7;7;14;12;62
"5123";"360810534012";8;0;10;5;8;31
"5124";"360810535001";6;19;163;60;34;282
"5125";"360810536011";5;2;21;19;13;60
"5126";"360810536012";4;2;16;19;3;44
"5127";"360810538001";6;1;8;32;4;51
"5128";"360810538002";37;6;10;31;8;92
"5129";"360810539001";54;24;64;76;11;229
"5130";"360810539002";14;10;56;11;15;106
"5131";"360810539003";151;36;99;9;21;316
"5132";"360810540001";48;6;58;50;41;203
"5133";"360810540002";32;4;34;76;13;159
"5134";"360810540003";27;2;22;25;15;91
"5135";"360810542001";24;2;26;15;8;75
"5136";"360810542002";39;4;31;38;54;166
"5137";"360810542003";27;9;59;30;48;173
"5138";"360810542004";33;11;36;18;40;138
"5139";"360810545001";47;20;112;1;11;191
"5140";"360810545002";19;5;35;1;4;64
"5141";"360810545003";45;18;24;0;10;97
"5142";"360810547001";74;90;46;0;10;220
"5143";"360810547002";67;9;36;2;3;117
"5144";"360810547003";35;14;36;1;11;97
"5145";"360810548001";75;9;24;14;30;152
"5146";"360810548002";9;0;35;12;13;69
"5147";"360810549001";21;15;66;5;10;117
"5148";"360810549002";41;7;50;3;16;117
"5149";"360810549003";51;31;22;0;12;116
"5150";"360810549004";342;34;8;4;15;403
"5151";"360810551001";28;11;38;4;17;98
"5152";"360810551002";15;12;9;0;11;47
"5153";"360810551003";13;8;13;0;35;69
"5154";"360810551004";43;10;10;5;2;70
"5155";"360810552001";28;1;15;20;15;79
"5156";"360810552002";49;7;39;27;20;142
"5157";"360810553001";17;14;105;6;10;152
"5158";"360810553002";66;24;25;3;8;126
"5159";"360810554001";11;1;42;6;14;74
"5160";"360810554002";22;6;32;13;15;88
"5161";"360810555001";8;7;50;2;5;72
"5162";"360810555002";35;33;62;14;14;158
"5163";"360810556001";24;11;23;15;17;90
"5164";"360810556002";10;1;6;7;8;32
"5165";"360810557001";16;14;54;7;18;109
"5166";"360810557002";36;100;82;9;10;237
"5167";"360810557003";19;3;15;3;6;46
"5168";"360810558001";18;4;28;6;16;72
"5169";"360810558002";36;3;27;40;16;122
"5170";"360810559001";38;36;104;37;24;239
"5171";"360810560001";0;0;19;7;5;31
"5172";"360810560002";15;0;8;4;8;35
"5173";"360810561001";1;49;37;19;9;115
"5174";"360810562001";25;5;51;5;20;106
"5175";"360810564001";28;1;21;7;6;63
"5176";"360810565001";138;35;174;68;16;431
"5177";"360810566001";18;2;14;4;10;48
"5178";"360810566002";15;0;37;6;23;81
"5179";"360810567001";17;2;116;82;19;236
"5180";"360810567002";26;7;292;97;120;542
"5181";"360810567003";27;7;167;28;20;249
"5182";"360810567004";34;13;104;1;20;172
"5183";"360810568001";17;6;70;31;23;147
"5184";"360810568002";24;7;15;45;9;100
"5185";"360810568003";4;5;7;19;19;54
"5186";"360810568004";32;5;61;43;15;156
"5187";"360810577001";18;7;53;4;2;84
"5188";"360810577002";46;16;284;17;11;374
"5189";"360810577003";4;5;127;2;5;143
"5190";"360810579001";18;73;33;18;2;144
"5191";"360810579002";37;4;57;15;6;119
"5192";"360810580001";14;2;5;9;5;35
"5193";"360810580002";21;13;8;12;9;63
"5194";"360810580003";36;4;26;22;13;101
"5195";"360810580004";9;1;8;19;9;46
"5196";"360810581001";13;3;123;9;11;159
"5197";"360810581002";13;59;126;1;12;211
"5198";"360810582001";8;5;80;44;20;157
"5199";"360810582002";17;2;56;29;13;117
"5200";"360810582003";4;1;33;25;9;72
"5201";"360810583001";15;33;25;3;22;98
"5202";"360810583002";79;19;144;4;21;267
"5203";"360810583003";2;3;58;3;5;71
"5204";"360810585001";10;6;34;2;39;91
"5205";"360810585002";5;9;93;11;12;130
"5206";"360810585003";21;24;56;4;14;119
"5207";"360810587001";30;3;153;3;8;197
"5208";"360810587002";7;7;33;0;3;50
"5209";"360810587003";7;10;44;0;8;69
"5210";"360810589001";39;8;56;3;13;119
"5211";"360810589002";23;25;46;3;9;106
"5212";"360810589003";37;40;71;3;8;159
"5213";"360810590001";11;1;7;34;6;59
"5214";"360810591001";27;18;67;12;7;131
"5215";"360810591002";16;5;90;6;18;135
"5216";"360810591003";44;6;176;4;13;243
"5217";"360810591004";26;8;158;2;8;202
"5218";"360810592001";14;0;26;62;9;111
"5219";"360810593001";75;7;45;3;4;134
"5220";"360810593002";25;9;150;9;15;208
"5221";"360810594001";0;2;16;20;1;39
"5222";"360810594002";8;0;5;8;0;21
"5223";"360810595001";42;10;92;43;15;202
"5224";"360810595002";19;9;61;4;6;99
"5225";"360810595003";9;8;70;9;10;106
"5226";"360810595004";40;58;105;9;23;235
"5227";"360810596001";1;1;12;31;4;49
"5228";"360810596002";4;1;9;20;3;37
"5229";"360810598001";11;4;19;15;7;56
"5230";"360810598002";12;5;21;18;4;60
"5231";"360810599001";6;1;101;19;6;133
"5232";"360810599002";22;57;77;37;17;210
"5233";"360810600001";10;11;15;15;9;60
"5234";"360810601001";24;9;91;44;18;186
"5235";"360810601002";31;141;60;37;21;290
"5236";"360810603001";12;1;132;48;18;211
"5237";"360810606001";7;1;28;14;10;60
"5238";"360810606002";4;0;5;14;5;28
"5239";"360810607011";0;1;43;18;4;66
"5240";"360810608001";25;108;22;34;9;198
"5241";"360810610001";17;7;23;48;5;100
"5242";"360810612001";1;3;14;17;2;37
"5243";"360810612002";10;0;36;30;10;86
"5244";"360810613011";32;3;184;20;20;259
"5245";"360810613012";26;28;398;33;28;513
"5246";"360810613013";7;5;98;4;16;130
"5247";"360810613014";14;18;41;6;15;94
"5248";"360810613021";0;0;2;1;2;5
"5249";"360810614001";7;0;12;8;13;40
"5250";"360810616011";0;1;9;6;2;18
"5251";"360810616012";1;1;1;8;6;17
"5252";"360810616013";0;0;3;6;9;18
"5253";"360810616021";1;0;14;22;6;43
"5254";"360810616022";6;2;8;8;6;30
"5255";"360810618001";6;0;3;3;2;14
"5256";"360810618002";6;7;12;8;9;42
"5257";"360810619001";14;8;158;51;26;257
"5258";"360810619002";10;1;80;18;6;115
"5259";"360810620001";17;1;13;25;14;70
"5260";"360810621001";47;2;54;10;24;137
"5261";"360810621002";16;0;38;37;8;99
"5262";"360810621003";28;5;76;12;14;135
"5263";"360810622001";1;13;28;21;4;67
"5264";"360810622002";4;1;20;31;4;60
"5265";"360810623001";26;2;61;35;5;129
"5266";"360810623002";20;5;195;41;8;269
"5267";"360810624001";0;0;2;1;0;3
"5268";"360810625001";15;16;89;1;11;132
"5269";"360810625002";55;22;197;7;30;311
"5270";"360810626001";3;5;19;13;1;41
"5271";"360810626002";3;13;19;16;10;61
"5272";"360810626003";7;2;3;10;2;24
"5273";"360810627001";32;2;151;18;23;226
"5274";"360810627002";31;6;97;1;9;144
"5275";"360810629001";14;3;161;22;20;220
"5276";"360810629002";24;10;32;9;3;78
"5277";"360810629003";20;13;66;6;9;114
"5278";"360810630001";1;10;17;21;11;60
"5279";"360810630002";7;0;18;16;4;45
"5280";"360810632001";1;0;12;11;8;32
"5281";"360810632002";18;18;47;27;14;124
"5282";"360810633011";7;3;143;91;14;258
"5283";"360810633021";2;1;54;34;8;99
"5284";"360810633022";10;2;141;22;11;186
"5285";"360810635001";11;0;51;27;7;96
"5286";"360810635002";8;1;84;20;8;121
"5287";"360810637001";6;1;57;51;13;128
"5288";"360810637002";10;4;76;56;21;167
"5289";"360810637003";7;4;39;31;13;94
"5290";"360810638001";18;2;20;14;0;54
"5291";"360810638002";9;14;30;10;9;72
"5292";"360810638003";12;2;17;32;6;69
"5293";"360810638004";5;0;6;32;15;58
"5294";"360810638005";2;6;21;20;4;53
"5295";"360810639001";8;0;117;41;18;184
"5296";"360810639002";36;10;279;17;15;357
"5297";"360810641011";15;5;62;24;2;108
"5298";"360810641021";10;29;107;48;13;207
"5299";"360810645001";3;0;15;21;8;47
"5300";"360810645002";9;6;56;23;18;112
"5301";"360810646001";5;2;22;15;2;46
"5302";"360810646002";11;3;17;34;8;73
"5303";"360810650001";9;2;19;14;3;47
"5304";"360810650002";14;1;9;34;23;81
"5305";"360810654001";7;6;14;40;15;82
"5306";"360810654002";46;5;20;20;10;101
"5307";"360810654003";10;2;15;20;6;53
"5308";"360810655011";0;1;26;9;3;39
"5309";"360810656001";36;21;58;9;19;143
"5310";"360810656002";16;1;6;10;9;42
"5311";"360810656003";37;2;65;30;11;145
"5312";"360810657021";26;12;124;14;21;197
"5313";"360810657031";11;8;172;22;16;229
"5314";"360810657032";18;4;42;10;7;81
"5315";"360810657033";5;2;68;66;15;156
"5316";"360810659001";4;1;35;35;31;106
"5317";"360810659002";6;10;117;20;10;163
"5318";"360810660001";22;3;47;11;20;103
"5319";"360810660002";21;2;17;44;13;97
"5320";"360810661001";11;1;42;15;10;79
"5321";"360810663001";4;2;57;16;4;83
"5322";"360810663002";0;3;55;21;15;94
"5323";"360810663003";0;8;30;31;13;82
"5324";"360810664001";4;1;17;5;3;30
"5325";"360810664002";11;3;19;35;5;73
"5326";"360810664003";25;4;36;20;13;98
"5327";"360810664004";18;4;10;16;12;60
"5328";"360810664005";12;2;24;23;7;68
"5329";"360810664006";21;4;28;15;7;75
"5330";"360810664007";40;1;37;25;8;111
"5331";"360810664008";10;1;56;15;9;91
"5332";"360810665011";2;3;41;18;4;68
"5333";"360810665012";2;1;41;10;4;58
"5334";"360810665013";6;2;60;21;15;104
"5335";"360810665014";20;2;17;5;1;45
"5336";"360810667011";39;3;108;47;31;228
"5337";"360810667012";2;0;82;19;9;112
"5338";"360810669001";24;3;111;10;19;167
"5339";"360810669002";2;0;186;22;25;235
"5340";"360810671001";3;3;46;17;22;91
"5341";"360810671002";1;3;39;42;14;99
"5342";"360810677001";1;0;40;24;6;71
"5343";"360810677002";4;1;37;16;6;64
"5344";"360810679001";2;1;44;22;2;71
"5345";"360810679002";85;5;81;10;9;190
"5346";"360810679003";21;38;313;34;14;420
"5347";"360810680001";19;10;32;28;12;101
"5348";"360810680002";15;2;18;67;22;124
"5349";"360810680003";16;7;38;31;16;108
"5350";"360810680004";17;2;99;22;4;144
"5351";"360810682001";3;0;18;19;8;48
"5352";"360810682002";11;1;20;15;9;56
"5353";"360810683001";84;3;16;3;10;116
"5354";"360810683002";27;11;37;4;26;105
"5355";"360810683003";31;2;31;1;22;87
"5356";"360810687001";2;6;5;1;4;18
"5357";"360810687002";11;5;67;2;3;88
"5358";"360810687003";75;4;227;24;29;359
"5359";"360810690001";22;5;39;47;12;125
"5360";"360810690002";55;3;37;65;12;172
"5361";"360810693001";85;13;247;0;23;368
"5362";"360810693002";9;5;46;6;6;72
"5363";"360810694001";15;5;43;30;5;98
"5364";"360810694002";51;67;81;31;8;238
"5365";"360810695001";31;2;86;15;12;146
"5366";"360810695002";12;3;71;4;6;96
"5367";"360810697011";29;10;11;0;6;56
"5368";"360810697012";19;0;112;1;16;148
"5369";"360810697013";19;9;35;0;9;72
"5370";"360810697021";2;0;11;11;3;27
"5371";"360810697022";1;0;15;36;3;55
"5372";"360810697023";12;1;40;29;6;88
"5373";"360810697024";7;3;21;10;3;44
"5374";"360810703001";6;5;34;29;15;89
"5375";"360810703002";3;2;127;28;16;176
"5376";"360810707001";1;0;8;1;7;17
"5377";"360810707002";2;0;11;0;5;18
"5378";"360810707003";6;0;30;6;2;44
"5379";"360810709001";6;3;59;1;5;74
"5380";"360810709002";11;26;20;3;5;65
"5381";"360810711001";2;3;26;3;3;37
"5382";"360810711002";84;13;111;1;26;235
"5383";"360810711003";3;9;41;1;3;57
"5384";"360810711004";13;36;33;3;25;110
"5385";"360810713031";35;5;40;0;3;83
"5386";"360810713032";47;15;28;1;10;101
"5387";"360810713033";25;8;28;0;2;63
"5388";"360810713041";15;0;12;0;5;32
"5389";"360810713042";6;6;10;0;3;25
"5390";"360810713043";6;0;2;0;1;9
"5391";"360810713044";26;4;39;0;3;72
"5392";"360810713051";10;11;9;0;3;33
"5393";"360810713052";5;12;16;1;2;36
"5394";"360810713053";19;11;74;3;8;115
"5395";"360810713061";79;4;54;2;4;143
"5396";"360810713062";53;9;78;4;13;157
"5397";"360810713063";19;6;34;0;8;67
"5398";"360810713064";12;4;26;5;18;65
"5399";"360810716001";0;0;33;3;8;44
"5400";"360810717011";8;15;6;0;6;35
"5401";"360810717012";25;14;54;0;4;97
"5402";"360810717013";2;3;7;0;1;13
"5403";"360810717014";9;13;40;2;1;65
"5404";"360810717021";9;10;80;2;18;119
"5405";"360810717022";1;1;37;0;1;40
"5406";"360810719001";54;5;64;5;3;131
"5407";"360810719002";47;6;155;4;16;228
"5408";"360810721001";9;7;29;2;1;48
"5409";"360810721002";12;3;10;1;3;29
"5410";"360810721003";41;3;53;1;9;107
"5411";"360810721004";3;2;115;1;0;121
"5412";"360810721005";18;6;111;0;8;143
"5413";"360810723001";1;4;8;7;0;20
"5414";"360810723002";2;2;32;5;7;48
"5415";"360810723003";2;2;14;1;7;26
"5416";"360810729001";19;1;24;2;5;51
"5417";"360810729002";12;5;88;1;14;120
"5418";"360810731001";4;31;6;1;10;52
"5419";"360810731002";20;81;26;3;8;138
"5420";"360810737001";6;75;18;0;24;123
"5421";"360810737002";0;5;4;2;4;15
"5422";"360810739001";3;0;18;0;2;23
"5423";"360810739002";13;6;18;1;0;38
"5424";"360810739003";5;11;9;1;6;32
"5425";"360810739004";4;0;11;5;3;23
"5426";"360810739005";10;7;0;0;3;20
"5427";"360810741001";2;2;13;0;1;18
"5428";"360810741002";13;1;25;5;4;48
"5429";"360810741003";0;1;4;1;0;6
"5430";"360810741004";0;2;16;9;1;28
"5431";"360810743001";0;0;15;1;7;23
"5432";"360810743002";1;1;41;2;10;55
"5433";"360810743003";51;5;29;2;1;88
"5434";"360810743004";18;6;17;1;3;45
"5435";"360810745001";34;1;31;5;5;76
"5436";"360810745002";15;14;52;0;8;89
"5437";"360810747001";81;19;48;8;14;170
"5438";"360810747002";7;8;14;3;4;36
"5439";"360810749001";4;0;6;1;0;11
"5440";"360810749002";2;0;4;2;0;8
"5441";"360810757011";29;89;86;0;24;228
"5442";"360810757012";4;8;4;0;1;17
"5443";"360810757013";11;6;28;0;22;67
"5444";"360810757021";34;2;27;3;4;70
"5445";"360810757022";3;9;57;3;12;84
"5446";"360810757023";5;5;7;1;0;18
"5447";"360810769011";10;18;5;1;4;38
"5448";"360810769012";88;17;32;1;8;146
"5449";"360810769021";12;15;63;8;19;117
"5450";"360810773001";7;31;35;0;0;73
"5451";"360810773002";16;1;20;2;6;45
"5452";"360810775001";30;3;40;11;14;98
"5453";"360810775002";15;0;65;2;11;93
"5454";"360810775003";9;115;41;1;6;172
"5455";"360810779021";1;2;20;2;3;28
"5456";"360810779022";0;1;31;2;8;42
"5457";"360810779023";0;4;20;5;2;31
"5458";"360810779024";3;6;4;0;1;14
"5459";"360810779025";0;0;17;2;9;28
"5460";"360810779031";4;1;14;1;3;23
"5461";"360810779032";12;0;6;0;0;18
"5462";"360810779033";13;4;18;2;0;37
"5463";"360810779041";6;0;2;7;9;24
"5464";"360810779042";15;3;47;2;21;88
"5465";"360810779043";10;6;44;3;9;72
"5466";"360810779044";10;2;37;1;8;58
"5467";"360810779051";6;12;41;16;11;86
"5468";"360810779052";1;1;5;0;0;7
"5469";"360810779061";13;8;26;7;5;59
"5470";"360810779062";17;4;93;63;18;195
"5471";"360810779071";22;4;47;12;17;102
"5472";"360810779072";21;4;36;3;7;71
"5473";"360810779081";16;4;14;1;4;39
"5474";"360810779082";59;12;36;4;6;117
"5475";"360810788001";35;5;33;27;12;112
"5476";"360810788002";14;1;18;15;5;53
"5477";"360810790001";18;4;40;35;31;128
"5478";"360810790002";47;11;72;65;24;219
"5479";"360810792001";79;8;42;41;14;184
"5480";"360810792002";22;0;47;33;16;118
"5481";"360810793001";0;0;1;1;0;2
"5482";"360810797011";4;1;6;0;0;11
"5483";"360810797012";20;0;0;0;4;24
"5484";"360810797013";2;0;3;0;2;7
"5485";"360810797014";0;0;6;1;12;19
"5486";"360810797021";2;5;134;3;9;153
"5487";"360810797022";23;0;61;7;24;115
"5488";"360810797023";6;0;6;0;3;15
"5489";"360810799001";30;24;238;13;50;355
"5490";"360810799002";19;6;254;1;25;305
"5491";"360810803011";12;3;53;3;16;87
"5492";"360810803012";14;0;143;3;11;171
"5493";"360810803013";25;4;74;7;15;125
"5494";"360810803021";7;1;35;27;13;83
"5495";"360810803022";5;1;60;23;29;118
"5496";"360810803023";2;2;38;20;5;67
"5497";"360810809001";19;8;27;3;3;60
"5498";"360810809002";9;1;69;3;0;82
"5499";"360810809003";3;0;27;2;10;42
"5500";"360810809004";13;6;92;12;21;144
"5501";"360810809005";1;1;24;3;2;31
"5502";"360810809006";2;1;11;21;1;36
"5503";"360810809007";5;6;60;45;3;119
"5504";"360810814001";24;3;67;43;34;171
"5505";"360810814002";17;5;32;20;22;96
"5506";"360810814003";38;1;22;44;23;128
"5507";"360810818001";41;55;61;35;32;224
"5508";"360810818002";53;2;26;34;25;140
"5509";"360810818003";25;7;64;28;30;154
"5510";"360810837001";8;12;50;15;19;104
"5511";"360810837002";9;0;83;29;46;167
"5512";"360810837003";4;1;68;18;8;99
"5513";"360810837004";15;9;71;19;25;139
"5514";"360810838001";29;4;58;74;29;194
"5515";"360810838002";44;9;33;16;37;139
"5516";"360810838003";34;4;60;24;30;152
"5517";"360810838004";35;9;94;21;30;189
"5518";"360810840001";69;41;88;66;29;293
"5519";"360810840002";102;57;76;27;40;302
"5520";"360810840003";26;7;61;16;28;138
"5521";"360810840004";31;4;70;18;18;141
"5522";"360810840005";79;6;58;15;28;186
"5523";"360810845001";11;0;3;0;1;15
"5524";"360810845002";98;5;8;0;9;120
"5525";"360810845003";6;3;131;3;38;181
"5526";"360810846011";64;8;97;41;33;243
"5527";"360810846012";40;4;106;36;21;207
"5528";"360810846021";21;5;131;129;13;299
"5529";"360810849001";20;3;65;2;31;121
"5530";"360810849002";16;3;40;1;13;73
"5531";"360810849003";37;4;113;10;19;183
"5532";"360810849004";1;3;123;5;28;160
"5533";"360810853001";5;10;18;1;41;75
"5534";"360810853002";5;5;7;0;14;31
"5535";"360810853003";2;10;67;0;3;82
"5536";"360810853004";3;1;12;1;13;30
"5537";"360810855001";29;18;6;0;6;59
"5538";"360810855002";22;11;17;1;9;60
"5539";"360810855003";9;0;24;0;4;37
"5540";"360810855004";23;22;72;0;5;122
"5541";"360810857001";14;21;22;1;12;70
"5542";"360810857002";34;1;37;3;2;77
"5543";"360810857003";41;1;25;0;10;77
"5544";"360810859001";15;1;20;0;18;54
"5545";"360810859002";18;4;63;1;79;165
"5546";"360810859003";8;5;54;0;10;77
"5547";"360810861001";12;0;22;0;6;40
"5548";"360810861002";4;2;28;2;39;75
"5549";"360810863001";10;1;9;0;4;24
"5550";"360810863002";7;4;28;0;0;39
"5551";"360810863003";103;0;3;0;11;117
"5552";"360810863004";28;1;37;0;74;140
"5553";"360810864001";41;28;137;13;34;253
"5554";"360810864002";35;12;45;18;21;131
"5555";"360810865001";7;8;42;2;6;65
"5556";"360810865002";11;48;34;1;39;133
"5557";"360810869001";11;13;87;8;23;142
"5558";"360810869002";3;5;131;13;15;167
"5559";"360810871001";174;23;29;0;40;266
"5560";"360810871002";7;35;70;6;49;167
"5561";"360810884001";26;4;30;36;22;118
"5562";"360810884002";1;0;21;11;7;40
"5563";"360810884003";4;0;17;13;19;53
"5564";"360810884004";3;5;8;11;23;50
"5565";"360810884005";17;4;10;5;7;43
"5566";"360810884006";34;10;130;38;27;239
"5567";"360810884007";1;0;18;14;2;35
"5568";"360810884008";5;2;36;20;8;71
"5569";"360810889011";69;0;124;35;44;272
"5570";"360810889012";11;5;5;7;1;29
"5571";"360810889013";6;7;13;0;1;27
"5572";"360810889014";2;2;10;0;3;17
"5573";"360810889015";3;2;12;0;1;18
"5574";"360810889016";60;19;38;1;12;130
"5575";"360810889017";14;4;32;0;16;66
"5576";"360810892001";25;5;11;7;30;78
"5577";"360810892002";47;12;34;10;5;108
"5578";"360810892003";13;6;23;17;14;73
"5579";"360810892004";3;3;9;16;18;49
"5580";"360810892005";5;3;10;10;16;44
"5581";"360810892006";4;1;6;3;15;29
"5582";"360810892007";2;1;5;5;14;27
"5583";"360810892008";7;94;11;2;15;129
"5584";"360810907001";14;12;183;64;28;301
"5585";"360810916011";0;2;1;0;2;5
"5586";"360810916012";2;1;0;0;3;6
"5587";"360810916013";1;0;0;1;1;3
"5588";"360810916014";8;1;14;0;5;28
"5589";"360810916021";0;0;10;2;1;13
"5590";"360810918001";0;2;0;0;0;2
"5591";"360810919001";24;1;62;12;16;115
"5592";"360810919002";72;31;161;31;35;330
"5593";"360810919003";26;4;95;40;15;180
"5594";"360810922001";7;0;2;2;5;16
"5595";"360810922002";6;0;6;4;0;16
"5596";"360810922003";3;0;41;0;12;56
"5597";"360810925001";56;19;94;55;12;236
"5598";"360810925002";61;17;92;29;15;214
"5599";"360810925003";48;6;121;17;17;209
"5600";"360810928001";15;14;14;0;10;53
"5601";"360810928002";10;2;49;1;14;76
"5602";"360810928003";2;0;5;4;4;15
"5603";"360810929000";0;1;0;0;0;1
"5604";"360810929001";100;15;160;88;37;400
"5605";"360810929002";19;6;175;125;35;360
"5606";"360810929003";17;2;61;34;10;124
"5607";"360810929004";4;1;28;17;2;52
"5608";"360810934011";2;5;13;3;6;29
"5609";"360810934012";7;2;33;3;5;50
"5610";"360810934013";4;3;49;0;7;63
"5611";"360810934021";45;5;63;6;14;133
"5612";"360810934022";0;1;43;0;8;52
"5613";"360810934023";28;2;75;11;24;140
"5614";"360810938001";8;1;8;1;25;43
"5615";"360810938002";26;18;280;1;17;342
"5616";"360810938003";102;92;85;3;96;378
"5617";"360810939001";71;18;132;53;49;323
"5618";"360810939002";26;5;84;47;15;177
"5619";"360810939003";31;3;75;66;29;204
"5620";"360810942011";103;129;102;17;26;377
"5621";"360810942020";0;1;0;0;0;1
"5622";"360810942021";250;70;100;21;4;445
"5623";"360810942022";86;24;65;13;21;209
"5624";"360810942031";50;49;52;1;18;170
"5625";"360810942032";1;18;26;3;2;50
"5626";"360810942033";10;9;17;0;0;36
"5627";"360810942034";3;4;9;1;5;22
"5628";"360810942035";3;23;7;4;1;38
"5629";"360810945000";0;0;2;0;0;2
"5630";"360810945001";19;23;94;51;22;209
"5631";"360810945002";21;13;51;22;45;152
"5632";"360810947001";33;82;121;30;28;294
"5633";"360810947002";47;7;78;84;24;240
"5634";"360810954001";43;6;27;6;9;91
"5635";"360810954002";64;11;22;5;9;111
"5636";"360810954003";21;5;45;13;18;102
"5637";"360810964001";46;4;32;6;25;113
"5638";"360810964002";30;45;69;32;25;201
"5639";"360810972021";140;10;3;4;16;173
"5640";"360810972031";25;4;3;20;7;59
"5641";"360810972032";33;8;5;0;6;52
"5642";"360810972033";27;6;19;3;7;62
"5643";"360810972034";67;7;4;0;0;78
"5644";"360810972041";17;11;6;1;1;36
"5645";"360810972042";8;3;29;11;12;63
"5646";"360810972043";0;3;3;0;0;6
"5647";"360810973001";7;28;24;12;4;75
"5648";"360810973002";12;3;10;7;3;35
"5649";"360810973003";1;7;8;7;16;39
"5650";"360810981001";12;6;23;12;14;67
"5651";"360810981002";9;8;27;10;13;67
"5652";"360810987001";20;15;49;30;32;146
"5653";"360810987002";24;31;59;19;31;164
"5654";"360810991001";4;6;25;14;2;51
"5655";"360810991002";1;0;17;2;3;23
"5656";"360810991003";2;4;14;16;8;44
"5657";"360810991004";10;1;16;9;11;47
"5658";"360810991005";3;1;26;23;9;62
"5659";"360810992001";54;7;34;10;10;115
"5660";"360810992002";362;11;33;19;11;436
"5661";"360810997011";4;3;12;8;5;32
"5662";"360810997012";12;2;40;5;11;70
"5663";"360810997013";0;4;31;10;2;47
"5664";"360810997031";25;2;55;15;13;110
"5665";"360810997032";0;2;5;6;0;13
"5666";"360810997033";3;3;16;26;7;55
"5667";"360810997041";23;0;15;13;17;68
"5668";"360810997042";37;1;31;9;6;84
"5669";"360810997043";5;1;13;2;9;30
"5670";"360810997044";2;12;13;2;5;34
"5671";"360810997051";13;4;31;20;12;80
"5672";"360810998011";21;6;58;11;19;115
"5673";"360810998012";51;2;13;0;6;72
"5674";"360810998013";79;3;77;4;9;172
"5675";"360810998014";1;0;2;0;1;4
"5676";"360810998015";38;3;64;6;12;123
"5677";"360810998021";72;39;25;18;21;175
"5678";"360810998022";18;1;2;1;2;24
"5679";"360810998023";5;4;0;0;1;10
"5680";"360810999001";0;2;2;0;5;9
"5681";"360811008011";88;14;20;16;1;139
"5682";"360811008012";36;6;18;11;15;86
"5683";"360811008021";57;22;56;5;18;158
"5684";"360811008022";14;1;37;14;11;77
"5685";"360811008023";38;2;17;8;13;78
"5686";"360811008024";33;7;17;22;12;91
"5687";"360811010011";83;12;65;5;10;175
"5688";"360811010012";28;5;36;11;8;88
"5689";"360811010013";29;83;95;3;16;226
"5690";"360811010014";51;6;26;2;9;94
"5691";"360811010021";1;3;30;7;3;44
"5692";"360811010022";162;13;61;6;13;255
"5693";"360811017001";4;2;38;4;4;52
"5694";"360811017002";17;1;17;15;11;61
"5695";"360811017003";8;3;11;6;8;36
"5696";"360811017004";2;0;37;9;3;51
"5697";"360811017005";2;2;9;4;9;26
"5698";"360811017006";8;20;49;22;15;114
"5699";"360811017007";0;2;18;12;2;34
"5700";"360811029001";10;3;92;31;15;151
"5701";"360811029002";5;14;33;19;11;82
"5702";"360811032011";69;1;49;24;15;158
"5703";"360811032012";69;5;24;4;29;131
"5704";"360811032013";72;14;15;5;5;111
"5705";"360811032021";17;2;43;10;20;92
"5706";"360811032022";5;0;2;10;2;19
"5707";"360811032023";67;11;32;14;3;127
"5708";"360811032024";53;2;29;2;9;95
"5709";"360811033001";5;1;44;19;18;87
"5710";"360811033002";4;2;41;14;18;79
"5711";"360811033003";5;1;12;2;12;32
"5712";"360811033004";3;0;9;9;9;30
"5713";"360811039001";13;7;69;21;9;119
"5714";"360811039002";16;3;115;54;34;222
"5715";"360811039003";14;16;39;19;31;119
"5716";"360811039004";17;5;35;23;11;91
"5717";"360811047001";10;5;42;19;26;102
"5718";"360811047002";3;2;28;27;11;71
"5719";"360811047003";20;7;51;18;12;108
"5720";"360811047004";6;1;89;19;11;126
"5721";"360811047005";7;1;108;44;20;180
"5722";"360811059001";8;6;6;2;12;34
"5723";"360811059002";20;1;19;10;18;68
"5724";"360811059003";1;4;3;6;11;25
"5725";"360811059004";0;2;21;7;36;66
"5726";"360811072011";24;10;135;60;33;262
"5727";"360811072020";2;2;4;2;1;11
"5728";"360811072021";0;0;2;0;1;3
"5729";"360811085001";8;3;25;14;4;54
"5730";"360811085002";3;3;41;6;26;79
"5731";"360811085003";2;0;35;14;27;78
"5732";"360811093001";0;2;5;2;5;14
"5733";"360811093002";2;2;13;3;9;29
"5734";"360811093003";9;1;7;2;8;27
"5735";"360811097001";2;3;3;5;10;23
"5736";"360811097002";16;3;26;23;8;76
"5737";"360811097003";3;0;11;9;6;29
"5738";"360811099001";2;3;31;12;31;79
"5739";"360811099002";12;0;17;7;12;48
"5740";"360811099003";10;64;42;5;17;138
"5741";"360811113001";7;0;29;0;6;42
"5742";"360811113002";0;0;14;13;13;40
"5743";"360811113003";7;1;8;6;2;24
"5744";"360811123001";11;4;62;2;7;86
"5745";"360811123002";9;42;96;7;23;177
"5746";"360811129001";8;0;22;1;10;41
"5747";"360811129002";1;1;12;1;2;17
"5748";"360811129003";13;2;23;4;4;46
"5749";"360811133001";6;3;9;4;3;25
"5750";"360811133002";1;3;11;9;8;32
"5751";"360811139001";8;2;43;4;8;65
"5752";"360811139002";35;2;53;9;6;105
"5753";"360811139003";12;1;28;9;9;59
"5754";"360811141001";5;19;18;13;17;72
"5755";"360811141002";5;4;23;4;9;45
"5756";"360811147001";3;0;18;9;15;45
"5757";"360811147002";4;1;23;17;12;57
"5758";"360811151001";2;20;26;7;23;78
"5759";"360811155001";34;1;32;6;19;92
"5760";"360811155002";10;19;18;2;12;61
"5761";"360811157001";2;9;42;3;17;73
"5762";"360811157002";57;9;39;1;4;110
"5763";"360811157003";6;1;33;0;4;44
"5764";"360811159001";0;3;5;0;2;10
"5765";"360811159002";8;4;48;5;9;74
"5766";"360811159003";103;1;69;0;3;176
"5767";"360811161001";59;5;63;1;23;151
"5768";"360811161002";39;2;18;0;6;65
"5769";"360811163001";18;0;3;0;3;24
"5770";"360811163002";14;1;24;0;11;50
"5771";"360811163003";21;5;56;0;7;89
"5772";"360811163004";80;6;10;2;9;107
"5773";"360811163005";21;53;72;0;11;157
"5774";"360811167001";18;26;518;5;34;601
"5775";"360811171001";8;42;70;16;31;167
"5776";"360811171002";9;11;25;2;13;60
"5777";"360811171003";12;2;37;2;13;66
"5778";"360811175001";5;2;68;1;14;90
"5779";"360811175002";26;5;85;4;9;129
"5780";"360811175003";6;2;52;5;2;67
"5781";"360811175004";20;37;83;15;27;182
"5782";"360811181001";3;2;82;12;16;115
"5783";"360811181002";7;2;82;25;18;134
"5784";"360811185001";5;6;62;32;19;124
"5785";"360811185002";4;7;68;8;13;100
"5786";"360811187001";13;0;27;3;9;52
"5787";"360811187002";13;4;202;20;26;265
"5788";"360811189001";3;1;89;17;31;141
"5789";"360811189002";2;1;42;6;22;73
"5790";"360811191001";22;4;71;15;33;145
"5791";"360811191002";2;3;49;4;20;78
"5792";"360811193001";5;3;49;8;22;87
"5793";"360811193002";9;5;51;4;6;75
"5794";"360811195001";21;3;70;21;19;134
"5795";"360811199001";34;3;52;32;20;141
"5796";"360811201001";9;0;73;6;39;127
"5797";"360811203001";6;1;27;2;15;51
"5798";"360811203002";3;6;18;1;26;54
"5799";"360811205001";18;12;231;3;33;297
"5800";"360811207001";6;1;19;16;11;53
"5801";"360811207002";7;3;62;19;38;129
"5802";"360811211001";1;3;26;8;0;38
"5803";"360811215001";41;1;85;18;15;160
"5804";"360811215002";5;4;82;36;23;150
"5805";"360811215003";13;2;175;24;24;238
"5806";"360811223001";19;4;123;9;14;169
"5807";"360811223002";3;2;48;14;21;88
"5808";"360811223003";32;4;44;27;29;136
"5809";"360811227011";9;14;150;7;16;196
"5810";"360811227012";6;1;99;18;9;133
"5811";"360811227013";18;5;134;21;36;214
"5812";"360811227014";20;2;22;1;2;47
"5813";"360811227015";71;3;95;4;6;179
"5814";"360811227016";0;0;1;1;0;2
"5815";"360811227017";25;3;34;7;4;73
"5816";"360811227021";213;1;7;13;3;237
"5817";"360811227022";45;14;38;10;15;122
"5818";"360811227023";309;8;8;18;8;351
"5819";"360811227024";8;0;42;21;11;82
"5820";"360811227025";11;4;17;9;5;46
"5821";"360811241001";14;2;53;25;5;99
"5822";"360811241002";4;0;17;13;17;51
"5823";"360811241003";57;6;54;13;9;139
"5824";"360811247001";14;1;28;28;11;82
"5825";"360811247002";11;2;23;12;13;61
"5826";"360811247003";28;2;29;11;9;79
"5827";"360811257001";19;13;81;8;14;135
"5828";"360811257002";225;284;223;3;601;1336
"5829";"360811257003";88;338;598;6;261;1291
"5830";"360811265001";26;2;29;10;10;77
"5831";"360811265002";12;29;29;6;469;545
"5832";"360811267001";45;10;28;10;10;103
"5833";"360811267002";11;2;100;24;29;166
"5834";"360811267003";74;2;27;5;29;137
"5835";"360811277001";25;8;35;14;6;88
"5836";"360811277002";47;3;23;8;17;98
"5837";"360811277003";7;1;10;20;2;40
"5838";"360811277004";0;5;16;10;7;38
"5839";"360811283001";1;23;81;3;4;112
"5840";"360811291021";8;1;20;13;14;56
"5841";"360811291022";16;3;5;2;3;29
"5842";"360811291023";4;0;1;0;13;18
"5843";"360811291024";7;1;3;3;4;18
"5844";"360811291031";5;1;10;4;3;23
"5845";"360811291032";21;1;6;7;0;35
"5846";"360811291033";8;1;16;9;3;37
"5847";"360811291041";4;2;1;0;2;9
"5848";"360811291042";5;0;13;5;2;25
"5849";"360811291043";2;19;24;2;2;49
"5850";"360811291044";0;0;8;5;6;19
"5851";"360811291045";3;1;78;2;1;85
"5852";"360811301001";1;1;27;4;10;43
"5853";"360811301002";4;5;5;1;4;19
"5854";"360811301003";50;1;32;17;14;114
"5855";"360811301004";3;0;25;11;12;51
"5856";"360811333001";8;1;62;46;5;122
"5857";"360811333002";1;0;46;5;5;57
"5858";"360811333003";36;5;51;8;21;121
"5859";"360811333004";22;7;46;24;9;108
"5860";"360811339001";65;4;64;21;14;168
"5861";"360811341001";8;2;94;28;36;168
"5862";"360811341002";14;1;33;36;20;104
"5863";"360811341003";2;0;30;10;10;52
"5864";"360811347001";18;10;39;10;3;80
"5865";"360811347002";1;1;66;17;3;88
"5866";"360811347003";3;3;25;10;1;42
"5867";"360811347004";21;1;40;9;7;78
"5868";"360811347005";44;4;71;15;5;139
"5869";"360811367001";9;20;55;8;11;103
"5870";"360811367002";9;5;6;6;5;31
"5871";"360811367003";7;0;26;4;0;37
"5872";"360811367004";3;2;16;12;8;41
"5873";"360811367005";0;2;28;47;2;79
"5874";"360811377001";15;2;23;3;1;44
"5875";"360811377002";9;1;50;12;8;80
"5876";"360811377003";3;2;45;9;7;66
"5877";"360811377004";9;0;19;10;14;52
"5878";"360811385011";4;4;26;1;3;38
"5879";"360811385012";9;1;59;5;6;80
"5880";"360811385013";2;3;30;7;8;50
"5881";"360811385014";4;1;40;17;27;89
"5882";"360811385021";0;6;13;2;2;23
"5883";"360811399001";0;0;13;8;9;30
"5884";"360811399002";5;1;10;7;6;29
"5885";"360811403001";0;0;8;3;1;12
"5886";"360811403002";2;1;16;9;32;60
"5887";"360811409011";1;0;10;6;9;26
"5888";"360811409021";13;3;33;9;27;85
"5889";"360811409022";7;6;39;6;11;69
"5890";"360811417001";4;1;13;15;8;41
"5891";"360811417002";4;4;13;4;22;47
"5892";"360811417003";1;1;1;4;14;21
"5893";"360811417004";8;0;18;11;12;49
"5894";"360811417005";5;1;34;1;9;50
"5895";"360811429001";2;0;11;0;9;22
"5896";"360811429002";15;4;15;5;19;58
"5897";"360811429003";4;1;14;3;14;36
"5898";"360811429004";2;3;21;31;13;70
"5899";"360811435001";5;1;30;6;19;61
"5900";"360811435002";4;0;13;8;7;32
"5901";"360811441001";4;0;7;1;4;16
"5902";"360811441002";10;3;11;0;1;25
"5903";"360811441003";2;0;8;2;0;12
"5904";"360811441004";2;0;8;1;3;14
"5905";"360811447001";12;1;85;6;37;141
"5906";"360811447002";5;10;87;45;35;182
"5907";"360811451011";7;9;20;8;22;66
"5908";"360811451021";6;2;9;11;10;38
"5909";"360811451022";41;0;22;32;14;109
"5910";"360811459001";5;4;9;3;2;23
"5911";"360811459002";8;16;14;10;20;68
"5912";"360811459003";7;1;14;14;6;42
"5913";"360811463001";8;1;52;14;20;95
"5914";"360811463002";11;2;73;55;14;155
"5915";"360811467001";10;38;117;12;22;199
"5916";"360811467002";26;2;4;0;3;35
"5917";"360811467003";14;1;68;8;7;98
"5918";"360811471001";9;6;130;23;31;199
"5919";"360811471002";22;0;30;5;8;65
"5920";"360811479001";8;6;66;4;17;101
"5921";"360811479002";4;4;70;3;11;92
"5922";"360811479003";2;4;43;5;8;62
"5923";"360811483001";4;0;18;6;6;34
"5924";"360811483002";8;3;35;5;13;64
"5925";"360811483003";10;2;8;2;8;30
"5926";"360811483004";5;2;6;6;7;26
"5927";"360811507011";8;4;11;11;16;50
"5928";"360811507012";2;2;11;9;7;31
"5929";"360811507013";4;2;10;8;4;28
"5930";"360811507021";1;0;13;7;7;28
"5931";"360811507022";4;0;7;5;1;17
"5932";"360811507023";5;2;11;3;4;25
"5933";"360811507024";4;54;60;4;7;129
"5934";"360811529011";1;2;29;7;8;47
"5935";"360811529012";21;5;103;9;8;146
"5936";"360811529013";0;9;31;14;10;64
"5937";"360811529021";1;1;6;9;1;18
"5938";"360811529022";1;1;11;10;3;26
"5939";"360811529023";13;1;30;2;20;66
"5940";"360811529024";2;5;19;3;5;34
"5941";"360811551011";0;0;0;0;2;2
"5942";"360811551021";3;4;81;4;4;96
"5943";"360811551022";1;0;5;9;3;18
"5944";"360811551023";11;11;95;8;16;141
"5945";"360811551024";0;2;29;9;10;50
"5946";"360811551025";0;1;17;4;1;23
"5947";"360811551026";0;0;9;9;1;19
"5948";"360811567001";6;3;29;5;11;54
"5949";"360811571011";1;1;9;6;3;20
"5950";"360811571012";4;65;57;1;23;150
"5951";"360811571013";0;0;13;10;2;25
"5952";"360811571014";9;1;12;15;14;51
"5953";"360811571015";31;1;10;17;13;72
"5954";"360811571016";9;9;19;21;19;77
"5955";"360811571017";3;9;32;8;19;71
"5956";"360811571018";1;2;10;4;5;22
"5957";"360811571021";1;0;26;9;8;44
"5958";"360811571022";1;4;41;16;16;78
"5959";"360811579011";8;2;13;6;12;41
"5960";"360811579012";0;0;6;4;12;22
"5961";"360811579013";0;0;5;8;4;17
"5962";"360811579014";13;2;8;5;3;31
"5963";"360811579015";3;0;17;8;5;33
"5964";"360811579016";1;18;11;6;26;62
"5965";"360811579021";2;40;7;6;10;65
"5966";"360811579022";36;0;22;8;5;71
"5967";"360811579023";5;42;11;4;4;66
"5968";"360811579024";11;0;3;7;5;26
"5969";"360811579025";1;28;17;5;11;62
"5970";"360811579031";20;0;12;5;11;48
"5971";"360811579032";7;8;20;5;17;57
"5972";"360811579033";4;0;19;13;14;50
"5973";"360811579034";10;15;171;36;8;240
"5974";"360811617001";9;2;40;20;27;98
"5975";"360811617002";8;2;5;14;11;40
"5976";"360811617003";0;1;24;11;32;68
"5977";"360811617004";26;7;63;33;24;153
"5978";"360811621001";39;5;17;8;17;86
"5979";"360811621002";34;11;41;14;27;127
"5980";"360811621003";24;1;14;17;11;67
"5981";"360811621004";8;1;14;9;24;56
"5982";"360811621005";32;7;83;16;17;155
"5983";"360850003001";9;1;41;3;19;73
"5984";"360850003002";7;16;24;23;17;87
"5985";"360850006001";2;68;15;26;17;128
"5986";"360850006002";6;6;54;27;19;112
"5987";"360850007001";89;13;10;6;20;138
"5988";"360850007002";15;7;106;8;8;144
"5989";"360850007003";18;8;65;17;1;109
"5990";"360850007004";85;5;55;10;11;166
"5991";"360850008001";23;7;29;19;21;99
"5992";"360850008002";40;3;56;8;9;116
"5993";"360850008003";10;9;33;24;12;88
"5994";"360850009001";102;7;132;25;13;279
"5995";"360850009002";18;7;27;19;21;92
"5996";"360850011001";18;28;44;40;23;153
"5997";"360850011002";38;3;17;17;17;92
"5998";"360850011003";27;1;36;19;16;99
"5999";"360850017001";3;0;10;4;6;23
"6000";"360850017002";12;7;27;25;5;76
"6001";"360850018001";0;0;0;0;2;2
"6002";"360850020011";12;1;63;55;12;143
"6003";"360850020012";7;0;39;3;6;55
"6004";"360850020021";37;5;54;39;11;146
"6005";"360850020022";4;3;25;24;7;63
"6006";"360850021001";115;11;37;30;32;225
"6007";"360850021002";41;117;70;44;56;328
"6008";"360850021003";57;119;62;50;30;318
"6009";"360850027001";45;25;44;54;33;201
"6010";"360850029001";18;10;146;67;18;259
"6011";"360850029002";128;51;3;6;1;189
"6012";"360850029003";47;23;52;25;17;164
"6013";"360850029004";15;5;18;22;7;67
"6014";"360850033001";13;1;36;16;9;75
"6015";"360850033002";50;11;147;99;32;339
"6016";"360850036001";19;2;43;25;15;104
"6017";"360850036002";38;4;24;9;9;84
"6018";"360850039001";5;0;28;7;0;40
"6019";"360850039002";24;0;99;22;8;153
"6020";"360850040001";44;2;39;30;17;132
"6021";"360850040002";132;22;13;22;8;197
"6022";"360850040003";159;4;19;15;4;201
"6023";"360850040004";20;3;24;10;5;62
"6024";"360850040005";8;20;13;5;8;54
"6025";"360850040006";32;2;18;8;8;68
"6026";"360850040007";20;2;17;19;12;70
"6027";"360850047001";13;8;33;28;18;100
"6028";"360850047002";4;9;21;7;2;43
"6029";"360850050001";7;4;18;19;6;54
"6030";"360850050002";10;1;27;11;5;54
"6031";"360850050003";4;2;17;22;0;45
"6032";"360850059001";43;17;117;29;10;216
"6033";"360850059002";18;10;30;1;13;72
"6034";"360850064001";12;0;18;5;7;42
"6035";"360850064002";4;1;13;7;11;36
"6036";"360850064003";84;18;108;10;6;226
"6037";"360850067001";6;3;7;3;10;29
"6038";"360850067002";11;4;38;13;14;80
"6039";"360850067003";5;1;6;14;5;31
"6040";"360850070001";26;19;88;51;32;216
"6041";"360850070002";6;2;78;6;8;100
"6042";"360850070003";29;21;45;41;25;161
"6043";"360850070004";12;3;34;14;20;83
"6044";"360850074001";15;6;127;52;8;208
"6045";"360850074002";34;8;53;30;22;147
"6046";"360850075001";29;10;35;17;10;101
"6047";"360850075002";20;1;53;4;7;85
"6048";"360850075003";24;6;50;20;12;112
"6049";"360850077001";31;5;13;28;10;87
"6050";"360850081001";24;31;30;23;9;117
"6051";"360850081002";28;7;21;9;7;72
"6052";"360850081003";148;37;22;41;26;274
"6053";"360850096011";35;2;46;14;21;118
"6054";"360850096012";11;1;63;20;14;109
"6055";"360850096021";4;1;25;11;7;48
"6056";"360850096022";22;1;29;21;10;83
"6057";"360850096023";3;6;42;12;12;75
"6058";"360850097001";15;8;35;37;18;113
"6059";"360850097002";22;1;33;20;11;87
"6060";"360850097003";2;10;13;10;14;49
"6061";"360850105001";8;20;12;17;8;65
"6062";"360850105002";6;8;14;6;7;41
"6063";"360850105003";5;5;31;7;3;51
"6064";"360850105004";21;7;60;33;20;141
"6065";"360850105005";56;24;20;35;10;145
"6066";"360850112011";20;8;56;19;35;138
"6067";"360850112012";43;28;74;31;32;208
"6068";"360850112021";38;9;57;21;22;147
"6069";"360850112022";26;37;50;33;15;161
"6070";"360850112023";23;8;37;19;13;100
"6071";"360850112024";0;1;2;3;0;6
"6072";"360850114011";10;11;40;7;9;77
"6073";"360850114012";284;11;24;4;13;336
"6074";"360850114021";6;1;12;9;12;40
"6075";"360850114022";27;2;10;8;15;62
"6076";"360850114023";0;1;9;6;4;20
"6077";"360850121001";2;0;19;17;4;42
"6078";"360850121002";2;2;20;8;4;36
"6079";"360850121003";4;2;31;7;9;53
"6080";"360850122001";7;2;14;3;4;30
"6081";"360850122002";3;13;14;16;6;52
"6082";"360850122003";3;3;13;6;5;30
"6083";"360850122004";23;165;14;17;12;231
"6084";"360850125001";410;79;51;54;70;664
"6085";"360850125002";44;31;39;16;5;135
"6086";"360850125003";13;2;12;3;2;32
"6087";"360850128041";58;7;85;53;33;236
"6088";"360850128042";43;4;105;29;50;231
"6089";"360850128051";5;3;47;29;36;120
"6090";"360850128061";3;2;13;6;7;31
"6091";"360850128062";12;2;11;8;1;34
"6092";"360850128063";16;4;42;7;23;92
"6093";"360850128064";34;8;62;19;24;147
"6094";"360850132011";5;2;6;2;2;17
"6095";"360850132012";0;2;20;1;4;27
"6096";"360850132031";14;0;30;8;4;56
"6097";"360850132032";5;2;33;9;11;60
"6098";"360850132033";22;5;40;21;17;105
"6099";"360850132041";6;0;26;13;15;60
"6100";"360850132042";7;2;35;18;11;73
"6101";"360850132043";7;1;17;19;14;58
"6102";"360850133011";128;3;12;12;12;167
"6103";"360850133021";8;3;50;38;17;116
"6104";"360850133022";18;11;48;52;17;146
"6105";"360850133023";80;8;73;76;25;262
"6106";"360850134001";17;0;36;12;12;77
"6107";"360850134002";6;2;36;16;11;71
"6108";"360850134003";4;0;28;20;17;69
"6109";"360850138001";8;1;3;3;6;21
"6110";"360850138002";8;0;39;8;17;72
"6111";"360850138003";1;1;28;8;4;42
"6112";"360850138004";1;0;11;12;11;35
"6113";"360850138005";7;5;19;13;20;64
"6114";"360850141001";24;5;19;21;12;81
"6115";"360850141002";23;2;14;26;12;77
"6116";"360850146041";2;2;37;3;7;51
"6117";"360850146042";9;10;26;6;10;61
"6118";"360850146043";16;5;48;13;6;88
"6119";"360850146044";5;0;56;7;7;75
"6120";"360850146051";7;2;37;12;17;75
"6121";"360850146052";33;14;17;6;6;76
"6122";"360850146061";9;7;101;17;17;151
"6123";"360850146062";9;5;83;9;24;130
"6124";"360850146063";30;1;38;5;9;83
"6125";"360850146064";4;0;67;13;5;89
"6126";"360850146071";26;7;79;10;12;134
"6127";"360850146072";8;22;12;12;2;56
"6128";"360850146081";3;6;109;14;16;148
"6129";"360850146082";7;5;28;22;12;74
"6130";"360850147001";0;0;4;7;3;14
"6131";"360850147002";14;5;38;14;12;83
"6132";"360850147003";8;0;34;11;15;68
"6133";"360850151001";20;3;22;26;43;114
"6134";"360850151002";5;0;14;14;10;43
"6135";"360850151003";0;2;8;18;5;33
"6136";"360850151004";9;1;11;10;4;35
"6137";"360850151005";11;5;19;10;9;54
"6138";"360850154001";1;0;1;0;0;2
"6139";"360850156011";10;41;22;13;17;103
"6140";"360850156012";28;0;14;9;5;56
"6141";"360850156013";4;6;27;14;13;64
"6142";"360850156014";8;0;40;1;7;56
"6143";"360850156015";10;3;7;5;5;30
"6144";"360850156016";13;11;22;12;2;60
"6145";"360850156021";2;5;17;1;7;32
"6146";"360850156022";1;0;17;3;7;28
"6147";"360850156023";14;0;8;2;4;28
"6148";"360850156024";2;0;13;0;1;16
"6149";"360850156031";6;6;15;5;12;44
"6150";"360850156032";5;6;47;11;23;92
"6151";"360850156033";11;102;56;13;21;203
"6152";"360850169011";9;1;30;15;10;65
"6153";"360850169012";14;4;57;17;10;102
"6154";"360850170051";34;8;29;18;27;116
"6155";"360850170052";58;108;41;12;18;237
"6156";"360850170071";20;23;56;6;12;117
"6157";"360850170072";22;6;67;10;9;114
"6158";"360850170081";12;5;65;30;18;130
"6159";"360850170082";11;2;79;12;11;115
"6160";"360850170083";17;3;79;19;17;135
"6161";"360850170091";16;0;51;3;20;90
"6162";"360850170092";4;3;20;41;13;81
"6163";"360850170093";4;1;38;20;13;76
"6164";"360850170101";11;3;61;11;16;102
"6165";"360850170102";16;2;73;15;6;112
"6166";"360850170103";62;4;148;10;20;244
"6167";"360850170104";4;3;34;13;21;75
"6168";"360850170111";3;2;16;24;9;54
"6169";"360850170112";12;7;43;27;7;96
"6170";"360850170121";12;3;49;15;56;135
"6171";"360850170122";3;1;23;9;9;45
"6172";"360850170123";14;1;34;18;2;69
"6173";"360850173001";9;3;30;13;3;58
"6174";"360850173002";113;11;5;2;9;140
"6175";"360850176001";10;2;31;2;5;50
"6176";"360850176002";3;1;8;7;10;29
"6177";"360850176003";8;3;9;9;5;34
"6178";"360850176004";17;1;5;2;16;41
"6179";"360850177001";9;1;4;0;4;18
"6180";"360850177002";6;4;6;7;8;31
"6181";"360850177003";7;7;10;11;18;53
"6182";"360850177004";7;2;7;1;6;23
"6183";"360850177005";2;2;10;6;58;78
"6184";"360850177006";0;0;0;1;3;4
"6185";"360850181001";3;1;20;3;5;32
"6186";"360850181002";9;6;14;6;13;48
"6187";"360850181003";5;1;4;1;7;18
"6188";"360850187011";16;5;28;24;61;134
"6189";"360850187012";5;2;9;10;10;36
"6190";"360850187021";13;1;31;20;7;72
"6191";"360850187022";23;1;23;15;6;68
"6192";"360850187023";15;7;47;29;15;113
"6193";"360850187024";11;2;72;47;11;143
"6194";"360850189011";10;6;83;30;112;241
"6195";"360850189012";5;3;32;13;14;67
"6196";"360850189021";7;1;20;8;7;43
"6197";"360850189022";7;3;27;9;9;55
"6198";"360850189023";42;6;21;5;15;89
"6199";"360850197001";1;2;6;10;6;25
"6200";"360850197002";26;3;41;6;6;82
"6201";"360850198001";0;3;2;3;1;9
"6202";"360850198002";14;2;51;25;15;107
"6203";"360850198003";10;3;15;6;12;46
"6204";"360850198004";15;3;50;14;21;103
"6205";"360850201001";29;7;23;15;22;96
"6206";"360850201002";10;7;12;14;22;65
"6207";"360850201003";6;6;10;9;9;40
"6208";"360850207001";75;14;76;37;30;232
"6209";"360850207002";26;5;26;25;16;98
"6210";"360850207003";139;13;80;60;30;322
"6211";"360850207004";30;15;62;44;29;180
"6212";"360850208011";6;4;41;16;15;82
"6213";"360850208012";8;1;41;12;48;110
"6214";"360850208013";18;0;71;19;17;125
"6215";"360850208014";27;11;41;23;19;121
"6216";"360850208031";17;1;137;25;8;188
"6217";"360850208032";11;25;38;14;33;121
"6218";"360850208033";5;3;23;8;11;50
"6219";"360850208041";10;3;33;9;11;66
"6220";"360850208042";4;1;24;61;15;105
"6221";"360850208043";0;3;47;6;5;61
"6222";"360850213001";26;7;49;45;16;143
"6223";"360850213002";18;5;11;21;14;69
"6224";"360850213003";38;3;41;19;13;114
"6225";"360850213004";43;4;46;30;12;135
"6226";"360850213005";5;1;27;9;11;53
"6227";"360850223001";29;13;48;68;21;179
"6228";"360850223002";27;7;73;65;17;189
"6229";"360850226001";0;4;76;43;29;152
"6230";"360850226002";15;3;58;31;40;147
"6231";"360850226003";22;12;98;20;10;162
"6232";"360850226004";9;4;21;22;22;78
"6233";"360850228001";6;12;18;14;23;73
"6234";"360850231001";66;13;70;29;22;200
"6235";"360850231002";13;5;23;23;9;73
"6236";"360850239001";53;23;57;45;24;202
"6237";"360850239002";15;9;35;26;33;118
"6238";"360850244011";5;4;8;3;18;38
"6239";"360850244012";12;0;20;5;23;60
"6240";"360850244013";10;3;9;10;15;47
"6241";"360850244021";19;2;19;7;8;55
"6242";"360850244022";12;10;59;30;9;120
"6243";"360850247001";31;6;26;15;17;95
"6244";"360850247002";33;22;43;42;18;158
"6245";"360850248001";29;17;89;10;29;174
"6246";"360850248002";12;7;31;23;9;82
"6247";"360850248003";15;30;43;10;21;119
"6248";"360850251001";39;6;21;16;23;105
"6249";"360850251002";2;4;9;12;6;33
"6250";"360850251003";18;1;11;26;11;67
"6251";"360850273011";0;0;21;5;0;26
"6252";"360850273012";22;5;64;56;14;161
"6253";"360850273021";13;9;69;22;20;133
"6254";"360850273022";2;1;25;4;4;36
"6255";"360850277021";19;1;33;15;6;74
"6256";"360850277022";7;3;21;23;2;56
"6257";"360850277023";32;3;53;7;9;104
"6258";"360850277041";2;1;256;31;9;299
"6259";"360850277042";19;1;38;7;6;71
"6260";"360850277051";17;6;83;48;33;187
"6261";"360850277052";22;1;65;13;3;104
"6262";"360850277053";10;6;48;13;3;80
"6263";"360850277061";13;4;38;90;44;189
"6264";"360850277062";4;1;17;4;8;34
"6265";"360850277063";3;1;32;5;9;50
"6266";"360850279001";11;9;20;15;17;72
"6267";"360850279002";8;1;17;0;4;30
"6268";"360850291021";6;3;56;26;10;101
"6269";"360850291022";23;5;146;51;30;255
"6270";"360850291031";20;9;71;19;28;147
"6271";"360850291032";0;0;8;4;2;14
"6272";"360850291033";21;4;20;4;17;66
"6273";"360850291034";21;1;17;20;11;70
"6274";"360850291035";48;4;36;66;17;171
"6275";"360850291041";31;0;56;31;16;134
"6276";"360850291042";29;5;41;6;7;88
"6277";"360850291043";3;2;33;20;12;70
"6278";"360850291044";26;7;22;24;14;93
"6279";"360850303011";53;5;102;48;24;232
"6280";"360850303012";12;3;16;24;8;63
"6281";"360850303021";18;6;50;19;10;103
"6282";"360850303022";27;5;92;31;13;168
"6283";"360850303023";9;6;58;30;4;107
"6284";"360850303024";34;2;9;7;8;60
"6285";"360850319011";40;7;15;4;8;74
"6286";"360850319012";15;3;24;17;15;74
"6287";"360850319021";28;0;13;10;6;57
"6288";"360850319022";99;4;32;38;36;209
"6289";"360850319023";25;5;66;46;9;151
"6290";"360850323001";35;0;17;30;29;111
"6291";"361190002031";0;0;1;1;0;2
"6292";"361190015031";6;0;11;1;0;18
"6293";"361190026001";3;0;1;1;0;5
"6294";"361190026003";6;1;5;4;0;16
"6295";"361190029002";0;0;2;3;0;5
