"";"Data";"0";"1";"3";"4";"5";"sum"
"1";"360050001001";0;0;3;0;2;5
"2";"360050002001";116;38;250;68;55;527
"3";"360050002002";212;102;175;155;50;694
"4";"360050002003";82;17;34;96;34;263
"5";"360050004001";9;14;91;56;27;197
"6";"360050004002";66;32;213;104;52;467
"7";"360050004003";75;147;67;12;23;324
"8";"360050004004";13;6;43;18;7;87
"9";"360050016001";60;10;38;0;11;119
"10";"360050016002";43;12;92;42;18;207
"11";"360050016003";17;2;6;0;3;28
"12";"360050016004";77;13;91;87;16;284
"13";"360050019001";63;46;144;36;81;370
"14";"360050019002";3;19;58;27;15;122
"15";"360050019003";18;20;142;69;72;321
"16";"360050019004";32;6;32;8;16;94
"17";"360050020001";59;18;128;53;23;281
"18";"360050020002";80;30;95;22;29;256
"19";"360050020003";114;30;4;1;9;158
"20";"360050020004";23;13;1;0;1;38
"21";"360050020005";95;2;1;1;1;100
"22";"360050020006";103;8;145;11;16;283
"23";"360050023001";509;69;21;0;15;614
"24";"360050023002";5;1;5;0;1;12
"25";"360050023003";46;12;6;0;4;68
"26";"360050024000";7;2;12;0;0;21
"27";"360050024001";86;22;9;2;0;119
"28";"360050025001";42;34;3;2;37;118
"29";"360050025002";41;8;3;1;2;55
"30";"360050025003";30;16;13;5;28;92
"31";"360050025004";110;20;7;1;10;148
"32";"360050025005";35;26;10;4;9;84
"33";"360050027011";145;0;20;10;7;182
"34";"360050027012";123;22;63;3;18;229
"35";"360050027021";44;8;22;32;10;116
"36";"360050027022";24;4;11;1;11;51
"37";"360050027023";61;56;25;4;39;185
"38";"360050027024";362;11;15;1;2;391
"39";"360050028001";37;63;148;31;37;316
"40";"360050028002";49;35;18;5;4;111
"41";"360050028003";4;3;2;1;1;11
"42";"360050028004";22;97;19;3;1;142
"43";"360050031001";165;84;79;19;40;387
"44";"360050033001";10;4;42;19;19;94
"45";"360050033002";129;8;23;6;4;170
"46";"360050033003";76;30;25;0;26;157
"47";"360050035001";38;15;49;18;60;180
"48";"360050035002";241;141;4;0;12;398
"49";"360050035003";70;52;77;4;39;242
"50";"360050037001";26;13;10;0;4;53
"51";"360050038001";147;7;84;92;27;357
"52";"360050039001";103;42;26;2;23;196
"53";"360050039002";44;40;27;7;34;152
"54";"360050039003";65;70;22;5;32;194
"55";"360050039004";70;11;48;11;49;189
"56";"360050039005";123;19;54;8;27;231
"57";"360050040011";38;17;148;27;28;258
"58";"360050041001";119;12;10;0;14;155
"59";"360050041002";144;7;127;5;47;330
"60";"360050041003";1;0;1;0;2;4
"61";"360050041004";233;131;11;9;15;399
"62";"360050042001";23;1;2;0;2;28
"63";"360050042002";280;11;4;1;3;299
"64";"360050042003";34;2;24;0;9;69
"65";"360050042004";18;2;4;8;3;35
"66";"360050042005";95;6;26;6;6;139
"67";"360050042006";1;7;13;2;3;26
"68";"360050042007";20;1;0;0;1;22
"69";"360050043001";115;75;41;10;62;303
"70";"360050043002";34;30;57;7;39;167
"71";"360050043003";121;36;21;6;19;203
"72";"360050043004";100;270;58;2;18;448
"73";"360050044001";40;10;1;7;5;63
"74";"360050044002";18;13;1;0;4;36
"75";"360050044003";48;8;73;4;16;149
"76";"360050044004";120;29;19;11;7;186
"77";"360050046001";92;13;27;30;31;193
"78";"360050048001";325;50;50;2;31;458
"79";"360050048002";83;41;153;3;34;314
"80";"360050050011";74;71;177;5;25;352
"81";"360050050012";562;69;40;0;928;1599
"82";"360050050013";137;51;44;2;33;267
"83";"360050050014";65;32;18;6;12;133
"84";"360050050021";169;51;48;1;42;311
"85";"360050050022";36;23;28;1;8;96
"86";"360050050023";36;41;17;1;19;114
"87";"360050050024";121;41;14;1;11;188
"88";"360050051001";26;32;70;32;34;194
"89";"360050051002";239;36;128;15;37;455
"90";"360050051003";189;13;8;1;21;232
"91";"360050052001";23;9;241;16;27;316
"92";"360050052002";218;79;7;1;17;322
"93";"360050053001";354;8;5;0;24;391
"94";"360050053002";0;0;8;0;0;8
"95";"360050054001";32;5;58;0;33;128
"96";"360050054002";157;43;201;4;56;461
"97";"360050054003";88;62;107;15;61;333
"98";"360050054004";124;24;10;0;16;174
"99";"360050056001";304;16;45;2;7;374
"100";"360050056002";9;2;25;1;1;38
"101";"360050056003";59;18;109;11;28;225
"102";"360050059021";14;13;20;3;20;70
"103";"360050059022";0;10;53;3;11;77
"104";"360050060001";81;102;86;19;36;324
"105";"360050061001";1;3;21;0;1;26
"106";"360050061002";37;15;14;1;12;79
"107";"360050061003";2;9;34;13;4;62
"108";"360050062001";419;32;114;3;22;590
"109";"360050062002";70;8;18;2;9;107
"110";"360050062003";201;31;19;2;14;267
"111";"360050062004";90;225;86;2;33;436
"112";"360050062005";0;3;14;1;5;23
"113";"360050063001";53;114;32;3;12;214
"114";"360050063002";37;48;155;29;99;368
"115";"360050063003";179;207;39;3;28;456
"116";"360050063004";111;257;1;0;7;376
"117";"360050063005";81;83;12;1;19;196
"118";"360050063006";455;350;90;11;123;1029
"119";"360050064001";71;17;142;5;28;263
"120";"360050064002";33;6;13;4;7;63
"121";"360050064003";17;0;51;5;9;82
"122";"360050064004";40;8;174;3;11;236
"123";"360050065001";89;33;73;2;108;305
"124";"360050065002";89;27;24;2;18;160
"125";"360050065003";77;5;30;7;28;147
"126";"360050065004";23;46;25;3;98;195
"127";"360050067001";106;49;64;5;46;270
"128";"360050067002";80;28;32;1;20;161
"129";"360050067003";82;18;6;2;10;118
"130";"360050067004";52;33;6;6;6;103
"131";"360050067005";15;5;1;0;14;35
"132";"360050067006";51;8;73;10;12;154
"133";"360050068001";42;23;64;8;12;149
"134";"360050068002";27;7;60;7;14;115
"135";"360050068003";96;50;127;6;22;301
"136";"360050069001";121;93;62;5;27;308
"137";"360050069002";250;35;165;37;28;515
"138";"360050069003";14;27;2;0;2;45
"139";"360050069004";15;1;3;1;1;21
"140";"360050070001";117;17;206;8;42;390
"141";"360050070002";110;2107;103;4;38;2362
"142";"360050070003";590;1158;151;3;23;1925
"143";"360050071001";27;8;81;3;8;127
"144";"360050071002";311;97;67;4;70;549
"145";"360050072001";118;52;101;5;51;327
"146";"360050072002";87;33;132;6;39;297
"147";"360050072003";25;9;45;1;29;109
"148";"360050072004";22;9;60;5;17;113
"149";"360050073001";90;27;73;3;21;214
"150";"360050073002";87;36;11;6;19;159
"151";"360050073003";113;40;33;8;26;220
"152";"360050074001";34;16;66;56;15;187
"153";"360050074002";82;22;41;27;44;216
"154";"360050074003";19;2;5;3;3;32
"155";"360050075001";254;30;169;7;55;515
"156";"360050075002";168;45;74;7;22;316
"157";"360050075003";200;4;14;1;4;223
"158";"360050075004";22;14;17;2;7;62
"159";"360050076001";12;5;6;3;14;40
"160";"360050076002";80;14;61;7;25;187
"161";"360050076003";10;6;43;3;11;73
"162";"360050076004";96;183;149;8;38;474
"163";"360050076005";20;9;186;17;27;259
"164";"360050077001";68;44;108;6;32;258
"165";"360050078001";53;9;127;15;33;237
"166";"360050078002";96;29;262;39;74;500
"167";"360050078003";48;38;14;3;8;111
"168";"360050078004";76;15;66;1;8;166
"169";"360050079001";130;26;29;4;41;230
"170";"360050079002";56;25;24;6;15;126
"171";"360050079003";22;15;13;0;17;67
"172";"360050079004";96;38;51;2;9;196
"173";"360050079005";26;2;9;1;2;40
"174";"360050079006";20;10;9;1;7;47
"175";"360050083001";59;12;41;3;12;127
"176";"360050083002";34;6;16;7;16;79
"177";"360050083003";83;13;33;1;11;141
"178";"360050083004";81;52;53;2;29;217
"179";"360050083005";47;36;65;5;9;162
"180";"360050083006";37;75;220;21;19;372
"181";"360050084001";29;1;44;34;11;119
"182";"360050084002";125;11;234;89;34;493
"183";"360050085001";87;47;73;2;27;236
"184";"360050085002";75;40;149;9;27;300
"185";"360050085003";37;13;22;3;19;94
"186";"360050085004";23;12;5;1;5;46
"187";"360050085005";20;34;4;0;5;63
"188";"360050086001";32;6;50;42;30;160
"189";"360050086002";79;6;9;15;4;113
"190";"360050086003";91;2;6;3;7;109
"191";"360050087001";41;62;16;10;28;157
"192";"360050087002";168;44;21;2;13;248
"193";"360050087003";59;11;42;0;8;120
"194";"360050087004";100;23;0;5;4;132
"195";"360050087005";132;42;9;16;27;226
"196";"360050089001";153;7;17;1;30;208
"197";"360050089002";53;14;126;0;20;213
"198";"360050090001";1;1;34;32;8;76
"199";"360050090002";15;87;40;39;11;192
"200";"360050090003";29;2;1;2;15;49
"201";"360050090004";13;6;114;39;23;195
"202";"360050090005";84;4;6;0;4;98
"203";"360050092001";137;14;43;1;21;216
"204";"360050092002";151;14;82;8;17;272
"205";"360050092003";95;54;104;19;45;317
"206";"360050092004";28;14;76;1;23;142
"207";"360050092005";43;32;131;21;21;248
"208";"360050093001";9;22;127;43;51;252
"209";"360050093002";84;60;61;11;58;274
"210";"360050093003";70;31;34;1;36;172
"211";"360050093004";102;28;49;11;22;212
"212";"360050093005";87;69;204;115;38;513
"213";"360050093006";1;33;233;157;29;453
"214";"360050096001";85;8;149;34;23;299
"215";"360050096002";21;50;197;89;54;411
"216";"360050098001";90;44;127;19;25;305
"217";"360050098002";79;34;46;5;18;182
"218";"360050098003";65;9;66;13;28;181
"219";"360050098004";29;4;67;8;11;119
"220";"360050098005";74;9;25;5;15;128
"221";"360050110000";0;1;0;0;0;1
"222";"360050110001";66;42;48;64;12;232
"223";"360050115021";295;47;167;28;52;589
"224";"360050115022";324;28;50;6;25;433
"225";"360050115023";51;72;74;8;15;220
"226";"360050117001";184;68;31;19;16;318
"227";"360050117002";2;17;52;45;9;125
"228";"360050118001";20;6;126;51;23;226
"229";"360050118002";9;25;324;6;21;385
"230";"360050118003";70;73;180;48;24;395
"231";"360050119001";81;43;7;2;69;202
"232";"360050119002";72;20;34;4;38;168
"233";"360050119003";29;16;31;5;9;90
"234";"360050119004";61;5;4;4;18;92
"235";"360050119005";112;14;28;5;14;173
"236";"360050121011";505;70;67;13;16;671
"237";"360050121012";274;152;187;17;27;657
"238";"360050121021";46;68;27;6;46;193
"239";"360050123001";147;41;88;10;43;329
"240";"360050123002";241;19;78;9;39;386
"241";"360050123003";51;28;35;22;21;157
"242";"360050125001";96;43;186;12;68;405
"243";"360050125002";149;242;101;19;20;531
"244";"360050127011";41;10;35;7;19;112
"245";"360050127012";33;7;20;5;27;92
"246";"360050129011";54;42;84;21;46;247
"247";"360050129012";193;104;44;0;51;392
"248";"360050130001";37;2;91;35;17;182
"249";"360050131001";96;20;21;4;7;148
"250";"360050131002";81;11;138;38;29;297
"251";"360050131003";138;68;75;27;38;346
"252";"360050132001";87;11;100;41;45;284
"253";"360050132002";301;24;52;16;35;428
"254";"360050132003";35;15;275;36;36;397
"255";"360050132004";71;40;112;70;42;335
"256";"360050132005";61;11;104;45;19;240
"257";"360050133001";121;11;2;1;8;143
"258";"360050133002";99;53;42;1;21;216
"259";"360050133003";19;7;0;0;0;26
"260";"360050133004";237;2;5;1;2;247
"261";"360050135001";93;23;76;6;30;228
"262";"360050135002";41;13;24;1;11;90
"263";"360050135003";201;30;100;2;24;357
"264";"360050138001";30;48;53;70;23;224
"265";"360050138002";124;4;123;77;8;336
"266";"360050141001";105;41;43;19;14;222
"267";"360050141002";389;147;17;2;29;584
"268";"360050141003";120;71;98;7;24;320
"269";"360050143001";90;34;110;42;38;314
"270";"360050144001";5;0;0;0;1;6
"271";"360050144002";43;5;10;1;7;66
"272";"360050144003";43;7;1;4;6;61
"273";"360050144004";79;3;7;1;1;91
"274";"360050144005";113;17;90;25;15;260
"275";"360050144006";101;6;63;26;35;231
"276";"360050145001";142;21;44;4;27;238
"277";"360050145002";105;4;16;1;2;128
"278";"360050145003";22;4;55;12;8;101
"279";"360050145004";142;16;63;35;46;302
"280";"360050147011";86;26;2;1;1;116
"281";"360050147012";193;27;52;1;14;287
"282";"360050147013";135;27;9;0;7;178
"283";"360050147021";208;198;3;1;6;416
"284";"360050147022";167;13;15;0;3;198
"285";"360050147023";45;9;4;1;2;61
"286";"360050147024";36;38;5;2;3;84
"287";"360050149001";80;71;80;13;42;286
"288";"360050149002";51;82;182;7;12;334
"289";"360050149003";83;41;49;4;26;203
"290";"360050151001";77;12;28;2;7;126
"291";"360050151002";84;96;25;2;30;237
"292";"360050151003";94;48;64;3;20;229
"293";"360050151004";396;69;84;10;30;589
"294";"360050152001";110;12;133;75;49;379
"295";"360050152002";69;54;178;97;152;550
"296";"360050153001";287;92;158;73;45;655
"297";"360050153002";33;29;25;10;8;105
"298";"360050153003";45;24;126;16;15;226
"299";"360050155001";114;67;24;6;25;236
"300";"360050155002";37;12;37;11;29;126
"301";"360050157001";156;88;124;11;28;407
"302";"360050157002";158;34;55;20;33;300
"303";"360050157003";137;31;89;6;15;278
"304";"360050158001";88;6;170;163;32;459
"305";"360050159001";77;30;20;3;21;151
"306";"360050159002";234;37;9;1;9;290
"307";"360050160001";67;7;140;35;25;274
"308";"360050160002";9;3;48;11;4;75
"309";"360050160003";19;2;46;18;24;109
"310";"360050160004";11;2;52;18;14;97
"311";"360050161001";93;36;34;3;25;191
"312";"360050161002";45;108;36;20;15;224
"313";"360050161003";94;18;2;28;6;148
"314";"360050161004";66;91;22;4;17;200
"315";"360050162001";30;2;33;11;12;88
"316";"360050162002";56;31;78;38;16;219
"317";"360050163001";59;32;13;2;14;120
"318";"360050164001";23;14;76;32;21;166
"319";"360050165001";69;30;110;29;35;273
"320";"360050166001";72;17;125;30;38;282
"321";"360050166002";54;3;59;44;15;175
"322";"360050167001";34;71;25;6;8;144
"323";"360050167002";57;46;85;38;34;260
"324";"360050169001";176;38;58;4;15;291
"325";"360050171001";93;75;37;9;10;224
"326";"360050173001";26;20;136;7;18;207
"327";"360050173002";61;19;50;1;16;147
"328";"360050173003";67;54;86;14;22;243
"329";"360050173004";61;64;30;3;7;165
"330";"360050175001";57;18;17;9;19;120
"331";"360050175002";55;20;8;1;11;95
"332";"360050175003";83;32;7;4;15;141
"333";"360050175004";260;41;33;1;16;351
"334";"360050175005";90;8;4;0;4;106
"335";"360050175006";79;11;8;1;5;104
"336";"360050177011";456;202;144;3;11;816
"337";"360050177012";680;8;4;4;12;708
"338";"360050177013";61;19;41;6;21;148
"339";"360050177021";62;5;42;0;5;114
"340";"360050177022";88;16;116;10;43;273
"341";"360050177023";94;168;186;1;36;485
"342";"360050177024";91;52;24;1;11;179
"343";"360050179011";658;974;86;5;37;1760
"344";"360050179012";3;7;2;0;2;14
"345";"360050179013";170;76;12;2;15;275
"346";"360050179021";113;117;66;3;15;314
"347";"360050179022";80;49;13;2;14;158
"348";"360050179023";91;188;4;0;18;301
"349";"360050181011";295;51;305;11;12;674
"350";"360050181012";101;15;37;0;9;162
"351";"360050181013";27;25;44;1;5;102
"352";"360050181021";148;40;21;4;13;226
"353";"360050181022";67;57;10;2;15;151
"354";"360050181023";77;79;19;1;8;184
"355";"360050181024";120;17;10;6;5;158
"356";"360050183011";156;104;67;5;10;342
"357";"360050183012";98;123;17;3;19;260
"358";"360050183013";234;62;22;0;6;324
"359";"360050183021";203;84;55;0;7;349
"360";"360050183022";53;59;30;8;14;164
"361";"360050183023";28;25;139;3;10;205
"362";"360050184001";25;3;77;42;44;191
"363";"360050184002";19;4;252;85;106;466
"364";"360050184003";8;5;58;39;26;136
"365";"360050184004";34;77;143;39;16;309
"366";"360050185001";330;55;261;26;61;733
"367";"360050185002";88;10;70;10;10;188
"368";"360050185003";161;56;97;12;40;366
"369";"360050185004";15;31;32;4;7;89
"370";"360050185005";42;11;49;2;13;117
"371";"360050189001";125;87;35;7;20;274
"372";"360050189002";26;8;8;1;7;50
"373";"360050189003";1192;345;96;25;300;1958
"374";"360050189004";324;68;301;5;37;735
"375";"360050193001";528;124;27;3;28;710
"376";"360050193002";51;8;7;0;3;69
"377";"360050193003";44;16;5;6;4;75
"378";"360050193004";91;26;110;10;23;260
"379";"360050194001";74;83;224;89;42;512
"380";"360050195001";194;84;30;5;37;350
"381";"360050195002";207;298;56;5;78;644
"382";"360050195003";321;70;22;23;29;465
"383";"360050195004";63;30;18;1;6;118
"384";"360050197001";100;103;10;3;17;233
"385";"360050197002";333;83;23;7;23;469
"386";"360050197003";219;141;27;3;57;447
"387";"360050197004";34;7;6;1;19;67
"388";"360050197005";335;23;6;0;5;369
"389";"360050199001";83;48;5;2;12;150
"390";"360050199002";107;78;6;0;13;204
"391";"360050199003";19;31;93;5;9;157
"392";"360050199004";162;29;41;2;21;255
"393";"360050199005";66;32;12;0;7;117
"394";"360050199006";261;204;166;1;27;659
"395";"360050200001";48;31;84;14;66;243
"396";"360050200002";5;17;96;28;16;162
"397";"360050200003";120;25;149;22;82;398
"398";"360050200004";64;35;15;4;24;142
"399";"360050201001";111;102;112;7;3;335
"400";"360050201002";18;96;41;15;10;180
"401";"360050201003";120;32;23;3;21;199
"402";"360050202001";57;6;86;8;23;180
"403";"360050202002";102;15;122;5;58;302
"404";"360050204001";37;6;63;3;26;135
"405";"360050204002";12;6;88;5;15;126
"406";"360050204003";38;26;107;1;18;190
"407";"360050205011";136;135;15;9;6;301
"408";"360050205012";112;61;28;9;13;223
"409";"360050205013";81;46;110;6;12;255
"410";"360050205014";217;110;230;13;10;580
"411";"360050205021";41;28;95;9;4;177
"412";"360050205022";56;8;178;5;7;254
"413";"360050205023";21;7;126;6;38;198
"414";"360050206011";89;18;62;0;25;194
"415";"360050206012";18;6;256;24;44;348
"416";"360050209001";28;34;36;10;17;125
"417";"360050209002";103;27;10;1;14;155
"418";"360050209003";40;17;23;0;9;89
"419";"360050209004";394;21;61;2;9;487
"420";"360050210011";9;0;12;0;1;22
"421";"360050210012";29;0;5;0;7;41
"422";"360050210013";5;1;1;0;0;7
"423";"360050210014";8;0;8;2;9;27
"424";"360050210015";17;2;3;2;9;33
"425";"360050210016";54;0;5;0;3;62
"426";"360050210021";8;1;5;0;0;14
"427";"360050210022";57;7;14;0;0;78
"428";"360050210023";1;0;2;0;0;3
"429";"360050210024";0;0;1;0;0;1
"430";"360050210025";25;0;7;2;8;42
"431";"360050210026";15;2;3;0;2;22
"432";"360050210027";3;1;1;0;3;8
"433";"360050211001";267;9;123;5;21;425
"434";"360050211002";57;61;41;12;17;188
"435";"360050211003";68;26;41;6;5;146
"436";"360050211004";12;11;8;0;4;35
"437";"360050212001";4;0;4;0;0;8
"438";"360050212002";2;2;0;0;2;6
"439";"360050212004";7;10;13;0;3;33
"440";"360050212005";2;0;0;0;0;2
"441";"360050213011";7;3;17;0;0;27
"442";"360050213012";40;35;75;3;9;162
"443";"360050213021";95;71;90;20;28;304
"444";"360050213022";20;21;50;6;6;103
"445";"360050213023";24;11;46;2;14;97
"446";"360050213024";225;104;230;3;8;570
"447";"360050215011";30;32;26;4;12;104
"448";"360050215012";255;90;128;4;19;496
"449";"360050215013";68;66;93;1;7;235
"450";"360050215021";182;131;64;10;15;402
"451";"360050215022";127;20;122;3;15;287
"452";"360050215023";64;12;229;3;18;326
"453";"360050215024";143;19;115;2;6;285
"454";"360050215025";66;7;32;2;12;119
"455";"360050216011";116;36;152;3;27;334
"456";"360050216012";141;22;182;5;36;386
"457";"360050216013";67;9;10;11;10;107
"458";"360050216014";62;3;26;9;6;106
"459";"360050216021";33;6;68;1;15;123
"460";"360050216022";40;9;4;0;7;60
"461";"360050216023";100;7;1;0;1;109
"462";"360050216024";17;7;36;0;12;72
"463";"360050216025";25;32;28;3;13;101
"464";"360050217001";106;67;209;26;33;441
"465";"360050217002";453;85;14;5;17;574
"466";"360050217003";3;8;35;19;16;81
"467";"360050217004";166;90;72;2;5;335
"468";"360050218001";115;29;7;33;13;197
"469";"360050218002";119;62;108;6;20;315
"470";"360050218003";222;16;314;9;32;593
"471";"360050218004";56;4;144;39;29;272
"472";"360050218005";103;9;50;28;40;230
"473";"360050219001";247;394;196;73;57;967
"474";"360050220001";288;50;199;25;50;612
"475";"360050221011";93;10;4;0;7;114
"476";"360050221012";41;35;22;0;14;112
"477";"360050221013";146;42;25;3;11;227
"478";"360050221021";115;157;35;4;32;343
"479";"360050221022";65;57;6;0;10;138
"480";"360050221023";165;35;20;1;34;255
"481";"360050222001";58;18;99;3;26;204
"482";"360050222002";15;3;56;0;31;105
"483";"360050222003";62;86;101;6;37;292
"484";"360050222004";19;10;26;2;106;163
"485";"360050223001";27;203;36;3;33;302
"486";"360050223002";73;112;25;1;19;230
"487";"360050223003";111;167;7;4;13;302
"488";"360050223004";31;36;4;2;9;82
"489";"360050224011";19;15;3;1;10;48
"490";"360050224012";234;27;38;5;25;329
"491";"360050224031";153;32;17;8;14;224
"492";"360050224032";117;49;38;4;59;267
"493";"360050224041";33;16;28;1;8;86
"494";"360050224042";220;18;22;1;20;281
"495";"360050224043";195;25;26;0;8;254
"496";"360050225001";184;125;20;3;28;360
"497";"360050225002";75;81;74;6;16;252
"498";"360050225003";52;97;6;2;22;179
"499";"360050225004";53;36;26;0;11;126
"500";"360050225005";102;38;21;3;11;175
"501";"360050225006";164;20;12;3;6;205
"502";"360050227011";72;20;26;8;15;141
"503";"360050227012";123;66;29;1;34;253
"504";"360050227013";115;45;159;18;25;362
"505";"360050227021";207;78;77;15;37;414
"506";"360050227031";45;88;31;8;14;186
"507";"360050228001";43;30;191;4;27;295
"508";"360050228002";218;22;39;2;16;297
"509";"360050228003";234;19;11;4;14;282
"510";"360050228004";131;16;9;0;7;163
"511";"360050229011";261;42;36;1;21;361
"512";"360050229012";111;54;83;1;13;262
"513";"360050229013";164;173;9;3;10;359
"514";"360050229014";83;134;95;5;7;324
"515";"360050229015";141;133;152;1;23;450
"516";"360050229021";40;56;52;12;3;163
"517";"360050229022";52;172;65;13;12;314
"518";"360050229023";113;72;16;2;8;211
"519";"360050230001";121;23;165;18;36;363
"520";"360050230002";75;8;262;10;41;396
"521";"360050231001";109;56;106;19;42;332
"522";"360050232001";47;36;111;6;41;241
"523";"360050232002";48;22;132;7;24;233
"524";"360050233011";72;44;38;9;20;183
"525";"360050233012";198;487;35;2;43;765
"526";"360050233013";21;25;69;5;17;137
"527";"360050233014";77;13;24;0;4;118
"528";"360050233021";187;158;21;10;24;400
"529";"360050233022";64;173;44;4;26;311
"530";"360050235011";169;44;22;4;58;297
"531";"360050235012";30;26;7;0;17;80
"532";"360050235013";82;59;0;0;12;153
"533";"360050235021";66;64;40;1;6;177
"534";"360050235022";43;27;16;1;8;95
"535";"360050235023";52;6;60;6;19;143
"536";"360050235024";281;44;6;7;26;364
"537";"360050236001";31;27;93;11;17;179
"538";"360050236002";22;19;53;9;24;127
"539";"360050237021";102;30;7;5;42;186
"540";"360050237031";117;68;108;1;82;376
"541";"360050237032";173;246;2;4;225;650
"542";"360050237033";112;58;63;7;18;258
"543";"360050237041";185;35;5;0;9;234
"544";"360050237042";195;42;42;3;19;301
"545";"360050237043";473;59;6;3;5;546
"546";"360050238001";0;9;55;19;13;96
"547";"360050238002";38;21;195;9;27;290
"548";"360050238003";75;14;118;11;31;249
"549";"360050239001";300;314;56;4;33;707
"550";"360050239002";79;270;32;7;30;418
"551";"360050239003";80;30;109;6;20;245
"552";"360050239004";357;87;54;10;43;551
"553";"360050239005";74;96;12;5;10;197
"554";"360050239006";163;36;22;2;18;241
"555";"360050240001";133;33;417;76;91;750
"556";"360050240002";42;15;77;9;16;159
"557";"360050240003";83;16;94;12;37;242
"558";"360050241001";153;58;9;4;34;258
"559";"360050241002";40;12;49;1;35;137
"560";"360050241003";67;16;46;2;23;154
"561";"360050241004";52;15;24;1;20;112
"562";"360050241005";94;35;14;2;19;164
"563";"360050243001";46;38;7;1;66;158
"564";"360050243002";61;19;136;6;18;240
"565";"360050243003";76;0;21;0;3;100
"566";"360050243004";140;31;197;5;23;396
"567";"360050244001";45;22;90;8;10;175
"568";"360050244002";28;9;218;88;29;372
"569";"360050245011";97;67;64;3;6;237
"570";"360050245012";108;72;155;4;7;346
"571";"360050245013";23;11;24;5;1;64
"572";"360050245014";39;17;51;2;10;119
"573";"360050245021";38;65;128;2;14;247
"574";"360050245022";5;3;3;1;4;16
"575";"360050245023";159;140;125;3;20;447
"576";"360050246001";309;6;156;21;33;525
"577";"360050246002";47;5;114;15;11;192
"578";"360050247001";0;0;7;1;2;10
"579";"360050247002";57;3;29;5;9;103
"580";"360050248001";52;5;94;18;15;184
"581";"360050248002";23;7;144;32;14;220
"582";"360050248003";31;1;145;32;23;232
"583";"360050249001";49;13;60;7;3;132
"584";"360050250001";201;3;123;30;40;397
"585";"360050250002";27;4;74;44;31;180
"586";"360050251001";184;105;67;3;19;378
"587";"360050251002";106;124;93;13;6;342
"588";"360050251003";75;70;136;23;42;346
"589";"360050251004";25;5;33;2;4;69
"590";"360050251005";114;38;78;6;19;255
"591";"360050251006";73;39;71;0;6;189
"592";"360050251007";12;4;13;0;3;32
"593";"360050252001";88;10;251;46;31;426
"594";"360050252002";51;6;148;110;10;325
"595";"360050253001";564;23;26;0;20;633
"596";"360050253002";156;50;95;0;15;316
"597";"360050253003";114;24;19;0;25;182
"598";"360050253004";84;31;24;4;13;156
"599";"360050254001";38;17;97;15;38;205
"600";"360050254002";19;33;171;24;20;267
"601";"360050255001";213;143;78;11;133;578
"602";"360050255002";255;198;85;9;27;574
"603";"360050255003";276;246;128;3;30;683
"604";"360050256001";78;19;84;164;38;383
"605";"360050256002";52;28;133;88;35;336
"606";"360050257001";125;26;388;11;21;571
"607";"360050261001";166;119;77;4;14;380
"608";"360050263001";263;160;24;1;48;496
"609";"360050263002";153;93;16;5;7;274
"610";"360050263003";298;186;59;5;22;570
"611";"360050263004";15;72;89;2;2;180
"612";"360050263005";54;23;28;22;9;136
"613";"360050264001";52;11;113;20;67;263
"614";"360050264002";24;3;114;41;32;214
"615";"360050264003";63;10;157;47;47;324
"616";"360050264004";33;3;99;47;24;206
"617";"360050265001";109;56;74;34;27;300
"618";"360050265002";234;76;68;34;18;430
"619";"360050265003";227;65;19;1;24;336
"620";"360050265004";65;62;78;5;12;222
"621";"360050266011";20;9;49;27;8;113
"622";"360050266012";38;41;25;4;13;121
"623";"360050266013";7;4;50;21;12;94
"624";"360050266021";70;7;92;28;21;218
"625";"360050266022";80;32;92;26;38;268
"626";"360050266023";43;5;167;30;42;287
"627";"360050266024";24;1;59;3;14;101
"628";"360050266025";40;3;65;11;23;142
"629";"360050267011";178;8;90;0;15;291
"630";"360050267012";170;81;8;1;12;272
"631";"360050267013";85;27;59;26;25;222
"632";"360050267021";234;44;119;6;54;457
"633";"360050267022";71;5;33;3;15;127
"634";"360050267023";114;17;29;1;4;165
"635";"360050267024";22;3;24;0;15;64
"636";"360050267025";29;11;18;2;11;71
"637";"360050267026";134;22;109;6;40;311
"638";"360050269001";98;103;453;26;35;715
"639";"360050269002";370;13;80;4;5;472
"640";"360050269003";66;15;78;0;5;164
"641";"360050273001";39;41;29;4;10;123
"642";"360050273002";126;204;155;3;16;504
"643";"360050273003";149;25;212;3;27;416
"644";"360050273004";320;172;215;8;32;747
"645";"360050274011";4;5;10;21;3;43
"646";"360050274012";28;11;97;29;31;196
"647";"360050274013";48;6;90;32;292;468
"648";"360050274014";49;3;126;69;51;298
"649";"360050274021";10;193;67;18;16;304
"650";"360050274022";1;4;16;23;4;48
"651";"360050274023";32;29;106;27;21;215
"652";"360050276001";60;37;80;38;37;252
"653";"360050277001";149;66;46;2;15;278
"654";"360050277002";25;21;50;1;11;108
"655";"360050277003";89;20;95;25;13;242
"656";"360050277004";115;35;13;0;9;172
"657";"360050279001";56;137;54;2;8;257
"658";"360050279002";40;14;74;1;29;158
"659";"360050279003";105;18;127;5;103;358
"660";"360050279004";65;26;164;3;22;280
"661";"360050279005";17;4;29;0;1;51
"662";"360050279006";311;26;79;5;10;431
"663";"360050281001";59;10;135;1;11;216
"664";"360050281002";64;4;10;1;4;83
"665";"360050281003";0;2;15;2;2;21
"666";"360050283001";45;48;67;7;33;200
"667";"360050283002";162;25;25;2;19;233
"668";"360050284001";91;10;102;58;24;285
"669";"360050285001";165;36;81;5;26;313
"670";"360050285002";56;7;16;0;5;84
"671";"360050285003";36;135;9;0;9;189
"672";"360050285004";169;47;142;17;18;393
"673";"360050286001";12;1;106;28;19;166
"674";"360050286002";25;52;78;13;18;186
"675";"360050287001";51;19;231;24;29;354
"676";"360050287002";94;9;4;0;4;111
"677";"360050287003";75;73;15;3;7;173
"678";"360050288001";31;6;60;64;11;172
"679";"360050288002";7;2;50;25;26;110
"680";"360050288003";14;0;32;1;2;49
"681";"360050288004";10;0;60;13;28;111
"682";"360050289001";268;52;104;6;32;462
"683";"360050289002";27;2;0;0;3;32
"684";"360050289003";28;28;32;11;29;128
"685";"360050289004";58;16;17;0;5;96
"686";"360050293011";6;2;10;21;3;42
"687";"360050293012";70;4;12;1;7;94
"688";"360050293021";26;5;7;0;1;39
"689";"360050293022";3;2;24;6;5;40
"690";"360050293023";90;19;28;1;12;150
"691";"360050293024";85;8;129;9;20;251
"692";"360050295001";76;45;50;6;7;184
"693";"360050295002";194;119;49;1;12;375
"694";"360050295003";97;8;92;4;5;206
"695";"360050295004";90;20;129;1;24;264
"696";"360050296001";486;48;173;94;33;834
"697";"360050296002";6;0;13;10;25;54
"698";"360050297001";33;6;50;2;14;105
"699";"360050297002";45;6;28;3;7;89
"700";"360050297003";66;5;28;0;3;102
"701";"360050300001";150;19;84;19;42;314
"702";"360050300002";47;9;187;43;34;320
"703";"360050300003";27;300;107;7;24;465
"704";"360050300004";86;7;58;9;15;175
"705";"360050300005";18;0;45;18;9;90
"706";"360050300006";27;2;144;28;15;216
"707";"360050301001";6;2;31;8;3;50
"708";"360050301002";1;1;19;0;0;21
"709";"360050302001";4;0;3;3;1;11
"710";"360050302002";3;1;2;0;2;8
"711";"360050302003";7;6;196;3;9;221
"712";"360050302004";3;0;0;1;1;5
"713";"360050302005";48;5;21;0;5;79
"714";"360050302006";3;0;0;0;1;4
"715";"360050307011";15;11;27;24;5;82
"716";"360050307012";9;0;21;1;2;33
"717";"360050307013";16;8;66;2;4;96
"718";"360050307014";1;4;12;0;1;18
"719";"360050309001";1;2;1;0;1;5
"720";"360050309002";1;6;19;4;4;34
"721";"360050309003";17;5;12;2;0;36
"722";"360050309004";8;32;21;1;1;63
"723";"360050310001";8;18;40;47;12;125
"724";"360050310002";38;16;52;42;17;165
"725";"360050310003";13;6;76;47;28;170
"726";"360050312001";9;1;38;52;66;166
"727";"360050312002";9;4;75;33;25;146
"728";"360050314001";43;3;58;36;20;160
"729";"360050314002";6;0;52;27;19;104
"730";"360050316001";37;10;169;46;35;297
"731";"360050316002";10;1;23;11;31;76
"732";"360050318001";16;4;93;13;13;139
"733";"360050318002";10;4;60;41;19;134
"734";"360050323001";5;4;7;5;0;21
"735";"360050323002";11;14;8;16;1;50
"736";"360050323003";10;0;8;9;28;55
"737";"360050323004";31;10;90;32;7;170
"738";"360050324001";361;17;35;7;12;432
"739";"360050324002";69;33;85;5;22;214
"740";"360050326001";182;26;124;17;27;376
"741";"360050326002";56;2;76;88;39;261
"742";"360050326003";9;0;77;16;18;120
"743";"360050328001";161;105;46;9;15;336
"744";"360050328002";164;25;3;5;2;199
"745";"360050328003";60;9;71;8;5;153
"746";"360050328004";129;2;66;12;16;225
"747";"360050330001";35;8;61;16;26;146
"748";"360050330002";1438;10;33;2;10;1493
"749";"360050330003";131;6;17;10;32;196
"750";"360050330004";38;3;44;7;6;98
"751";"360050332011";82;9;12;2;7;112
"752";"360050332012";112;5;59;6;12;194
"753";"360050332013";168;14;54;7;16;259
"754";"360050332021";144;2;104;9;5;264
"755";"360050332022";69;38;56;3;11;177
"756";"360050332023";31;5;40;2;9;87
"757";"360050332024";22;1;56;6;6;91
"758";"360050334001";46;85;38;18;22;209
"759";"360050335001";0;0;1;5;3;9
"760";"360050335002";39;50;80;31;13;213
"761";"360050335003";72;140;48;1;4;265
"762";"360050336001";38;5;76;39;15;173
"763";"360050336002";282;102;5;5;13;407
"764";"360050336003";69;31;3;14;6;123
"765";"360050336004";50;5;5;1;8;69
"766";"360050336005";173;6;2;7;21;209
"767";"360050336006";51;19;38;8;20;136
"768";"360050337001";4;4;20;5;4;37
"769";"360050337002";14;1;83;67;12;177
"770";"360050337003";45;20;94;32;27;218
"771";"360050338001";43;14;36;12;12;117
"772";"360050338002";111;10;27;4;6;158
"773";"360050338003";48;7;203;7;21;286
"774";"360050338004";117;33;127;17;31;325
"775";"360050340001";71;4;130;10;15;230
"776";"360050340002";155;13;111;14;13;306
"777";"360050340003";122;29;24;6;12;193
"778";"360050340004";32;10;59;4;8;113
"779";"360050342001";20;1;54;21;5;101
"780";"360050342002";70;29;132;35;26;292
"781";"360050343001";20;3;78;29;10;140
"782";"360050343002";111;11;108;45;6;281
"783";"360050344001";14;3;41;9;11;78
"784";"360050344002";10;4;49;62;21;146
"785";"360050345001";53;7;182;36;8;286
"786";"360050345002";58;3;99;50;29;239
"787";"360050345003";70;2;23;14;8;117
"788";"360050348001";42;8;133;129;15;327
"789";"360050348002";318;67;9;11;35;440
"790";"360050348003";69;3;270;84;32;458
"791";"360050348004";29;9;126;55;16;235
"792";"360050350001";79;13;117;39;29;277
"793";"360050350002";26;14;28;46;29;143
"794";"360050351001";6;9;55;28;0;98
"795";"360050351002";218;4;75;57;13;367
"796";"360050351003";173;30;59;36;10;308
"797";"360050356001";17;6;52;37;13;125
"798";"360050356002";47;28;119;90;23;307
"799";"360050358001";41;27;75;41;9;193
"800";"360050358002";36;4;94;86;14;234
"801";"360050358003";37;4;71;25;12;149
"802";"360050358004";31;3;46;42;14;136
"803";"360050358005";26;2;77;50;4;159
"804";"360050358006";20;11;69;14;43;157
"805";"360050358007";62;22;85;12;26;207
"806";"360050359001";74;50;54;31;27;236
"807";"360050360001";12;24;61;32;18;147
"808";"360050360002";31;8;93;70;21;223
"809";"360050360003";11;0;46;35;12;104
"810";"360050361001";58;30;19;4;9;120
"811";"360050361002";135;15;102;2;13;267
"812";"360050361003";31;6;7;6;10;60
"813";"360050361004";112;2;2;0;3;119
"814";"360050361005";222;64;20;8;6;320
"815";"360050363001";118;14;40;7;7;186
"816";"360050363002";25;7;11;1;5;49
"817";"360050363003";54;39;62;6;56;217
"818";"360050363004";254;16;105;42;28;445
"819";"360050363005";189;36;12;5;15;257
"820";"360050363006";168;26;46;16;40;296
"821";"360050364001";28;12;106;24;14;184
"822";"360050364002";17;2;42;3;17;81
"823";"360050364003";30;9;69;16;8;132
"824";"360050365011";107;6;23;11;16;163
"825";"360050365012";34;14;59;4;16;127
"826";"360050365013";92;18;25;8;13;156
"827";"360050365021";96;106;45;4;9;260
"828";"360050365022";174;26;70;10;24;304
"829";"360050367001";53;11;39;31;26;160
"830";"360050367002";671;68;36;19;31;825
"831";"360050368001";56;10;85;27;24;202
"832";"360050368002";10;6;52;16;14;98
"833";"360050369011";145;179;20;24;92;460
"834";"360050369012";69;58;29;4;9;169
"835";"360050369021";123;12;3;3;8;149
"836";"360050369022";73;27;35;17;8;160
"837";"360050370001";20;9;57;36;9;131
"838";"360050370002";13;1;62;4;6;86
"839";"360050370003";21;1;46;2;23;93
"840";"360050371001";61;9;163;2;24;259
"841";"360050371002";85;16;32;15;71;219
"842";"360050371003";137;18;30;15;22;222
"843";"360050371004";59;11;56;6;13;145
"844";"360050372001";27;8;46;6;14;101
"845";"360050372002";72;33;128;21;18;272
"846";"360050373001";129;26;16;7;10;188
"847";"360050373002";77;163;115;23;26;404
"848";"360050373003";113;73;41;14;47;288
"849";"360050373004";326;58;21;7;31;443
"850";"360050374001";43;7;65;3;16;134
"851";"360050374002";117;41;166;17;33;374
"852";"360050374003";71;28;4;0;4;107
"853";"360050374004";7;0;0;0;8;15
"854";"360050375041";15;11;35;47;17;125
"855";"360050375042";231;46;36;48;10;371
"856";"360050375043";142;128;67;27;24;388
"857";"360050376001";265;9;31;5;6;316
"858";"360050376002";17;6;34;36;16;109
"859";"360050378001";92;18;84;11;47;252
"860";"360050378002";18;35;17;1;7;78
"861";"360050378003";54;14;52;25;23;168
"862";"360050379001";25;39;119;93;17;293
"863";"360050379002";29;5;9;1;6;50
"864";"360050379003";86;9;7;3;8;113
"865";"360050379004";50;16;57;3;5;131
"866";"360050379005";151;34;20;15;11;231
"867";"360050380001";92;3;18;5;2;120
"868";"360050380002";67;6;83;6;15;177
"869";"360050380003";124;12;73;30;28;267
"870";"360050380004";94;15;79;27;15;230
"871";"360050381001";68;7;4;3;7;89
"872";"360050381002";176;60;21;1;6;264
"873";"360050381003";79;50;13;0;5;147
"874";"360050381004";47;13;32;4;12;108
"875";"360050381005";14;11;83;2;12;122
"876";"360050381006";228;34;15;1;35;313
"877";"360050382001";56;3;150;14;35;258
"878";"360050382002";48;10;75;9;13;155
"879";"360050383011";59;39;57;1;16;172
"880";"360050383012";194;18;69;4;10;295
"881";"360050383013";89;45;33;0;21;188
"882";"360050383021";84;50;54;37;27;252
"883";"360050383022";206;107;49;6;9;377
"884";"360050383023";386;63;30;9;21;509
"885";"360050385001";70;27;49;7;31;184
"886";"360050385002";39;33;27;5;9;113
"887";"360050385003";38;79;29;11;20;177
"888";"360050385004";195;36;66;53;28;378
"889";"360050386001";39;7;176;44;23;289
"890";"360050386002";31;14;101;26;15;187
"891";"360050386003";32;53;4;0;9;98
"892";"360050386004";55;19;124;5;12;215
"893";"360050386005";45;9;54;15;7;130
"894";"360050386006";25;53;39;2;13;132
"895";"360050386007";13;2;2;4;7;28
"896";"360050386008";94;89;19;6;4;212
"897";"360050387001";108;15;21;0;114;258
"898";"360050387002";201;58;34;28;32;353
"899";"360050387003";54;51;17;5;13;140
"900";"360050388001";43;6;125;6;12;192
"901";"360050388002";56;8;239;12;22;337
"902";"360050389001";178;21;56;10;12;277
"903";"360050389002";39;20;7;2;23;91
"904";"360050389003";204;94;27;3;49;377
"905";"360050389004";56;74;32;2;15;179
"906";"360050389005";47;23;38;9;31;148
"907";"360050390001";39;6;166;13;19;243
"908";"360050390002";55;45;133;32;24;289
"909";"360050391001";469;37;57;2;13;578
"910";"360050391002";125;18;82;18;24;267
"911";"360050391003";64;68;115;43;16;306
"912";"360050391004";60;131;27;0;44;262
"913";"360050391005";38;3;4;3;26;74
"914";"360050391006";55;11;7;0;37;110
"915";"360050392001";19;11;62;5;14;111
"916";"360050392002";25;35;106;3;30;199
"917";"360050393001";223;40;36;3;21;323
"918";"360050393002";303;116;24;18;21;482
"919";"360050393003";44;12;6;8;6;76
"920";"360050393004";63;20;20;4;17;124
"921";"360050393005";9;26;18;3;5;61
"922";"360050393006";108;84;64;19;25;300
"923";"360050394001";151;9;28;0;11;199
"924";"360050394002";133;8;155;6;25;327
"925";"360050394003";7;7;23;4;4;45
"926";"360050394004";67;15;97;8;16;203
"927";"360050395001";52;52;141;97;27;369
"928";"360050395002";61;38;72;35;26;232
"929";"360050395003";32;12;135;59;33;271
"930";"360050395004";95;55;123;82;48;403
"931";"360050396001";202;13;134;7;23;379
"932";"360050396002";89;36;136;12;18;291
"933";"360050396003";104;16;142;6;42;310
"934";"360050396004";71;7;115;3;13;209
"935";"360050397001";70;43;39;19;61;232
"936";"360050397002";234;45;20;2;112;413
"937";"360050398001";71;7;129;11;26;244
"938";"360050398002";30;6;43;16;15;110
"939";"360050398003";44;2;48;6;15;115
"940";"360050399011";99;45;5;1;34;184
"941";"360050399012";43;24;16;1;13;97
"942";"360050399013";75;39;46;4;20;184
"943";"360050399014";55;25;3;1;10;94
"944";"360050399015";142;133;51;17;27;370
"945";"360050399021";107;55;49;7;44;262
"946";"360050399022";51;60;4;0;11;126
"947";"360050399023";134;115;26;5;24;304
"948";"360050399024";66;8;3;0;6;83
"949";"360050399025";126;9;26;3;8;172
"950";"360050401001";143;16;0;0;11;170
"951";"360050401002";252;80;39;0;27;398
"952";"360050401003";243;42;22;1;26;334
"953";"360050401004";59;3;3;0;11;76
"954";"360050401005";432;220;34;0;27;713
"955";"360050403021";786;64;5;4;25;884
"956";"360050403022";12;11;4;1;4;32
"957";"360050403023";47;18;19;1;3;88
"958";"360050403031";222;79;59;10;19;389
"959";"360050403032";247;38;252;4;20;561
"960";"360050403033";85;40;17;3;14;159
"961";"360050403041";80;240;23;5;18;366
"962";"360050403042";315;106;26;0;19;466
"963";"360050403043";165;27;22;0;21;235
"964";"360050404001";48;8;231;11;23;321
"965";"360050404002";12;8;77;3;10;110
"966";"360050404003";35;1;70;8;6;120
"967";"360050405011";283;116;32;8;27;466
"968";"360050405012";38;10;25;5;9;87
"969";"360050405013";84;16;38;7;22;167
"970";"360050405021";102;61;27;1;8;199
"971";"360050405022";33;39;46;0;11;129
"972";"360050405023";74;49;89;2;10;224
"973";"360050405024";47;21;24;2;9;103
"974";"360050405025";38;10;29;1;4;82
"975";"360050405026";49;7;98;10;15;179
"976";"360050406001";436;56;118;22;31;663
"977";"360050406002";102;33;91;2;20;248
"978";"360050406003";86;17;54;7;32;196
"979";"360050407011";56;71;22;6;16;171
"980";"360050407012";1017;29;15;1;9;1071
"981";"360050407013";263;61;15;1;8;348
"982";"360050407021";55;11;13;0;13;92
"983";"360050407022";137;198;114;14;22;485
"984";"360050407023";263;28;25;7;14;337
"985";"360050407024";96;13;77;2;20;208
"986";"360050407025";41;6;45;3;4;99
"987";"360050408001";112;14;39;4;7;176
"988";"360050408002";276;66;67;3;7;419
"989";"360050408003";140;24;29;1;5;199
"990";"360050408004";116;26;136;7;23;308
"991";"360050409001";44;56;217;27;123;467
"992";"360050409002";44;35;40;17;12;148
"993";"360050411001";159;12;61;6;5;243
"994";"360050411002";111;9;42;9;13;184
"995";"360050411003";105;27;63;22;25;242
"996";"360050413001";173;108;189;3;37;510
"997";"360050413002";53;73;20;3;9;158
"998";"360050413003";121;78;47;0;9;255
"999";"360050413004";94;4;11;5;5;119
"1000";"360050413005";69;13;29;1;8;120
"1001";"360050413006";79;21;93;1;9;203
"1002";"360050413007";200;18;59;4;16;297
"1003";"360050414001";64;10;102;88;20;284
"1004";"360050414002";51;27;162;45;26;311
"1005";"360050414003";105;4;124;47;20;300
"1006";"360050414004";195;70;123;77;55;520
"1007";"360050415001";137;21;165;7;16;346
"1008";"360050415002";136;10;77;1;1;225
"1009";"360050415003";51;4;55;1;10;121
"1010";"360050415004";30;8;29;1;7;75
"1011";"360050415005";54;15;41;3;3;116
"1012";"360050415006";210;22;50;1;13;296
"1013";"360050418001";43;28;72;53;22;218
"1014";"360050418002";50;22;79;52;22;225
"1015";"360050418003";61;6;63;27;13;170
"1016";"360050418004";17;3;43;42;20;125
"1017";"360050419001";57;11;134;2;10;214
"1018";"360050419002";56;15;27;2;22;122
"1019";"360050419003";98;8;14;2;19;141
"1020";"360050419004";117;17;57;3;24;218
"1021";"360050419005";32;16;18;1;8;75
"1022";"360050419006";71;19;15;0;11;116
"1023";"360050419007";90;23;83;0;7;203
"1024";"360050420001";59;10;38;11;11;129
"1025";"360050420002";235;17;88;3;12;355
"1026";"360050420003";122;12;86;2;16;238
"1027";"360050421001";10;7;24;2;6;49
"1028";"360050421002";344;65;6;1;29;445
"1029";"360050421003";45;9;8;5;17;84
"1030";"360050421004";289;62;42;7;10;410
"1031";"360050421005";96;30;5;0;4;135
"1032";"360050422001";75;14;313;43;31;476
"1033";"360050422002";46;11;104;15;14;190
"1034";"360050423001";113;43;30;1;6;193
"1035";"360050423002";91;21;201;15;17;345
"1036";"360050423003";79;33;100;3;13;228
"1037";"360050424001";26;0;96;12;11;145
"1038";"360050424002";52;5;141;10;15;223
"1039";"360050425001";36;10;19;1;12;78
"1040";"360050425002";213;61;109;4;26;413
"1041";"360050425003";179;146;205;2;31;563
"1042";"360050425004";100;2;82;4;8;196
"1043";"360050425005";65;45;44;13;39;206
"1044";"360050425006";26;12;29;3;10;80
"1045";"360050425007";252;189;82;6;37;566
"1046";"360050426001";84;52;222;55;38;451
"1047";"360050426002";124;10;158;39;18;349
"1048";"360050426003";26;11;119;53;5;214
"1049";"360050426004";18;7;61;28;11;125
"1050";"360050426005";25;2;58;15;9;109
"1051";"360050426006";19;2;114;16;14;165
"1052";"360050428001";24;41;89;33;13;200
"1053";"360050428002";48;3;88;67;15;221
"1054";"360050429011";407;35;277;12;27;758
"1055";"360050429012";79;19;104;1;14;217
"1056";"360050429013";34;46;89;2;4;175
"1057";"360050429021";391;101;213;9;51;765
"1058";"360050429022";76;24;139;4;14;257
"1059";"360050429023";139;5;107;8;6;265
"1060";"360050430001";25;2;81;40;16;164
"1061";"360050430002";21;2;39;32;16;110
"1062";"360050430003";55;3;139;37;8;242
"1063";"360050431001";38;14;3;0;0;55
"1064";"360050431002";64;13;11;0;23;111
"1065";"360050431003";78;1;10;1;4;94
"1066";"360050431004";86;44;48;2;16;196
"1067";"360050431005";784;67;49;5;25;930
"1068";"360050431006";216;69;34;5;17;341
"1069";"360050431007";256;49;25;2;27;359
"1070";"360050431008";83;44;42;3;12;184
"1071";"360050434001";54;64;118;68;44;348
"1072";"360050434002";103;20;65;16;24;228
"1073";"360050434003";63;2;81;12;25;183
"1074";"360050434004";233;18;118;20;26;415
"1075";"360050435001";257;145;206;54;129;791
"1076";"360050436001";117;12;60;65;32;286
"1077";"360050436002";54;36;175;19;14;298
"1078";"360050442001";319;15;8;12;14;368
"1079";"360050442002";30;2;53;23;12;120
"1080";"360050442003";13;0;40;74;2;129
"1081";"360050442004";61;7;140;103;23;334
"1082";"360050442005";20;12;55;35;12;134
"1083";"360050444001";34;11;82;21;23;171
"1084";"360050444002";24;8;35;8;11;86
"1085";"360050444003";72;10;82;31;7;202
"1086";"360050444004";28;8;130;53;7;226
"1087";"360050448001";40;4;72;59;11;186
"1088";"360050448002";11;1;52;14;8;86
"1089";"360050449011";17;2;88;27;4;138
"1090";"360050449012";11;6;131;38;8;194
"1091";"360050449021";40;13;143;16;16;228
"1092";"360050449022";38;11;122;37;22;230
"1093";"360050451011";31;13;295;12;34;385
"1094";"360050451012";64;5;149;32;26;276
"1095";"360050451021";43;7;134;30;14;228
"1096";"360050451022";72;9;112;19;26;238
"1097";"360050456001";36;9;79;37;14;175
"1098";"360050456002";44;8;173;89;28;342
"1099";"360050456003";31;1;24;22;9;87
"1100";"360050458001";32;12;8;4;6;62
"1101";"360050458002";396;18;1;0;9;424
"1102";"360050458003";11;2;1;0;2;16
"1103";"360050458004";562;24;18;5;7;616
"1104";"360050460001";118;15;111;19;18;281
"1105";"360050460002";17;7;56;27;8;115
"1106";"360050462011";13;11;94;22;6;146
"1107";"360050462012";1;0;2;1;1;5
"1108";"360050462013";19;11;54;5;5;94
"1109";"360050462014";11;2;69;3;2;87
"1110";"360050462015";25;1;8;0;1;35
"1111";"360050462016";34;3;12;5;3;57
"1112";"360050462017";3;2;19;0;0;24
"1113";"360050462018";3;4;48;4;6;65
"1114";"360050462019";8;0;16;2;1;27
"1115";"360050462021";55;21;139;211;28;454
"1116";"360050462022";28;19;195;93;19;354
"1117";"360050462023";64;23;154;80;15;336
"1118";"360050462024";14;19;47;37;8;125
"1119";"360050462025";22;10;85;55;18;190
"1120";"360050462026";11;1;20;24;1;57
"1121";"360050484001";17;5;69;16;6;113
"1122";"360050484002";36;77;298;328;80;819
"1123";"360050484003";21;2;35;37;7;102
"1124";"360050484004";40;6;114;33;6;199
"1125";"360050504001";1;7;6;4;3;21
"1126";"360050516001";27;103;197;38;25;390
"1127";"360050516002";37;27;131;52;30;277
"1128";"360050516003";17;45;123;56;44;285
"1129";"360050516004";92;93;213;38;29;465
"1130";"360470001001";6;67;104;3;7;187
"1131";"360470001002";12;19;11;1;0;43
"1132";"360470001003";44;44;51;7;34;180
"1133";"360470001004";6;33;15;0;4;58
"1134";"360470002001";17;60;224;61;99;461
"1135";"360470003011";6;7;10;0;2;25
"1136";"360470003012";14;27;21;1;2;65
"1137";"360470003013";9;32;12;1;7;61
"1138";"360470003014";6;16;55;0;12;89
"1139";"360470003015";15;37;12;0;3;67
"1140";"360470005011";58;26;68;5;19;176
"1141";"360470005012";16;30;19;2;1;68
"1142";"360470005013";8;15;22;2;11;58
"1143";"360470005021";29;11;15;10;12;77
"1144";"360470005022";27;91;27;4;20;169
"1145";"360470007001";18;39;115;11;19;202
"1146";"360470007002";27;11;44;3;5;90
"1147";"360470007003";30;14;46;14;16;120
"1148";"360470009001";43;156;136;22;56;413
"1149";"360470009002";9;33;29;11;18;100
"1150";"360470011001";8;91;237;1;76;413
"1151";"360470013001";17;160;207;9;42;435
"1152";"360470013002";4;2;9;1;1;17
"1153";"360470015001";83;188;115;14;25;425
"1154";"360470015002";300;20;21;4;29;374
"1155";"360470015003";44;98;224;7;42;415
"1156";"360470018001";41;27;349;106;80;603
"1157";"360470020001";6;18;116;13;33;186
"1158";"360470020002";14;22;176;13;23;248
"1159";"360470021001";24;137;197;3;21;382
"1160";"360470021002";18;44;166;11;43;282
"1161";"360470021003";94;243;204;7;41;589
"1162";"360470022001";91;29;351;23;69;563
"1163";"360470022002";40;20;88;14;38;200
"1164";"360470022003";44;27;298;107;31;507
"1165";"360470023001";82;25;7;4;3;121
"1166";"360470023002";172;11;5;0;11;199
"1167";"360470023003";851;35;38;6;11;941
"1168";"360470029011";4672;11;23;1;2;4709
"1169";"360470029012";200;13;22;10;18;263
"1170";"360470030001";21;9;134;46;24;234
"1171";"360470030002";42;0;68;3;13;126
"1172";"360470031001";30;36;54;3;6;129
"1173";"360470031002";2;10;14;1;3;30
"1174";"360470031003";1;4;16;2;4;27
"1175";"360470033001";6;24;35;10;10;85
"1176";"360470033002";144;96;154;7;83;484
"1177";"360470034001";29;24;96;26;29;204
"1178";"360470034002";30;16;331;10;26;413
"1179";"360470034003";9;6;234;7;15;271
"1180";"360470035001";10;79;72;5;59;225
"1181";"360470035002";24;54;35;0;14;127
"1182";"360470036001";29;8;261;9;17;324
"1183";"360470036002";108;17;335;4;9;473
"1184";"360470036003";14;1;451;43;14;523
"1185";"360470037001";48;262;314;5;78;707
"1186";"360470038001";14;11;737;15;26;803
"1187";"360470039001";29;50;165;11;37;292
"1188";"360470039002";118;29;80;3;44;274
"1189";"360470039003";21;40;101;13;82;257
"1190";"360470041001";65;85;465;15;40;670
"1191";"360470041002";11;32;52;11;18;124
"1192";"360470041003";18;17;85;10;14;144
"1193";"360470043001";0;2;5;2;0;9
"1194";"360470043002";6;11;137;12;13;179
"1195";"360470043003";26;38;62;12;13;151
"1196";"360470043004";39;79;147;17;47;329
"1197";"360470044001";12;30;165;28;26;261
"1198";"360470044002";72;3;156;15;7;253
"1199";"360470045001";10;36;87;7;20;160
"1200";"360470045002";6;14;44;4;1;69
"1201";"360470045003";17;9;27;7;5;65
"1202";"360470045004";7;10;75;4;4;100
"1203";"360470046001";16;12;166;46;20;260
"1204";"360470047001";40;66;81;24;54;265
"1205";"360470049001";17;25;173;7;16;238
"1206";"360470049002";17;3;14;10;3;47
"1207";"360470049003";10;4;30;2;5;51
"1208";"360470050001";24;5;76;3;6;114
"1209";"360470050002";16;4;77;19;8;124
"1210";"360470050003";20;7;128;12;24;191
"1211";"360470051001";1;51;63;9;8;132
"1212";"360470051002";9;11;70;14;14;118
"1213";"360470051003";22;15;122;16;34;209
"1214";"360470052011";18;9;90;7;13;137
"1215";"360470052021";20;6;29;9;8;72
"1216";"360470052022";48;5;114;9;14;190
"1217";"360470053001";31;116;251;79;79;556
"1218";"360470053002";45;29;87;20;36;217
"1219";"360470053003";45;23;98;28;21;215
"1220";"360470053004";23;20;72;12;34;161
"1221";"360470054001";58;12;86;9;11;176
"1222";"360470054002";25;14;93;9;9;150
"1223";"360470054003";35;23;89;10;48;205
"1224";"360470056011";15;4;88;49;28;184
"1225";"360470056012";82;18;204;12;18;334
"1226";"360470056021";39;81;282;20;25;447
"1227";"360470058001";57;63;74;8;26;228
"1228";"360470058002";48;45;234;18;55;400
"1229";"360470058003";12;1;35;4;4;56
"1230";"360470059001";230;156;79;17;32;514
"1231";"360470059002";21;23;206;230;50;530
"1232";"360470060001";69;22;65;7;39;202
"1233";"360470060002";23;36;114;23;23;219
"1234";"360470060003";11;21;48;3;58;141
"1235";"360470062001";38;61;48;5;26;178
"1236";"360470062002";48;255;72;3;22;400
"1237";"360470062003";52;84;59;3;4;202
"1238";"360470063001";11;2;32;3;10;58
"1239";"360470063002";7;10;38;8;17;80
"1240";"360470064001";57;42;125;6;34;264
"1241";"360470064002";42;8;130;13;93;286
"1242";"360470064003";39;106;107;11;30;293
"1243";"360470065001";6;10;20;7;14;57
"1244";"360470065002";11;20;19;3;10;63
"1245";"360470065003";13;2;38;4;5;62
"1246";"360470065004";9;7;17;15;15;63
"1247";"360470065005";7;1;13;3;11;35
"1248";"360470065006";23;19;73;14;13;142
"1249";"360470065007";5;4;15;7;27;58
"1250";"360470066001";8;97;184;27;26;342
"1251";"360470066002";73;118;127;8;18;344
"1252";"360470066003";73;39;379;21;36;548
"1253";"360470067001";5;6;11;11;8;41
"1254";"360470067002";4;15;7;0;3;29
"1255";"360470067003";7;8;33;5;9;62
"1256";"360470067004";48;31;99;4;5;187
"1257";"360470067005";9;6;20;3;14;52
"1258";"360470068001";57;11;44;7;37;156
"1259";"360470068002";282;15;72;9;59;437
"1260";"360470068003";0;15;217;3;16;251
"1261";"360470068004";62;42;163;7;28;302
"1262";"360470069001";14;22;16;5;12;69
"1263";"360470069002";19;24;51;7;23;124
"1264";"360470069003";14;58;45;8;18;143
"1265";"360470069004";32;19;33;9;19;112
"1266";"360470070001";2;5;151;18;20;196
"1267";"360470070002";21;4;90;6;11;132
"1268";"360470071001";6;15;21;2;3;47
"1269";"360470071002";18;25;55;21;18;137
"1270";"360470071003";85;21;10;2;3;121
"1271";"360470071004";504;53;7;3;5;572
"1272";"360470072001";84;18;109;38;69;318
"1273";"360470074001";59;27;188;5;38;317
"1274";"360470074002";86;14;21;2;58;181
"1275";"360470074003";58;63;48;4;38;211
"1276";"360470074004";18;6;26;5;13;68
"1277";"360470075001";7;36;28;12;19;102
"1278";"360470075002";7;78;24;12;6;127
"1279";"360470075003";13;27;88;13;20;161
"1280";"360470075004";27;13;15;5;14;74
"1281";"360470075005";5;29;61;18;6;119
"1282";"360470076001";90;73;47;10;66;286
"1283";"360470076002";43;25;21;3;48;140
"1284";"360470076003";68;20;114;3;40;245
"1285";"360470077001";8;10;95;5;17;135
"1286";"360470077002";21;31;245;13;20;330
"1287";"360470077003";43;115;64;19;31;272
"1288";"360470077004";31;56;20;19;37;163
"1289";"360470078001";56;28;46;7;35;172
"1290";"360470078002";36;24;11;5;33;109
"1291";"360470078003";67;69;72;6;34;248
"1292";"360470078004";53;24;13;6;32;128
"1293";"360470080001";138;78;40;4;49;309
"1294";"360470080002";146;106;42;5;50;349
"1295";"360470080003";22;1;44;6;31;104
"1296";"360470082001";45;31;21;20;41;158
"1297";"360470082002";49;21;44;9;15;138
"1298";"360470082003";53;25;29;12;19;138
"1299";"360470084001";20;64;88;9;30;211
"1300";"360470084002";76;40;44;4;36;200
"1301";"360470084003";9;26;55;6;45;141
"1302";"360470085001";209;83;11;9;21;333
"1303";"360470085002";101;19;12;3;7;142
"1304";"360470085003";83;44;9;5;6;147
"1305";"360470086001";25;961;67;4;28;1085
"1306";"360470088001";74;115;66;14;49;318
"1307";"360470088002";63;43;65;16;24;211
"1308";"360470090001";34;22;126;18;54;254
"1309";"360470090002";65;27;236;7;46;381
"1310";"360470092001";400;37;46;3;36;522
"1311";"360470092002";223;17;63;5;55;363
"1312";"360470092003";61;22;25;6;36;150
"1313";"360470094001";50;13;88;4;39;194
"1314";"360470094002";38;25;108;5;35;211
"1315";"360470094003";55;101;67;6;57;286
"1316";"360470096001";52;22;72;6;59;211
"1317";"360470096002";44;24;71;4;38;181
"1318";"360470096003";63;12;147;15;35;272
"1319";"360470096004";60;96;67;3;62;288
"1320";"360470098001";29;33;82;4;45;193
"1321";"360470098002";46;39;140;5;62;292
"1322";"360470098003";33;15;77;1;49;175
"1323";"360470098004";47;87;67;8;57;266
"1324";"360470100001";14;11;26;3;41;95
"1325";"360470100002";44;7;41;3;41;136
"1326";"360470100003";13;28;24;4;48;117
"1327";"360470100004";87;121;26;2;65;301
"1328";"360470101001";76;102;96;28;63;365
"1329";"360470101002";33;28;161;37;41;300
"1330";"360470101003";48;40;99;33;37;257
"1331";"360470102001";20;33;114;7;104;278
"1332";"360470102002";16;25;36;2;37;116
"1333";"360470102003";50;59;56;7;47;219
"1334";"360470104001";18;17;210;1;80;326
"1335";"360470104002";63;17;66;9;54;209
"1336";"360470104003";38;35;141;1;74;289
"1337";"360470106001";15;8;195;5;108;331
"1338";"360470106002";26;4;73;2;55;160
"1339";"360470106003";71;1;74;3;73;222
"1340";"360470108001";28;23;99;17;56;223
"1341";"360470108002";27;4;130;12;27;200
"1342";"360470108003";13;10;160;8;84;275
"1343";"360470110001";28;32;290;37;49;436
"1344";"360470110002";86;16;495;23;57;677
"1345";"360470112001";71;37;233;24;27;392
"1346";"360470112002";27;7;30;9;11;84
"1347";"360470112003";9;3;84;3;12;111
"1348";"360470112004";82;52;57;6;30;227
"1349";"360470114001";3;10;59;3;16;91
"1350";"360470114002";30;76;226;15;17;364
"1351";"360470114003";35;10;84;8;29;166
"1352";"360470116001";12;14;164;5;24;219
"1353";"360470116002";41;7;81;1;40;170
"1354";"360470116003";9;12;67;4;29;121
"1355";"360470117001";29;15;116;31;32;223
"1356";"360470117002";12;21;88;17;43;181
"1357";"360470117003";27;58;145;19;41;290
"1358";"360470118001";41;47;83;4;50;225
"1359";"360470118002";8;7;188;8;49;260
"1360";"360470119001";16;94;233;16;60;419
"1361";"360470119002";44;1910;222;46;100;2322
"1362";"360470119003";22;40;227;10;59;358
"1363";"360470120001";41;23;322;34;93;513
"1364";"360470121001";80;32;142;62;58;374
"1365";"360470121002";21;26;111;35;72;265
"1366";"360470122001";75;39;52;5;86;257
"1367";"360470122002";53;44;97;3;50;247
"1368";"360470122003";66;101;316;5;70;558
"1369";"360470126001";68;27;83;8;39;225
"1370";"360470126002";6;19;66;9;16;116
"1371";"360470126003";11;15;182;5;23;236
"1372";"360470127001";111;83;126;12;41;373
"1373";"360470127002";130;87;109;61;32;419
"1374";"360470127003";152;34;16;1;3;206
"1375";"360470128011";62;127;195;9;40;433
"1376";"360470129011";35;38;170;17;40;300
"1377";"360470129012";80;175;126;13;34;428
"1378";"360470129013";18;9;79;8;15;129
"1379";"360470129021";11;63;76;3;25;178
"1380";"360470129022";46;642;281;10;18;997
"1381";"360470129023";32;33;46;5;16;132
"1382";"360470130001";6;13;57;9;17;102
"1383";"360470130002";35;7;87;14;26;169
"1384";"360470130003";13;14;153;12;46;238
"1385";"360470130004";32;22;120;12;44;230
"1386";"360470131001";26;45;56;5;12;144
"1387";"360470131002";46;22;29;2;18;117
"1388";"360470131003";17;32;26;11;11;97
"1389";"360470131004";64;57;31;2;22;176
"1390";"360470132001";12;1;36;1;18;68
"1391";"360470132002";12;7;172;25;51;267
"1392";"360470133001";19;31;46;15;9;120
"1393";"360470133002";18;31;51;5;19;124
"1394";"360470133003";18;17;66;7;8;116
"1395";"360470133004";30;8;48;3;18;107
"1396";"360470134001";47;75;728;34;56;940
"1397";"360470134002";79;11;91;19;42;242
"1398";"360470134003";119;58;217;16;31;441
"1399";"360470135001";42;35;27;3;9;116
"1400";"360470135002";23;80;85;26;47;261
"1401";"360470135003";26;63;135;10;28;262
"1402";"360470136001";15;15;152;12;40;234
"1403";"360470136002";38;5;93;5;28;169
"1404";"360470136003";46;20;90;10;33;199
"1405";"360470136004";15;15;98;10;26;164
"1406";"360470137001";15;103;36;9;19;182
"1407";"360470137002";20;77;46;12;24;179
"1408";"360470137003";44;67;168;29;79;387
"1409";"360470138001";34;46;115;6;48;249
"1410";"360470138002";28;11;33;5;24;101
"1411";"360470138003";20;15;55;4;21;115
"1412";"360470139001";49;22;35;4;20;130
"1413";"360470139002";160;85;37;4;25;311
"1414";"360470139003";13;8;7;9;22;59
"1415";"360470139004";13;9;28;15;66;131
"1416";"360470140001";17;2;121;7;20;167
"1417";"360470140002";11;10;130;15;28;194
"1418";"360470141001";36;26;69;8;21;160
"1419";"360470141002";19;15;79;16;44;173
"1420";"360470141003";95;21;116;10;20;262
"1421";"360470142001";154;28;96;11;53;342
"1422";"360470142002";51;22;40;0;29;142
"1423";"360470142003";154;63;63;2;26;308
"1424";"360470143001";69;69;101;13;83;335
"1425";"360470143002";56;40;107;13;62;278
"1426";"360470143003";38;25;63;6;32;164
"1427";"360470145001";79;111;194;15;32;431
"1428";"360470145002";47;17;56;19;47;186
"1429";"360470145003";67;37;102;21;24;251
"1430";"360470145004";50;19;52;14;27;162
"1431";"360470147001";22;45;56;7;19;149
"1432";"360470147002";74;27;97;7;17;222
"1433";"360470148001";22;4;47;4;18;95
"1434";"360470148002";3;6;62;6;16;93
"1435";"360470149001";29;5;45;7;11;97
"1436";"360470149002";30;23;70;15;8;146
"1437";"360470149003";7;8;28;8;9;60
"1438";"360470149004";18;34;62;5;17;136
"1439";"360470149005";9;19;48;1;19;96
"1440";"360470150001";7;0;36;5;15;63
"1441";"360470150002";16;13;73;20;9;131
"1442";"360470151001";12;5;34;4;49;104
"1443";"360470151002";30;16;15;6;5;72
"1444";"360470151003";53;12;42;11;31;149
"1445";"360470151004";10;12;13;3;36;74
"1446";"360470152001";7;2;55;23;14;101
"1447";"360470152002";7;1;26;18;3;55
"1448";"360470152003";13;9;119;31;20;192
"1449";"360470153001";9;7;96;0;11;123
"1450";"360470153002";12;13;44;9;41;119
"1451";"360470153003";17;23;26;17;32;115
"1452";"360470153004";4;1;34;1;31;71
"1453";"360470154001";16;33;39;6;10;104
"1454";"360470155001";35;30;17;3;8;93
"1455";"360470155002";21;2;14;4;13;54
"1456";"360470155003";16;34;95;1;7;153
"1457";"360470155004";7;27;37;8;3;82
"1458";"360470157001";8;15;79;10;8;120
"1459";"360470157002";16;14;16;7;13;66
"1460";"360470157003";15;13;59;13;14;114
"1461";"360470157004";25;18;12;1;7;63
"1462";"360470159001";17;36;88;13;44;198
"1463";"360470159002";15;8;46;4;15;88
"1464";"360470159003";27;58;31;5;11;132
"1465";"360470159004";29;13;46;7;8;103
"1466";"360470159005";20;18;26;4;13;81
"1467";"360470160001";18;0;49;18;18;103
"1468";"360470160002";37;53;62;2;16;170
"1469";"360470160003";30;8;80;20;24;162
"1470";"360470160004";76;142;127;22;55;422
"1471";"360470161001";97;97;266;21;11;492
"1472";"360470161002";23;48;95;7;4;177
"1473";"360470161003";67;269;196;32;47;611
"1474";"360470162001";23;4;63;7;17;114
"1475";"360470162002";8;6;194;19;39;266
"1476";"360470163001";32;24;133;9;17;215
"1477";"360470163002";20;27;61;10;17;135
"1478";"360470163003";145;16;68;6;17;252
"1479";"360470164001";2;1;10;5;7;25
"1480";"360470165001";16;12;46;5;10;89
"1481";"360470165002";23;7;37;7;12;86
"1482";"360470165003";39;18;91;10;9;167
"1483";"360470165004";17;14;19;4;6;60
"1484";"360470166001";19;10;56;14;12;111
"1485";"360470166002";17;15;42;30;35;139
"1486";"360470167001";16;3;61;7;11;98
"1487";"360470167002";4;8;44;11;9;76
"1488";"360470167003";39;18;35;6;16;114
"1489";"360470167004";32;22;155;9;25;243
"1490";"360470168001";82;9;597;18;28;734
"1491";"360470169001";1;13;39;2;20;75
"1492";"360470169002";61;43;11;2;15;132
"1493";"360470169003";23;44;15;5;22;109
"1494";"360470169004";20;23;32;4;23;102
"1495";"360470169005";26;21;45;5;5;102
"1496";"360470170001";10;5;39;9;13;76
"1497";"360470170002";15;32;260;12;35;354
"1498";"360470170003";10;7;216;18;22;273
"1499";"360470171001";5;4;67;15;10;101
"1500";"360470171002";5;2;18;4;3;32
"1501";"360470171003";6;7;31;0;9;53
"1502";"360470171004";29;3;38;4;7;81
"1503";"360470172001";25;13;142;21;35;236
"1504";"360470172002";37;17;131;18;35;238
"1505";"360470174001";8;52;178;22;25;285
"1506";"360470174002";15;4;99;7;9;134
"1507";"360470175001";17;20;45;15;6;103
"1508";"360470176001";5;1;173;29;21;229
"1509";"360470176002";33;4;172;20;17;246
"1510";"360470177001";76;320;209;59;122;786
"1511";"360470178001";19;42;63;21;33;178
"1512";"360470178002";43;8;293;18;43;405
"1513";"360470179001";18;4;17;1;1;41
"1514";"360470179002";408;89;184;8;11;700
"1515";"360470179003";32;56;59;2;8;157
"1516";"360470180001";20;3;125;26;44;218
"1517";"360470180002";40;15;141;16;16;228
"1518";"360470181001";40;52;20;3;17;132
"1519";"360470181002";3;7;24;3;3;40
"1520";"360470181003";34;74;63;7;30;208
"1521";"360470181004";27;37;44;20;8;136
"1522";"360470182001";17;12;73;12;33;147
"1523";"360470182002";20;8;128;28;49;233
"1524";"360470183001";24;86;46;8;25;189
"1525";"360470183002";241;393;33;16;20;703
"1526";"360470183003";28;20;80;5;21;154
"1527";"360470184001";6;3;186;16;16;227
"1528";"360470184002";15;4;121;14;41;195
"1529";"360470185011";11;65;26;3;10;115
"1530";"360470185012";84;10;98;3;6;201
"1531";"360470185013";101;9;46;0;10;166
"1532";"360470185014";42;12;4;1;4;63
"1533";"360470186001";20;0;107;3;33;163
"1534";"360470186002";27;3;60;6;16;112
"1535";"360470187001";63;81;91;12;36;283
"1536";"360470188001";14;8;175;16;32;245
"1537";"360470188002";26;5;325;8;54;418
"1538";"360470190001";19;4;279;10;30;342
"1539";"360470190002";56;6;170;10;44;286
"1540";"360470190003";12;15;217;13;39;296
"1541";"360470191001";152;167;186;10;68;583
"1542";"360470191002";25;25;58;9;20;137
"1543";"360470191003";45;147;71;7;39;309
"1544";"360470192001";13;5;126;16;29;189
"1545";"360470192002";22;173;168;41;226;630
"1546";"360470193001";55;90;73;10;24;252
"1547";"360470193002";76;22;42;4;11;155
"1548";"360470193003";7;9;12;1;4;33
"1549";"360470193004";27;48;10;1;25;111
"1550";"360470194001";24;20;120;39;49;252
"1551";"360470194002";149;2;161;19;22;353
"1552";"360470194003";10;3;131;97;29;270
"1553";"360470195001";43;75;71;5;16;210
"1554";"360470195002";78;66;52;6;10;212
"1555";"360470195003";15;26;36;9;3;89
"1556";"360470195004";9;18;43;11;7;88
"1557";"360470196001";37;3;159;16;36;251
"1558";"360470196002";6;2;104;6;51;169
"1559";"360470196003";19;8;85;2;34;148
"1560";"360470197001";10;13;102;5;4;134
"1561";"360470197002";52;46;45;9;15;167
"1562";"360470197003";19;29;67;2;21;138
"1563";"360470197004";10;58;29;6;16;119
"1564";"360470198001";5;6;67;12;28;118
"1565";"360470198002";15;4;118;17;33;187
"1566";"360470199001";23;64;50;6;13;156
"1567";"360470199002";185;93;39;0;21;338
"1568";"360470199003";57;292;62;9;40;460
"1569";"360470199004";69;4;40;3;9;125
"1570";"360470200001";9;5;90;8;29;141
"1571";"360470200002";7;13;189;2;42;253
"1572";"360470201001";33;33;25;4;15;110
"1573";"360470201002";68;155;39;10;54;326
"1574";"360470201003";114;58;49;5;33;259
"1575";"360470201004";116;26;38;5;5;190
"1576";"360470202001";8;5;99;9;39;160
"1577";"360470202002";7;6;167;8;32;220
"1578";"360470203001";90;378;338;42;51;899
"1579";"360470203002";17;24;56;16;20;133
"1580";"360470204001";28;22;218;13;37;318
"1581";"360470204002";1;4;163;9;27;204
"1582";"360470205001";52;64;254;12;27;409
"1583";"360470205002";99;200;212;22;16;549
"1584";"360470205003";20;44;38;28;15;145
"1585";"360470206001";22;3;78;6;37;146
"1586";"360470206002";15;2;143;6;93;259
"1587";"360470207001";131;115;74;20;18;358
"1588";"360470207002";54;162;80;1;22;319
"1589";"360470207003";4;6;52;5;8;75
"1590";"360470208001";1;2;221;0;19;243
"1591";"360470208002";9;2;166;5;55;237
"1592";"360470208003";14;5;196;2;51;268
"1593";"360470210001";24;6;261;20;39;350
"1594";"360470210002";4;4;128;8;35;179
"1595";"360470210003";11;3;47;3;25;89
"1596";"360470211001";7;25;56;5;5;98
"1597";"360470211002";55;71;599;62;54;841
"1598";"360470212001";49;18;139;27;42;275
"1599";"360470212002";23;9;65;3;24;124
"1600";"360470212003";18;5;191;5;23;242
"1601";"360470213001";77;97;11;3;14;202
"1602";"360470213002";125;60;16;2;13;216
"1603";"360470213003";94;12;26;12;4;148
"1604";"360470214001";5;10;105;58;18;196
"1605";"360470214002";20;33;108;8;29;198
"1606";"360470215001";71;183;87;9;13;363
"1607";"360470215002";76;104;27;1;23;231
"1608";"360470215003";97;49;23;2;25;196
"1609";"360470215004";45;98;49;3;25;220
"1610";"360470216001";6;0;92;7;2;107
"1611";"360470216002";0;3;97;8;7;115
"1612";"360470216003";25;13;135;11;29;213
"1613";"360470217001";214;73;53;7;22;369
"1614";"360470217002";189;352;60;1;26;628
"1615";"360470218001";18;7;48;6;32;111
"1616";"360470218002";1;0;34;8;3;46
"1617";"360470218003";11;7;93;13;19;143
"1618";"360470219001";64;57;9;5;17;152
"1619";"360470219002";45;12;39;2;14;112
"1620";"360470219003";53;48;74;9;32;216
"1621";"360470220001";3;3;18;4;8;36
"1622";"360470220002";23;18;60;4;17;122
"1623";"360470220003";16;1;25;0;7;49
"1624";"360470220004";4;5;119;6;20;154
"1625";"360470221001";70;39;55;42;47;253
"1626";"360470221002";259;231;109;13;71;683
"1627";"360470221003";39;39;31;5;15;129
"1628";"360470222001";8;5;29;6;11;59
"1629";"360470222002";4;12;35;7;11;69
"1630";"360470222003";21;11;94;10;26;162
"1631";"360470224001";8;3;77;5;9;102
"1632";"360470224002";18;2;51;4;4;79
"1633";"360470224003";59;10;190;6;11;276
"1634";"360470224004";19;19;396;7;22;463
"1635";"360470226001";44;25;159;72;50;350
"1636";"360470226002";55;36;177;17;35;320
"1637";"360470227001";89;133;43;9;58;332
"1638";"360470227002";59;390;122;31;44;646
"1639";"360470227003";137;168;46;19;35;405
"1640";"360470227004";136;118;93;9;41;397
"1641";"360470228001";34;37;154;10;26;261
"1642";"360470228002";6;45;115;22;2;190
"1643";"360470228003";2;11;83;18;7;121
"1644";"360470229001";178;56;38;4;29;305
"1645";"360470229002";110;17;43;6;35;211
"1646";"360470229003";24;45;81;6;20;176
"1647";"360470229004";135;44;33;15;42;269
"1648";"360470230001";3;6;38;10;2;59
"1649";"360470230002";2;6;23;1;4;36
"1650";"360470230003";13;14;79;74;13;193
"1651";"360470231001";146;142;80;1;27;396
"1652";"360470231002";169;72;153;21;32;447
"1653";"360470231003";121;83;29;10;34;277
"1654";"360470232001";1;2;89;4;9;105
"1655";"360470232002";13;1;50;1;9;74
"1656";"360470232003";2;1;27;1;11;42
"1657";"360470232004";1;6;18;4;8;37
"1658";"360470232005";9;9;137;0;8;163
"1659";"360470233001";84;125;68;4;36;317
"1660";"360470233002";776;61;28;4;11;880
"1661";"360470233003";152;120;139;20;89;520
"1662";"360470234001";7;7;58;2;6;80
"1663";"360470234002";20;4;48;2;5;79
"1664";"360470234003";39;8;77;6;5;135
"1665";"360470235001";163;304;351;19;62;899
"1666";"360470235002";45;16;98;99;28;286
"1667";"360470236001";6;3;70;2;11;92
"1668";"360470236002";11;17;28;6;5;67
"1669";"360470236003";3;8;47;0;4;62
"1670";"360470236004";9;17;136;2;5;169
"1671";"360470238001";8;2;55;5;4;74
"1672";"360470238002";22;7;84;25;9;147
"1673";"360470238003";3;5;32;13;12;65
"1674";"360470240001";5;4;54;5;5;73
"1675";"360470240002";6;6;74;13;36;135
"1676";"360470240003";25;3;28;30;12;98
"1677";"360470241001";147;362;734;49;126;1418
"1678";"360470241002";86;55;59;12;26;238
"1679";"360470242001";6;1;125;42;4;178
"1680";"360470242002";1;2;71;11;11;96
"1681";"360470243001";153;69;48;14;44;328
"1682";"360470243002";303;66;55;25;22;471
"1683";"360470243003";104;53;54;13;34;258
"1684";"360470244001";22;18;124;6;29;199
"1685";"360470244002";8;11;205;10;15;249
"1686";"360470244003";4;7;141;27;23;202
"1687";"360470245001";58;20;90;63;22;253
"1688";"360470245002";210;60;34;9;27;340
"1689";"360470245003";75;42;18;2;13;150
"1690";"360470245004";52;36;31;0;23;142
"1691";"360470246001";8;5;79;4;10;106
"1692";"360470246002";9;3;168;14;21;215
"1693";"360470246003";15;38;179;13;9;254
"1694";"360470247001";79;111;43;11;39;283
"1695";"360470247002";123;70;111;27;85;416
"1696";"360470248001";3;4;80;5;33;125
"1697";"360470248002";31;69;199;17;90;406
"1698";"360470249001";79;125;24;21;29;278
"1699";"360470249002";120;21;32;3;16;192
"1700";"360470249003";117;1312;61;8;26;1524
"1701";"360470249004";8;17;10;2;17;54
"1702";"360470250001";7;12;199;108;57;383
"1703";"360470250002";3;28;137;8;22;198
"1704";"360470251001";85;133;67;14;21;320
"1705";"360470251002";201;36;34;15;14;300
"1706";"360470251003";111;72;34;3;26;246
"1707";"360470252001";22;6;112;4;20;164
"1708";"360470252002";110;6;159;2;11;288
"1709";"360470252003";21;5;413;7;7;453
"1710";"360470252004";28;8;119;6;17;178
"1711";"360470253001";73;29;68;9;22;201
"1712";"360470253002";83;21;59;4;21;188
"1713";"360470253003";116;48;44;8;24;240
"1714";"360470254001";13;2;37;3;15;70
"1715";"360470254002";15;3;132;9;29;188
"1716";"360470254003";58;1;187;6;27;279
"1717";"360470255001";130;25;18;1;6;180
"1718";"360470255002";218;16;9;3;26;272
"1719";"360470256001";13;20;168;7;39;247
"1720";"360470256002";27;5;94;4;23;153
"1721";"360470257001";42;24;99;7;38;210
"1722";"360470257002";57;15;90;11;21;194
"1723";"360470257003";25;25;68;12;34;164
"1724";"360470258001";41;2;276;19;46;384
"1725";"360470258002";28;6;137;4;27;202
"1726";"360470258003";22;2;108;15;24;171
"1727";"360470259011";264;165;151;34;51;665
"1728";"360470259021";254;7;30;10;7;308
"1729";"360470260001";24;3;48;3;24;102
"1730";"360470260002";11;5;57;5;10;88
"1731";"360470260003";195;9;75;3;20;302
"1732";"360470261001";187;150;124;7;28;496
"1733";"360470261002";80;17;29;6;24;156
"1734";"360470261003";171;75;41;13;20;320
"1735";"360470261004";120;31;48;5;32;236
"1736";"360470261005";195;35;43;11;18;302
"1737";"360470262001";73;47;206;9;55;390
"1738";"360470262002";9;14;199;20;59;301
"1739";"360470263001";185;130;79;23;26;443
"1740";"360470264001";17;16;103;12;25;173
"1741";"360470264002";42;4;276;39;49;410
"1742";"360470264003";34;17;207;4;39;301
"1743";"360470264004";17;14;62;5;26;124
"1744";"360470265001";146;11;47;10;8;222
"1745";"360470265002";191;40;54;6;33;324
"1746";"360470265003";41;24;88;19;17;189
"1747";"360470265004";72;29;44;30;21;196
"1748";"360470266001";10;7;123;17;23;180
"1749";"360470266002";25;3;86;9;22;145
"1750";"360470266003";52;4;64;2;15;137
"1751";"360470267001";48;44;12;1;16;121
"1752";"360470267002";52;72;23;6;30;183
"1753";"360470267003";31;55;58;0;25;169
"1754";"360470267004";50;62;31;7;25;175
"1755";"360470268001";36;8;32;1;11;88
"1756";"360470268002";23;0;45;3;20;91
"1757";"360470268003";4;4;186;4;20;218
"1758";"360470268004";12;1;27;3;11;54
"1759";"360470269001";70;119;32;3;45;269
"1760";"360470269002";21;12;14;14;26;87
"1761";"360470269003";74;244;42;3;43;406
"1762";"360470270001";17;3;157;10;19;206
"1763";"360470270002";48;11;171;18;18;266
"1764";"360470271001";118;49;146;58;67;438
"1765";"360470271002";43;43;115;18;13;232
"1766";"360470272001";7;0;64;1;2;74
"1767";"360470272002";39;8;65;7;9;128
"1768";"360470272003";17;1;68;7;10;103
"1769";"360470273001";18;34;24;12;8;96
"1770";"360470273002";48;20;157;8;5;238
"1771";"360470273003";56;38;29;9;31;163
"1772";"360470274001";18;1;114;9;18;160
"1773";"360470274002";9;42;190;8;27;276
"1774";"360470275001";58;39;25;4;25;151
"1775";"360470275002";62;28;25;13;17;145
"1776";"360470275003";82;465;22;10;24;603
"1777";"360470275004";112;308;51;11;27;509
"1778";"360470276001";91;12;41;6;14;164
"1779";"360470276002";22;3;111;4;41;181
"1780";"360470276003";48;16;159;76;34;333
"1781";"360470277001";124;91;15;3;3;236
"1782";"360470277002";68;22;16;7;21;134
"1783";"360470277003";69;33;33;6;5;146
"1784";"360470277004";110;12;13;11;23;169
"1785";"360470278001";132;19;117;3;21;292
"1786";"360470278002";77;34;123;4;54;292
"1787";"360470279001";74;97;24;9;19;223
"1788";"360470279002";40;69;47;7;17;180
"1789";"360470279003";111;37;66;8;30;252
"1790";"360470279004";139;69;57;13;18;296
"1791";"360470280001";18;0;96;12;18;144
"1792";"360470280002";27;22;227;10;36;322
"1793";"360470281001";106;26;82;8;13;235
"1794";"360470281002";67;20;45;15;16;163
"1795";"360470281003";150;140;113;16;299;718
"1796";"360470282001";14;3;146;32;14;209
"1797";"360470282002";82;6;178;66;20;352
"1798";"360470282003";3;0;58;4;6;71
"1799";"360470283001";60;15;69;3;21;168
"1800";"360470283002";59;11;167;13;12;262
"1801";"360470283003";94;30;47;14;14;199
"1802";"360470284001";31;2;228;0;13;274
"1803";"360470284002";66;9;255;2;22;354
"1804";"360470284003";39;1;104;1;49;194
"1805";"360470285011";50;46;119;1;44;260
"1806";"360470285021";219;43;78;6;9;355
"1807";"360470286001";55;7;5;3;2;72
"1808";"360470286002";41;4;41;9;6;101
"1809";"360470286003";12;3;2;0;3;20
"1810";"360470286004";13;4;137;0;19;173
"1811";"360470286005";14;5;89;6;9;123
"1812";"360470287001";85;375;59;35;101;655
"1813";"360470287002";58;35;78;16;22;209
"1814";"360470287003";130;34;16;14;24;218
"1815";"360470288001";32;22;122;5;16;197
"1816";"360470288002";16;9;25;14;42;106
"1817";"360470288003";28;8;102;3;35;176
"1818";"360470289001";27;94;35;7;50;213
"1819";"360470289002";91;42;60;18;28;239
"1820";"360470289003";52;60;26;8;14;160
"1821";"360470289004";132;85;50;26;19;312
"1822";"360470290001";72;4;38;6;4;124
"1823";"360470290002";74;2;56;2;12;146
"1824";"360470290003";38;13;173;1;72;297
"1825";"360470291001";111;105;71;23;41;351
"1826";"360470291002";101;36;85;9;26;257
"1827";"360470291003";255;25;29;6;16;331
"1828";"360470292001";10;3;143;9;12;177
"1829";"360470292002";26;3;202;3;20;254
"1830";"360470293001";86;12;5;5;9;117
"1831";"360470293002";65;19;5;3;11;103
"1832";"360470293003";58;23;33;13;23;150
"1833";"360470293004";24;9;30;1;14;78
"1834";"360470294001";23;20;120;3;36;202
"1835";"360470295001";157;27;90;1;26;301
"1836";"360470295002";70;82;17;4;22;195
"1837";"360470295003";30;16;12;6;18;82
"1838";"360470295004";125;12;42;2;12;193
"1839";"360470296001";63;1;229;33;21;347
"1840";"360470296002";44;18;111;10;31;214
"1841";"360470296003";33;3;187;11;23;257
"1842";"360470296004";17;8;251;2;9;287
"1843";"360470297001";15;51;64;2;22;154
"1844";"360470297002";159;204;55;13;16;447
"1845";"360470297003";16;10;49;16;12;103
"1846";"360470298001";10;8;232;5;24;279
"1847";"360470298002";12;42;161;6;31;252
"1848";"360470298003";4;6;66;13;32;121
"1849";"360470299001";38;4;56;15;27;140
"1850";"360470299002";57;47;70;40;40;254
"1851";"360470300001";26;56;302;2;34;420
"1852";"360470300002";15;82;160;20;25;302
"1853";"360470301001";35;12;57;23;22;149
"1854";"360470301002";39;4;42;14;16;115
"1855";"360470301003";46;25;105;43;25;244
"1856";"360470302001";12;8;209;7;17;253
"1857";"360470302002";31;6;112;7;11;167
"1858";"360470302003";14;16;95;4;15;144
"1859";"360470303001";208;30;104;8;13;363
"1860";"360470303002";77;19;49;27;20;192
"1861";"360470303003";207;43;56;31;37;374
"1862";"360470304001";8;10;299;55;28;400
"1863";"360470304002";33;22;267;16;17;355
"1864";"360470304003";34;2;55;31;11;133
"1865";"360470305001";146;996;637;182;115;2076
"1866";"360470305002";254;145;98;20;45;562
"1867";"360470305003";91;95;63;15;13;277
"1868";"360470305004";158;78;40;15;30;321
"1869";"360470306001";24;46;262;24;29;385
"1870";"360470307001";75;6;13;4;3;101
"1871";"360470307002";78;8;12;4;4;106
"1872";"360470307003";201;114;226;64;88;693
"1873";"360470308001";167;49;222;46;34;518
"1874";"360470309001";103;31;76;19;43;272
"1875";"360470309002";52;9;101;24;18;204
"1876";"360470311001";57;15;114;10;48;244
"1877";"360470311002";121;288;62;12;19;502
"1878";"360470311003";75;37;45;4;33;194
"1879";"360470313001";37;21;27;17;19;121
"1880";"360470313002";55;13;26;14;14;122
"1881";"360470313003";233;75;37;7;35;387
"1882";"360470313004";30;34;86;3;27;180
"1883";"360470314001";24;7;91;23;16;161
"1884";"360470314002";18;12;173;46;12;261
"1885";"360470314003";25;17;20;3;2;67
"1886";"360470314004";137;11;166;30;24;368
"1887";"360470315001";131;266;123;7;61;588
"1888";"360470315002";143;67;30;3;23;266
"1889";"360470315003";170;120;55;5;46;396
"1890";"360470315004";191;296;29;19;50;585
"1891";"360470317011";129;72;140;6;39;386
"1892";"360470317012";66;165;40;10;26;307
"1893";"360470317013";75;62;86;19;35;277
"1894";"360470317021";111;72;17;7;12;219
"1895";"360470317022";93;38;10;26;20;187
"1896";"360470317023";291;57;74;6;30;458
"1897";"360470319001";152;42;46;16;24;280
"1898";"360470319002";29;108;49;1;16;203
"1899";"360470319003";167;58;76;78;15;394
"1900";"360470321001";70;108;18;4;26;226
"1901";"360470321002";105;87;45;0;21;258
"1902";"360470321003";197;105;16;7;13;338
"1903";"360470321004";224;58;47;4;21;354
"1904";"360470323001";152;49;42;7;38;288
"1905";"360470323002";124;24;32;2;20;202
"1906";"360470323003";58;20;67;7;33;185
"1907";"360470325001";63;112;22;24;77;298
"1908";"360470325002";163;37;35;4;20;259
"1909";"360470325003";204;84;31;34;21;374
"1910";"360470326001";26;29;99;12;67;233
"1911";"360470326002";127;55;13;2;49;246
"1912";"360470326003";165;100;6;0;12;283
"1913";"360470326004";50;29;26;9;13;127
"1914";"360470326005";18;8;86;20;22;154
"1915";"360470327001";82;88;27;13;17;227
"1916";"360470327002";203;109;43;23;23;401
"1917";"360470327003";44;74;27;3;20;168
"1918";"360470328001";24;3;37;5;23;92
"1919";"360470328002";8;7;28;5;3;51
"1920";"360470328003";186;5;2;4;11;208
"1921";"360470328004";141;5;26;11;18;201
"1922";"360470329001";102;35;63;14;8;222
"1923";"360470329002";171;32;26;6;6;241
"1924";"360470329003";134;344;14;0;19;511
"1925";"360470329004";93;66;11;7;32;209
"1926";"360470330001";97;6;6;8;10;127
"1927";"360470330002";22;2;8;2;1;35
"1928";"360470330003";134;40;20;21;5;220
"1929";"360470331001";308;23;39;4;5;379
"1930";"360470331002";90;39;24;16;4;173
"1931";"360470331003";24;4;194;5;2;229
"1932";"360470333001";117;14;33;3;4;171
"1933";"360470333002";57;11;75;5;10;158
"1934";"360470333003";111;15;29;15;7;177
"1935";"360470335001";31;13;93;3;10;150
"1936";"360470335002";17;12;59;14;3;105
"1937";"360470335003";21;15;153;44;7;240
"1938";"360470336001";7;4;9;4;22;46
"1939";"360470336002";3;3;6;1;23;36
"1940";"360470336003";2;1;6;0;3;12
"1941";"360470336004";46;3;8;2;8;67
"1942";"360470336005";36;12;6;1;28;83
"1943";"360470337001";52;14;29;23;9;127
"1944";"360470337002";82;28;50;22;15;197
"1945";"360470337003";65;24;114;8;28;239
"1946";"360470339001";186;43;90;5;16;340
"1947";"360470339002";218;181;71;16;14;500
"1948";"360470339003";41;46;20;1;5;113
"1949";"360470339004";94;16;28;10;15;163
"1950";"360470340001";45;10;18;5;10;88
"1951";"360470340002";0;24;11;3;2;40
"1952";"360470341001";61;28;17;10;4;120
"1953";"360470341002";178;25;22;5;8;238
"1954";"360470341003";149;37;22;16;19;243
"1955";"360470342001";134;20;10;6;27;197
"1956";"360470342002";170;15;42;5;22;254
"1957";"360470342003";118;13;16;1;17;165
"1958";"360470342004";12;6;0;0;1;19
"1959";"360470343001";255;17;11;6;26;315
"1960";"360470343002";35;17;68;12;19;151
"1961";"360470343003";159;296;29;35;18;537
"1962";"360470345001";78;40;75;10;21;224
"1963";"360470345002";63;84;125;62;15;349
"1964";"360470347001";65;32;31;3;2;133
"1965";"360470347002";78;11;62;9;14;174
"1966";"360470347003";159;59;74;5;27;324
"1967";"360470348001";32;19;475;195;84;805
"1968";"360470348002";56;9;117;28;130;340
"1969";"360470349001";113;142;13;2;14;284
"1970";"360470349002";79;11;36;5;15;146
"1971";"360470349003";90;70;230;4;25;419
"1972";"360470349004";38;11;12;0;13;74
"1973";"360470350001";1;11;0;3;3;18
"1974";"360470350002";7;53;41;12;61;174
"1975";"360470351001";172;221;88;6;20;507
"1976";"360470351002";147;34;34;2;34;251
"1977";"360470351003";122;69;78;16;43;328
"1978";"360470352001";7;94;39;3;64;207
"1979";"360470353001";98;93;109;5;13;318
"1980";"360470353002";174;57;28;7;16;282
"1981";"360470353003";307;60;79;10;23;479
"1982";"360470354001";6;2;51;17;19;95
"1983";"360470354002";109;8;56;8;10;191
"1984";"360470354003";5;15;26;1;13;60
"1985";"360470355001";308;47;97;13;28;493
"1986";"360470355002";63;22;42;0;10;137
"1987";"360470355003";119;59;43;9;22;252
"1988";"360470356011";7;3;27;15;2;54
"1989";"360470356021";28;2;27;2;6;65
"1990";"360470356022";17;2;36;7;5;67
"1991";"360470356023";54;7;41;3;10;115
"1992";"360470357001";219;88;74;11;22;414
"1993";"360470359001";106;35;150;15;35;341
"1994";"360470359002";60;20;59;5;10;154
"1995";"360470359003";150;69;45;17;32;313
"1996";"360470359004";398;52;34;2;11;497
"1997";"360470360011";15;36;4;1;23;79
"1998";"360470360012";18;7;28;0;12;65
"1999";"360470360013";32;9;36;1;12;90
"2000";"360470360021";73;249;27;1;17;367
"2001";"360470360022";43;35;13;1;65;157
"2002";"360470361001";33;12;80;6;6;137
"2003";"360470361002";28;20;37;34;29;148
"2004";"360470361003";52;22;28;18;8;128
"2005";"360470362001";84;110;209;5;74;482
"2006";"360470362002";46;10;141;4;33;234
"2007";"360470362003";26;10;102;1;27;166
"2008";"360470363001";56;6;28;7;24;121
"2009";"360470363002";75;31;96;22;17;241
"2010";"360470363003";68;29;70;24;23;214
"2011";"360470363004";53;11;39;10;1;114
"2012";"360470364001";28;12;241;12;51;344
"2013";"360470364002";42;15;203;24;44;328
"2014";"360470365011";64;12;72;7;9;164
"2015";"360470365012";85;8;181;38;21;333
"2016";"360470365021";52;49;177;123;63;464
"2017";"360470366001";23;16;79;50;39;207
"2018";"360470366002";45;15;80;20;27;187
"2019";"360470366003";53;6;145;5;20;229
"2020";"360470367001";94;48;105;86;43;376
"2021";"360470367002";24;5;40;27;20;116
"2022";"360470369001";112;43;44;27;22;248
"2023";"360470369002";91;34;56;32;41;254
"2024";"360470369003";148;53;49;27;44;321
"2025";"360470369004";197;19;143;10;50;419
"2026";"360470370001";13;10;103;23;21;170
"2027";"360470370002";8;7;61;10;9;95
"2028";"360470370003";9;4;161;5;11;190
"2029";"360470370004";10;1;40;5;8;64
"2030";"360470371001";30;33;59;10;15;147
"2031";"360470371002";46;14;30;9;11;110
"2032";"360470371003";43;1;68;6;8;126
"2033";"360470371004";42;5;115;5;21;188
"2034";"360470371005";17;15;25;20;17;94
"2035";"360470373001";38;12;14;6;23;93
"2036";"360470373002";33;14;44;15;13;119
"2037";"360470373003";86;111;39;10;22;268
"2038";"360470373004";178;100;51;13;34;376
"2039";"360470374011";32;4;181;13;29;259
"2040";"360470374012";33;2;137;10;20;202
"2041";"360470374013";43;6;75;10;18;152
"2042";"360470374021";18;17;777;52;20;884
"2043";"360470374022";34;82;17;11;9;153
"2044";"360470374023";35;10;5;1;3;54
"2045";"360470374024";9;1;163;18;9;200
"2046";"360470375001";56;25;31;20;16;148
"2047";"360470375002";128;33;53;13;54;281
"2048";"360470375003";81;35;19;9;23;167
"2049";"360470377001";63;59;51;25;45;243
"2050";"360470377002";90;54;34;36;22;236
"2051";"360470377003";91;69;25;8;17;210
"2052";"360470377004";118;24;83;21;15;261
"2053";"360470379001";63;49;36;11;12;171
"2054";"360470379002";62;65;207;20;30;384
"2055";"360470379003";49;21;78;52;41;241
"2056";"360470381001";71;16;64;11;18;180
"2057";"360470381002";91;23;8;7;8;137
"2058";"360470381003";92;76;54;17;24;263
"2059";"360470381004";50;86;11;7;13;167
"2060";"360470382001";74;7;124;6;16;227
"2061";"360470382002";160;30;40;10;9;249
"2062";"360470382003";66;7;1;2;5;81
"2063";"360470383001";202;58;63;13;16;352
"2064";"360470383002";120;62;49;7;22;260
"2065";"360470383003";57;22;47;16;27;169
"2066";"360470383004";43;20;16;9;17;105
"2067";"360470385001";43;37;59;7;21;167
"2068";"360470385002";34;19;50;11;5;119
"2069";"360470385003";120;45;73;8;16;262
"2070";"360470385004";35;19;113;14;12;193
"2071";"360470386001";53;8;232;125;83;501
"2072";"360470386002";21;25;103;36;67;252
"2073";"360470387001";57;34;50;14;62;217
"2074";"360470387002";32;10;39;9;8;98
"2075";"360470387003";40;14;81;13;16;164
"2076";"360470387004";48;41;55;4;30;178
"2077";"360470388001";24;2;31;6;6;69
"2078";"360470388002";10;3;170;17;24;224
"2079";"360470388003";34;4;132;15;23;208
"2080";"360470388004";6;0;70;11;9;96
"2081";"360470389001";116;110;77;35;50;388
"2082";"360470389002";113;170;49;5;42;379
"2083";"360470389003";52;155;51;15;65;338
"2084";"360470390001";31;4;125;46;28;234
"2085";"360470390002";6;1;53;9;14;83
"2086";"360470391001";105;38;73;31;24;271
"2087";"360470391002";394;79;110;17;72;672
"2088";"360470392001";17;6;101;39;15;178
"2089";"360470392002";108;2;87;17;12;226
"2090";"360470393001";168;38;104;21;46;377
"2091";"360470393002";84;43;105;25;76;333
"2092";"360470393003";127;116;90;7;96;436
"2093";"360470394001";34;14;67;3;8;126
"2094";"360470394002";3;4;75;10;11;103
"2095";"360470394003";2;5;62;22;11;102
"2096";"360470395001";88;35;79;12;31;245
"2097";"360470395002";167;29;53;12;44;305
"2098";"360470395003";72;105;71;8;35;291
"2099";"360470396001";10;5;94;30;11;150
"2100";"360470396002";8;6;56;15;17;102
"2101";"360470397001";116;31;99;2;26;274
"2102";"360470397002";53;308;92;9;41;503
"2103";"360470397003";121;75;88;9;36;329
"2104";"360470398001";18;29;193;98;91;429
"2105";"360470398002";21;10;51;59;34;175
"2106";"360470399001";186;21;195;14;41;457
"2107";"360470399002";187;36;60;22;45;350
"2108";"360470399003";67;17;33;3;23;143
"2109";"360470400001";25;6;78;53;48;210
"2110";"360470400002";7;3;65;2;21;98
"2111";"360470400003";12;12;85;7;35;151
"2112";"360470401001";46;11;36;7;14;114
"2113";"360470401002";185;43;42;10;21;301
"2114";"360470401003";111;19;160;11;38;339
"2115";"360470402001";23;20;184;44;24;295
"2116";"360470402002";19;15;222;37;38;331
"2117";"360470403001";94;23;76;51;39;283
"2118";"360470403002";83;18;77;14;37;229
"2119";"360470403003";51;41;42;9;27;170
"2120";"360470404001";4;8;178;11;12;213
"2121";"360470404002";8;11;70;21;22;132
"2122";"360470405001";26;29;209;149;41;454
"2123";"360470405002";30;21;19;11;15;96
"2124";"360470406001";85;16;229;13;22;365
"2125";"360470406002";20;6;77;5;8;116
"2126";"360470406003";93;5;69;10;14;191
"2127";"360470407001";0;1;6;16;0;23
"2128";"360470408001";13;8;58;3;15;97
"2129";"360470408002";18;10;93;6;19;146
"2130";"360470408003";5;10;80;7;17;119
"2131";"360470409001";253;48;79;30;44;454
"2132";"360470409002";113;249;187;101;31;681
"2133";"360470409003";67;36;106;5;20;234
"2134";"360470410001";22;48;292;8;24;394
"2135";"360470410002";4;3;115;23;11;156
"2136";"360470411001";145;72;54;10;21;302
"2137";"360470411002";77;16;72;10;20;195
"2138";"360470411003";40;7;53;2;6;108
"2139";"360470412001";17;29;124;12;56;238
"2140";"360470412002";23;6;682;35;29;775
"2141";"360470413001";109;18;52;18;27;224
"2142";"360470413002";113;53;97;9;26;298
"2143";"360470413003";95;54;107;5;27;288
"2144";"360470414011";12;14;34;11;14;85
"2145";"360470414012";1;2;70;8;10;91
"2146";"360470414021";362;7;30;5;16;420
"2147";"360470414022";42;1;36;10;5;94
"2148";"360470415001";146;40;118;10;35;349
"2149";"360470415002";217;55;141;28;44;485
"2150";"360470415003";194;2;54;6;12;268
"2151";"360470416001";19;6;124;9;11;169
"2152";"360470416002";38;2;84;5;7;136
"2153";"360470417001";15;16;24;1;6;62
"2154";"360470417002";39;17;40;9;3;108
"2155";"360470417003";135;35;73;9;17;269
"2156";"360470417004";80;84;49;17;23;253
"2157";"360470418001";26;63;65;7;11;172
"2158";"360470418002";16;5;65;7;6;99
"2159";"360470419001";220;73;103;17;30;443
"2160";"360470419002";84;26;93;2;12;217
"2161";"360470419003";83;29;34;21;25;192
"2162";"360470420001";11;9;118;6;24;168
"2163";"360470420002";4;9;67;18;10;108
"2164";"360470421001";104;76;37;27;9;253
"2165";"360470421002";102;77;54;6;43;282
"2166";"360470421003";90;102;50;26;49;317
"2167";"360470421004";84;93;142;30;33;382
"2168";"360470422001";76;9;149;4;9;247
"2169";"360470422002";6;15;165;23;34;243
"2170";"360470422003";27;2;61;11;22;123
"2171";"360470423001";109;87;173;39;57;465
"2172";"360470423002";187;166;200;42;40;635
"2173";"360470423003";158;50;33;10;14;265
"2174";"360470424001";21;52;86;19;29;207
"2175";"360470424002";54;11;96;31;24;216
"2176";"360470424003";39;4;148;10;10;211
"2177";"360470425001";61;62;44;3;22;192
"2178";"360470425002";57;24;81;16;44;222
"2179";"360470425003";55;275;45;22;29;426
"2180";"360470426001";25;7;130;10;6;178
"2181";"360470426002";12;7;246;14;20;299
"2182";"360470426003";7;10;71;16;13;117
"2183";"360470427001";269;369;27;7;58;730
"2184";"360470427002";183;116;79;4;40;422
"2185";"360470427003";294;123;71;15;35;538
"2186";"360470427004";85;80;48;7;35;255
"2187";"360470428001";13;5;179;6;19;222
"2188";"360470428002";39;7;164;5;24;239
"2189";"360470428003";12;7;106;4;13;142
"2190";"360470429001";290;334;87;7;46;764
"2191";"360470429002";318;125;17;2;42;504
"2192";"360470429003";144;173;31;4;51;403
"2193";"360470429004";270;161;19;0;45;495
"2194";"360470430001";11;13;58;1;18;101
"2195";"360470430002";27;13;142;32;11;225
"2196";"360470430003";57;20;173;15;29;294
"2197";"360470431001";117;173;149;7;93;539
"2198";"360470431002";151;125;47;12;51;386
"2199";"360470431003";109;88;38;10;47;292
"2200";"360470431004";150;235;29;6;87;507
"2201";"360470432001";30;5;298;12;13;358
"2202";"360470432002";24;21;133;4;55;237
"2203";"360470432003";13;16;104;8;24;165
"2204";"360470433001";38;37;14;7;10;106
"2205";"360470433002";236;212;54;10;64;576
"2206";"360470433003";138;114;28;31;50;361
"2207";"360470434001";45;32;95;29;22;223
"2208";"360470434002";29;4;103;11;19;166
"2209";"360470434003";62;8;103;9;20;202
"2210";"360470435001";126;52;37;7;26;248
"2211";"360470435002";135;90;74;12;48;359
"2212";"360470435003";84;72;44;11;24;235
"2213";"360470436001";25;8;166;12;11;222
"2214";"360470436002";12;26;52;3;28;121
"2215";"360470436003";36;2;141;14;15;208
"2216";"360470437001";88;28;78;3;13;210
"2217";"360470437002";192;137;35;14;55;433
"2218";"360470437003";191;224;52;8;53;528
"2219";"360470437004";373;239;59;3;21;695
"2220";"360470438001";25;8;57;14;16;120
"2221";"360470438002";53;10;182;38;58;341
"2222";"360470439001";76;134;219;18;54;501
"2223";"360470439002";59;24;159;19;33;294
"2224";"360470439003";78;100;378;23;55;634
"2225";"360470440001";28;1;68;5;8;110
"2226";"360470440002";60;17;234;38;12;361
"2227";"360470440003";24;4;190;59;85;362
"2228";"360470441001";201;256;95;8;88;648
"2229";"360470441002";131;97;121;1;42;392
"2230";"360470441003";631;159;56;4;24;874
"2231";"360470442001";71;10;68;32;14;195
"2232";"360470442002";6;5;71;18;4;104
"2233";"360470443001";41;20;19;4;11;95
"2234";"360470443002";156;96;87;7;73;419
"2235";"360470443003";193;52;60;5;43;353
"2236";"360470443004";72;10;37;1;39;159
"2237";"360470444001";7;3;77;11;13;111
"2238";"360470444002";12;3;94;13;18;140
"2239";"360470444003";48;15;75;12;32;182
"2240";"360470445001";125;56;111;4;35;331
"2241";"360470445002";150;134;138;46;26;494
"2242";"360470445003";140;328;84;7;31;590
"2243";"360470446001";7;5;133;30;28;203
"2244";"360470446002";25;15;180;13;8;241
"2245";"360470447001";156;263;89;10;46;564
"2246";"360470447002";47;201;147;15;71;481
"2247";"360470448001";8;48;87;16;25;184
"2248";"360470448002";23;15;96;12;27;173
"2249";"360470449001";29;58;12;18;9;126
"2250";"360470449002";370;234;35;9;5;653
"2251";"360470449003";68;69;252;55;35;479
"2252";"360470449004";9;478;311;221;70;1089
"2253";"360470450001";17;25;126;49;17;234
"2254";"360470452001";8;5;101;15;13;142
"2255";"360470452002";22;1;72;21;21;137
"2256";"360470453001";104;139;219;53;109;624
"2257";"360470453002";142;464;116;21;61;804
"2258";"360470454001";9;97;67;17;29;219
"2259";"360470454002";8;6;60;23;5;102
"2260";"360470456001";16;45;103;15;73;252
"2261";"360470456002";18;10;82;19;17;146
"2262";"360470458001";71;1;110;12;11;205
"2263";"360470458002";2;2;40;22;6;72
"2264";"360470460001";36;11;157;11;14;229
"2265";"360470460002";17;8;89;6;39;159
"2266";"360470460003";12;8;130;26;69;245
"2267";"360470462011";37;6;265;26;17;351
"2268";"360470462012";31;36;468;34;34;603
"2269";"360470462021";7;3;125;22;12;169
"2270";"360470462022";28;14;156;17;45;260
"2271";"360470464001";3;5;66;34;28;136
"2272";"360470464002";17;2;70;10;44;143
"2273";"360470468001";9;231;283;22;32;577
"2274";"360470470001";8;10;86;15;11;130
"2275";"360470470002";2;6;93;12;2;115
"2276";"360470472001";0;1;9;19;0;29
"2277";"360470472002";4;30;66;9;14;123
"2278";"360470472003";4;0;34;11;5;54
"2279";"360470474001";1;7;79;13;8;108
"2280";"360470474002";4;5;41;15;2;67
"2281";"360470476001";7;57;85;48;27;224
"2282";"360470476002";6;5;45;9;0;65
"2283";"360470476003";1;2;108;21;2;134
"2284";"360470477001";170;81;236;45;64;596
"2285";"360470477002";104;148;179;27;59;517
"2286";"360470478001";25;29;136;24;64;278
"2287";"360470478002";4;2;37;13;7;63
"2288";"360470478003";24;13;286;41;55;419
"2289";"360470480001";6;3;98;5;14;126
"2290";"360470480002";22;10;264;65;42;403
"2291";"360470481001";36;23;43;9;23;134
"2292";"360470481002";18;112;77;32;20;259
"2293";"360470481003";123;61;101;12;45;342
"2294";"360470482001";14;10;232;40;35;331
"2295";"360470482002";32;12;124;7;35;210
"2296";"360470482003";64;8;170;23;16;281
"2297";"360470482004";155;13;342;6;80;596
"2298";"360470484001";65;55;196;9;41;366
"2299";"360470484002";32;108;699;13;25;877
"2300";"360470484003";22;8;40;9;7;86
"2301";"360470485001";239;269;407;64;129;1108
"2302";"360470485002";309;460;343;23;68;1203
"2303";"360470486001";17;75;173;4;29;298
"2304";"360470486002";619;23;73;17;52;784
"2305";"360470486003";16;30;124;17;27;214
"2306";"360470488001";56;31;152;4;37;280
"2307";"360470488002";11;7;352;20;13;403
"2308";"360470488003";23;41;165;31;11;271
"2309";"360470489001";172;9;2;0;5;188
"2310";"360470489002";59;5;4;1;8;77
"2311";"360470489003";168;24;5;0;1;198
"2312";"360470490001";128;39;113;14;10;304
"2313";"360470490002";106;29;234;14;24;407
"2314";"360470490003";86;7;152;8;23;276
"2315";"360470491001";12;43;5;0;4;64
"2316";"360470491002";66;187;25;1;89;368
"2317";"360470491003";182;183;35;6;45;451
"2318";"360470491004";27;11;15;4;5;62
"2319";"360470492001";10;13;97;61;12;193
"2320";"360470492002";42;23;129;40;39;273
"2321";"360470492003";18;27;120;49;18;232
"2322";"360470493001";111;39;8;1;6;165
"2323";"360470493002";269;127;27;6;41;470
"2324";"360470493003";86;96;55;20;32;289
"2325";"360470493004";84;37;8;2;15;146
"2326";"360470493005";40;100;15;10;40;205
"2327";"360470494001";91;79;161;39;9;379
"2328";"360470494002";75;11;110;9;17;222
"2329";"360470494003";26;17;58;1;4;106
"2330";"360470494004";5;3;31;1;5;45
"2331";"360470495001";41;36;39;2;30;148
"2332";"360470495002";66;42;55;6;39;208
"2333";"360470495003";50;113;54;23;27;267
"2334";"360470496001";46;31;97;15;49;238
"2335";"360470496002";13;11;88;25;32;169
"2336";"360470496003";47;15;113;42;25;242
"2337";"360470497001";27;24;72;13;16;152
"2338";"360470497002";37;38;102;17;42;236
"2339";"360470497003";56;16;80;10;34;196
"2340";"360470498001";115;30;137;34;22;338
"2341";"360470498002";47;11;146;29;31;264
"2342";"360470498003";18;8;158;51;22;257
"2343";"360470499001";23;21;20;6;28;98
"2344";"360470499002";60;9;90;9;44;212
"2345";"360470500001";9;4;76;12;10;111
"2346";"360470500002";102;17;53;20;38;230
"2347";"360470500003";34;5;68;23;11;141
"2348";"360470501001";65;7;27;13;23;135
"2349";"360470501002";80;27;34;12;27;180
"2350";"360470501003";65;292;104;25;78;564
"2351";"360470502021";9;16;32;7;15;79
"2352";"360470502022";28;33;109;12;53;235
"2353";"360470503001";42;136;90;16;37;321
"2354";"360470503002";127;65;90;24;72;378
"2355";"360470503003";49;50;44;19;31;193
"2356";"360470504001";7;8;24;13;8;60
"2357";"360470504002";64;34;99;19;22;238
"2358";"360470504003";86;33;163;18;47;347
"2359";"360470505001";91;35;8;3;14;151
"2360";"360470505002";122;138;46;5;33;344
"2361";"360470505003";58;160;19;4;31;272
"2362";"360470506001";212;74;40;1;23;350
"2363";"360470506002";83;42;84;7;33;249
"2364";"360470506003";151;36;19;14;20;240
"2365";"360470506004";112;22;30;17;40;221
"2366";"360470507001";26;14;173;39;108;360
"2367";"360470508011";97;41;4;10;13;165
"2368";"360470508012";212;83;27;1;63;386
"2369";"360470508031";241;123;61;14;40;479
"2370";"360470508041";174;82;69;28;12;365
"2371";"360470508042";175;101;85;36;24;421
"2372";"360470508043";204;57;65;4;22;352
"2373";"360470509001";110;526;81;35;28;780
"2374";"360470509002";3;10;24;10;11;58
"2375";"360470510011";112;12;15;51;9;199
"2376";"360470510012";690;224;31;7;36;988
"2377";"360470510021";157;116;56;13;27;369
"2378";"360470510022";152;83;12;1;7;255
"2379";"360470510023";96;53;17;4;8;178
"2380";"360470511001";100;28;20;4;10;162
"2381";"360470511002";184;183;55;14;31;467
"2382";"360470511003";59;185;82;20;45;391
"2383";"360470512001";112;110;52;83;24;381
"2384";"360470512002";166;53;11;29;6;265
"2385";"360470512003";127;50;35;32;7;251
"2386";"360470512004";56;35;49;12;14;166
"2387";"360470513001";61;357;157;17;69;661
"2388";"360470513002";29;46;23;15;18;131
"2389";"360470513003";187;521;178;19;102;1007
"2390";"360470513004";62;163;13;12;15;265
"2391";"360470514001";21;25;132;17;11;206
"2392";"360470514002";172;41;39;18;22;292
"2393";"360470514003";195;69;49;2;39;354
"2394";"360470514004";194;16;47;15;33;305
"2395";"360470515001";87;116;101;15;76;395
"2396";"360470516011";115;31;73;3;17;239
"2397";"360470516012";256;45;66;4;23;394
"2398";"360470516013";273;162;197;10;71;713
"2399";"360470516021";174;148;42;7;12;383
"2400";"360470516022";197;417;88;13;84;799
"2401";"360470517001";104;132;22;3;35;296
"2402";"360470517002";64;309;52;11;80;516
"2403";"360470518001";91;7;102;7;5;212
"2404";"360470518002";45;27;82;22;7;183
"2405";"360470518003";43;20;38;22;7;130
"2406";"360470519001";134;95;100;10;69;408
"2407";"360470519002";90;62;125;19;77;373
"2408";"360470519003";131;242;102;9;71;555
"2409";"360470520001";120;36;105;27;28;316
"2410";"360470520002";59;29;145;14;25;272
"2411";"360470520003";26;9;28;0;10;73
"2412";"360470523001";118;365;38;7;28;556
"2413";"360470523002";88;373;28;4;35;528
"2414";"360470523003";121;85;34;3;25;268
"2415";"360470523004";26;37;17;1;14;95
"2416";"360470523005";47;174;11;0;28;260
"2417";"360470525001";289;115;39;8;50;501
"2418";"360470525002";30;51;36;5;23;145
"2419";"360470526001";37;59;76;41;26;239
"2420";"360470526002";209;25;297;21;49;601
"2421";"360470526003";4;3;85;2;8;102
"2422";"360470527001";71;32;123;8;24;258
"2423";"360470527002";140;68;11;0;12;231
"2424";"360470527003";70;87;42;14;55;268
"2425";"360470527004";34;76;17;2;28;157
"2426";"360470527005";122;189;37;1;14;363
"2427";"360470527006";118;558;52;10;23;761
"2428";"360470527007";18;66;20;2;12;118
"2429";"360470528001";34;13;99;7;5;158
"2430";"360470528002";10;9;191;16;60;286
"2431";"360470529001";0;8;71;21;10;110
"2432";"360470529002";25;29;27;11;14;106
"2433";"360470529003";24;47;46;9;35;161
"2434";"360470530001";55;7;46;17;18;143
"2435";"360470530002";90;9;89;9;22;219
"2436";"360470530003";28;12;175;39;33;287
"2437";"360470531001";31;10;96;13;26;176
"2438";"360470531002";20;13;65;0;5;103
"2439";"360470531003";3;6;8;0;9;26
"2440";"360470531004";0;1;15;2;3;21
"2441";"360470532001";32;18;78;4;23;155
"2442";"360470532002";5;9;107;8;18;147
"2443";"360470533001";0;2;10;4;7;23
"2444";"360470533002";0;0;5;1;4;10
"2445";"360470533003";1;2;44;1;1;49
"2446";"360470533004";15;4;2;0;2;23
"2447";"360470533005";1;15;52;17;3;88
"2448";"360470534001";43;14;97;2;12;168
"2449";"360470534002";25;2;24;4;4;59
"2450";"360470534003";6;13;53;6;9;87
"2451";"360470534004";13;13;41;2;9;78
"2452";"360470535001";7;4;15;6;3;35
"2453";"360470535002";0;2;12;2;2;18
"2454";"360470535003";2;7;35;6;6;56
"2455";"360470535004";3;57;62;9;11;142
"2456";"360470537001";1;1;23;4;0;29
"2457";"360470537002";2;4;63;11;12;92
"2458";"360470538001";45;20;69;4;12;150
"2459";"360470538002";275;7;69;14;17;382
"2460";"360470538003";17;50;157;10;19;253
"2461";"360470539001";1;2;16;6;6;31
"2462";"360470539002";5;3;23;0;2;33
"2463";"360470542001";48;6;134;5;15;208
"2464";"360470542002";63;32;128;18;30;271
"2465";"360470542003";3;4;82;21;6;116
"2466";"360470543001";2;22;66;24;5;119
"2467";"360470543002";67;55;210;86;48;466
"2468";"360470544001";59;4;134;20;7;224
"2469";"360470544002";14;2;277;7;9;309
"2470";"360470544003";3;4;140;4;11;162
"2471";"360470545001";1;1;12;10;1;25
"2472";"360470545002";0;12;5;4;2;23
"2473";"360470545003";78;33;1;3;8;123
"2474";"360470545004";0;0;1;4;0;5
"2475";"360470545005";193;84;17;2;13;309
"2476";"360470545006";102;29;15;0;4;150
"2477";"360470546001";11;22;99;9;3;144
"2478";"360470546002";47;6;314;2;8;377
"2479";"360470546003";23;9;85;19;8;144
"2480";"360470547001";56;61;29;16;14;176
"2481";"360470547002";11;4;137;2;8;162
"2482";"360470547003";34;50;157;6;11;258
"2483";"360470548001";25;9;71;33;5;143
"2484";"360470548002";2;4;80;89;6;181
"2485";"360470549001";60;46;102;6;22;236
"2486";"360470549002";131;443;177;10;50;811
"2487";"360470550001";20;3;122;31;3;179
"2488";"360470550002";33;6;213;114;20;386
"2489";"360470550003";38;7;105;3;18;171
"2490";"360470551001";106;280;142;15;31;574
"2491";"360470551002";62;66;63;6;40;237
"2492";"360470551003";170;366;42;9;37;624
"2493";"360470551004";76;53;8;8;14;159
"2494";"360470552001";26;5;79;2;13;125
"2495";"360470552002";28;33;69;3;13;146
"2496";"360470552003";31;37;114;25;47;254
"2497";"360470553001";120;387;54;20;79;660
"2498";"360470553002";38;123;107;13;40;321
"2499";"360470553003";125;398;124;18;78;743
"2500";"360470554001";29;9;66;16;19;139
"2501";"360470554002";63;9;21;2;20;115
"2502";"360470554003";11;18;90;11;16;146
"2503";"360470555001";575;731;426;38;159;1929
"2504";"360470556001";16;20;107;10;19;172
"2505";"360470556002";8;5;96;2;5;116
"2506";"360470556003";19;8;80;6;27;140
"2507";"360470557001";66;27;82;4;30;209
"2508";"360470557002";108;243;191;41;56;639
"2509";"360470558001";16;2;77;13;19;127
"2510";"360470558002";30;318;156;8;23;535
"2511";"360470560001";5;4;147;54;21;231
"2512";"360470560002";90;6;69;1;13;179
"2513";"360470560003";19;2;42;20;4;87
"2514";"360470561001";92;51;120;30;44;337
"2515";"360470561002";16;5;31;9;29;90
"2516";"360470561003";11;86;77;14;68;256
"2517";"360470561004";37;43;104;11;35;230
"2518";"360470562001";1;1;64;59;7;132
"2519";"360470562002";7;1;126;103;3;240
"2520";"360470563001";122;131;113;14;48;428
"2521";"360470563002";121;440;113;13;52;739
"2522";"360470563003";38;24;129;9;24;224
"2523";"360470563004";45;71;226;11;55;408
"2524";"360470564001";28;1;30;5;12;76
"2525";"360470564002";7;0;60;22;15;104
"2526";"360470564003";7;0;21;26;5;59
"2527";"360470565001";76;250;194;21;85;626
"2528";"360470565002";31;6;44;22;35;138
"2529";"360470565003";68;66;20;8;58;220
"2530";"360470566001";23;7;80;22;32;164
"2531";"360470566002";6;7;47;21;12;93
"2532";"360470568001";1;1;64;30;17;113
"2533";"360470568002";0;1;45;27;3;76
"2534";"360470569001";80;204;20;5;82;391
"2535";"360470569002";31;67;81;7;66;252
"2536";"360470570001";16;6;16;11;7;56
"2537";"360470570002";8;1;10;11;3;33
"2538";"360470570003";0;0;10;10;3;23
"2539";"360470570004";39;15;53;99;25;231
"2540";"360470571001";55;118;49;4;30;256
"2541";"360470571002";20;13;33;2;24;92
"2542";"360470571003";35;14;21;9;51;130
"2543";"360470571004";25;17;33;4;39;118
"2544";"360470572001";327;37;9;30;13;416
"2545";"360470572002";370;32;26;46;22;496
"2546";"360470573001";22;32;84;20;18;176
"2547";"360470573002";31;14;46;7;12;110
"2548";"360470573003";36;10;56;3;23;128
"2549";"360470574001";16;32;75;41;24;188
"2550";"360470574002";10;8;62;25;26;131
"2551";"360470575001";49;22;34;12;33;150
"2552";"360470575002";51;87;39;3;39;219
"2553";"360470575003";29;12;68;22;41;172
"2554";"360470575004";59;42;71;5;37;214
"2555";"360470576001";32;6;68;23;46;175
"2556";"360470576002";12;14;117;26;25;194
"2557";"360470578001";53;11;148;23;29;264
"2558";"360470578002";62;15;91;9;64;241
"2559";"360470579001";63;48;65;0;18;194
"2560";"360470579002";19;23;312;47;44;445
"2561";"360470580001";85;10;74;10;38;217
"2562";"360470580002";27;8;103;6;17;161
"2563";"360470582001";10;5;86;4;12;117
"2564";"360470582002";3;20;70;6;8;107
"2565";"360470582003";72;4;83;8;39;206
"2566";"360470584001";64;4;91;7;7;173
"2567";"360470584002";76;10;175;21;30;312
"2568";"360470586001";118;5;66;16;16;221
"2569";"360470586002";7;3;109;12;11;142
"2570";"360470588001";66;3;186;31;32;318
"2571";"360470588002";39;32;29;4;12;116
"2572";"360470589001";21;6;76;20;31;154
"2573";"360470589002";39;60;57;5;16;177
"2574";"360470590001";20;89;295;24;41;469
"2575";"360470591001";35;4;26;2;28;95
"2576";"360470591002";26;62;31;13;21;153
"2577";"360470591003";25;30;99;12;26;192
"2578";"360470591004";29;68;34;4;41;176
"2579";"360470592001";43;1;101;5;18;168
"2580";"360470592002";55;15;201;46;17;334
"2581";"360470592003";38;9;55;6;20;128
"2582";"360470593001";36;8;93;14;15;166
"2583";"360470593002";92;23;33;12;25;185
"2584";"360470594011";0;1;36;27;40;104
"2585";"360470594012";11;1;140;52;25;229
"2586";"360470594013";9;18;124;102;25;278
"2587";"360470594014";16;16;93;72;29;226
"2588";"360470594015";42;1;62;12;33;150
"2589";"360470594016";207;1;98;31;13;350
"2590";"360470594021";13;34;40;20;40;147
"2591";"360470594022";50;8;200;89;9;356
"2592";"360470594023";3;2;176;39;6;226
"2593";"360470594024";10;0;99;28;6;143
"2594";"360470596001";21;13;24;18;3;79
"2595";"360470596002";2;1;8;4;2;17
"2596";"360470596003";17;12;201;60;21;311
"2597";"360470598001";48;8;75;61;12;204
"2598";"360470598002";33;3;92;34;20;182
"2599";"360470600001";6;6;87;23;26;148
"2600";"360470600002";6;1;220;79;22;328
"2601";"360470600003";13;4;261;333;30;641
"2602";"360470600004";3;3;108;20;27;161
"2603";"360470600005";65;6;73;11;27;182
"2604";"360470606001";104;19;41;3;68;235
"2605";"360470606002";33;1;78;18;23;153
"2606";"360470608001";59;37;107;30;41;274
"2607";"360470608002";55;6;100;55;28;244
"2608";"360470608003";240;70;106;15;28;459
"2609";"360470610021";50;10;129;5;8;202
"2610";"360470610022";107;27;28;1;17;180
"2611";"360470610031";10;7;43;1;24;85
"2612";"360470610032";56;21;76;5;77;235
"2613";"360470610041";33;10;62;6;48;159
"2614";"360470610042";47;2;346;1;18;414
"2615";"360470610043";46;5;171;4;18;244
"2616";"360470610044";205;21;38;1;3;268
"2617";"360470610045";57;4;31;1;17;110
"2618";"360470612001";16;34;97;6;28;181
"2619";"360470616001";39;26;143;10;31;249
"2620";"360470620001";14;30;53;6;18;121
"2621";"360470620002";6;19;43;8;13;89
"2622";"360470622001";83;6;156;50;32;327
"2623";"360470622002";97;34;224;95;69;519
"2624";"360470626001";28;3;103;18;13;165
"2625";"360470626002";11;24;96;104;26;261
"2626";"360470628001";16;12;74;106;44;252
"2627";"360470628002";16;15;168;66;56;321
"2628";"360470628003";19;2;67;40;21;149
"2629";"360470628004";34;8;91;62;25;220
"2630";"360470632001";50;5;54;16;12;137
"2631";"360470632002";4;2;35;7;7;55
"2632";"360470636001";35;4;145;60;16;260
"2633";"360470638001";3;2;48;16;5;74
"2634";"360470638002";1;3;54;25;10;93
"2635";"360470640001";23;7;64;33;3;130
"2636";"360470640002";10;8;87;42;12;159
"2637";"360470642001";39;15;87;58;31;230
"2638";"360470642002";19;0;67;35;14;135
"2639";"360470644001";17;10;114;37;21;199
"2640";"360470644002";17;7;67;76;30;197
"2641";"360470646001";3;6;49;27;15;100
"2642";"360470646002";13;11;188;87;30;329
"2643";"360470648001";63;11;233;193;38;538
"2644";"360470648002";5;4;63;60;15;147
"2645";"360470650001";5;6;57;30;32;130
"2646";"360470650002";34;3;120;117;21;295
"2647";"360470652001";15;278;123;83;41;540
"2648";"360470654001";2;3;93;22;3;123
"2649";"360470654002";35;3;42;25;13;118
"2650";"360470656001";5;33;71;36;19;164
"2651";"360470656002";1;2;41;15;2;61
"2652";"360470658001";13;9;48;8;26;104
"2653";"360470658002";4;10;114;37;23;188
"2654";"360470660001";11;2;68;21;5;107
"2655";"360470660002";9;6;45;24;9;93
"2656";"360470662001";7;24;157;93;40;321
"2657";"360470666001";21;68;74;47;17;227
"2658";"360470670001";15;6;105;80;8;214
"2659";"360470670002";86;11;208;160;38;503
"2660";"360470672001";84;29;193;328;45;679
"2661";"360470674001";9;17;51;123;12;212
"2662";"360470674002";45;11;154;153;11;374
"2663";"360470676001";17;6;82;92;4;201
"2664";"360470676002";13;18;107;113;20;271
"2665";"360470678001";35;2;159;140;21;357
"2666";"360470678002";48;9;122;223;12;414
"2667";"360470680001";52;8;103;117;12;292
"2668";"360470680002";64;106;169;96;22;457
"2669";"360470682001";53;62;89;153;15;372
"2670";"360470682002";61;7;72;137;12;289
"2671";"360470686001";12;2;76;54;23;167
"2672";"360470686002";6;3;77;48;6;140
"2673";"360470688001";21;1;85;85;19;211
"2674";"360470688002";8;5;32;30;11;86
"2675";"360470690001";26;10;128;87;16;267
"2676";"360470690002";67;23;145;165;22;422
"2677";"360470692001";56;20;197;379;23;675
"2678";"360470692002";18;2;231;211;4;466
"2679";"360470696011";152;17;262;97;20;548
"2680";"360470696012";49;14;287;147;68;565
"2681";"360470696021";10;17;140;64;34;265
"2682";"360470696022";86;17;149;305;38;595
"2683";"360470696023";77;15;210;79;39;420
"2684";"360470698001";18;1;28;14;16;77
"2685";"360470698002";47;40;188;175;38;488
"2686";"360470700001";9;5;21;14;4;53
"2687";"360470700002";22;3;200;121;24;370
"2688";"360470702011";5;10;51;72;11;149
"2689";"360470702012";7;3;14;44;5;73
"2690";"360470702013";30;2;62;49;4;147
"2691";"360470702014";10;2;248;85;21;366
"2692";"360470702015";41;6;201;83;47;378
"2693";"360470702021";0;5;9;1;4;19
"2694";"360470706001";18;24;263;83;72;460
"2695";"360470706002";13;55;124;37;51;280
"2696";"360470720001";45;10;166;342;37;600
"2697";"360470722001";38;33;169;135;30;405
"2698";"360470722002";60;12;119;244;31;466
"2699";"360470724001";15;4;63;16;10;108
"2700";"360470724002";23;7;114;162;21;327
"2701";"360470726001";30;16;217;210;53;526
"2702";"360470728001";123;20;139;26;16;324
"2703";"360470728002";23;10;70;100;20;223
"2704";"360470730001";40;23;111;61;26;261
"2705";"360470730002";24;7;54;58;22;165
"2706";"360470732001";57;5;103;31;14;210
"2707";"360470732002";63;7;94;38;14;216
"2708";"360470734001";13;4;47;28;13;105
"2709";"360470734002";12;12;124;35;6;189
"2710";"360470736001";145;7;19;59;5;235
"2711";"360470736002";19;5;45;30;14;113
"2712";"360470736003";33;9;77;44;33;196
"2713";"360470738001";51;14;216;58;24;363
"2714";"360470738002";93;2;319;31;7;452
"2715";"360470738003";52;22;550;55;9;688
"2716";"360470740001";89;33;239;63;25;449
"2717";"360470740002";132;31;174;44;46;427
"2718";"360470742001";37;10;295;23;27;392
"2719";"360470742002";93;10;105;20;18;246
"2720";"360470744001";16;12;137;20;6;191
"2721";"360470744002";3;14;105;14;4;140
"2722";"360470746001";67;10;207;40;20;344
"2723";"360470746002";5;5;135;8;26;179
"2724";"360470748001";16;11;149;20;20;216
"2725";"360470748002";0;0;39;40;5;84
"2726";"360470750001";3;5;101;21;34;164
"2727";"360470750002";222;9;51;27;10;319
"2728";"360470752001";0;3;72;27;6;108
"2729";"360470754001";0;1;39;11;2;53
"2730";"360470754002";1;1;46;13;4;65
"2731";"360470756001";12;5;94;16;35;162
"2732";"360470756002";6;0;49;10;12;77
"2733";"360470758001";9;1;195;22;6;233
"2734";"360470758002";102;4;89;19;13;227
"2735";"360470760001";0;0;61;5;6;72
"2736";"360470760002";30;0;46;4;8;88
"2737";"360470760003";39;5;37;1;15;97
"2738";"360470762001";98;4;30;10;0;142
"2739";"360470762002";25;4;159;7;15;210
"2740";"360470762003";132;12;29;0;5;178
"2741";"360470764001";111;15;148;8;10;292
"2742";"360470764002";40;8;55;4;5;112
"2743";"360470764003";29;41;107;5;7;189
"2744";"360470766001";333;15;194;27;9;578
"2745";"360470768001";16;13;125;27;17;198
"2746";"360470768002";17;5;136;9;17;184
"2747";"360470768003";20;5;161;6;29;221
"2748";"360470770001";51;35;100;23;8;217
"2749";"360470770002";115;50;383;97;63;708
"2750";"360470772001";92;21;248;52;14;427
"2751";"360470772002";129;26;155;60;9;379
"2752";"360470774001";30;9;76;9;33;157
"2753";"360470774002";75;16;80;30;51;252
"2754";"360470776001";29;7;21;14;3;74
"2755";"360470776002";24;5;36;10;4;79
"2756";"360470776003";11;5;120;42;19;197
"2757";"360470780001";30;0;49;19;8;106
"2758";"360470780002";61;4;68;19;8;160
"2759";"360470782001";61;5;67;40;10;183
"2760";"360470782002";317;11;113;9;17;467
"2761";"360470784001";79;4;106;21;21;231
"2762";"360470784002";29;30;108;17;15;199
"2763";"360470786001";82;27;73;12;27;221
"2764";"360470786002";30;13;41;19;47;150
"2765";"360470786003";153;17;161;11;22;364
"2766";"360470788001";61;16;132;22;13;244
"2767";"360470788002";51;7;83;12;17;170
"2768";"360470788003";15;25;84;54;20;198
"2769";"360470790001";148;145;80;29;30;432
"2770";"360470790002";122;79;100;52;37;390
"2771";"360470790003";59;16;61;15;21;172
"2772";"360470790004";31;9;50;63;30;183
"2773";"360470792001";252;132;231;72;25;712
"2774";"360470792002";88;20;63;38;22;231
"2775";"360470792003";80;119;134;99;72;504
"2776";"360470794001";47;83;129;69;63;391
"2777";"360470794002";38;14;74;36;37;199
"2778";"360470796011";86;292;87;7;38;510
"2779";"360470796012";326;34;93;2;28;483
"2780";"360470796021";355;196;113;11;48;723
"2781";"360470796022";195;259;73;21;49;597
"2782";"360470798011";84;122;108;7;15;336
"2783";"360470798012";128;63;166;11;61;429
"2784";"360470798021";125;96;49;5;46;321
"2785";"360470798022";265;363;9;3;55;695
"2786";"360470798023";292;387;30;33;54;796
"2787";"360470800001";257;257;56;3;33;606
"2788";"360470800002";82;58;110;17;45;312
"2789";"360470800003";40;18;62;11;18;149
"2790";"360470802001";284;70;109;38;30;531
"2791";"360470802002";152;105;93;6;31;387
"2792";"360470802003";239;35;72;9;14;369
"2793";"360470804001";95;91;104;13;23;326
"2794";"360470804002";178;74;35;6;8;301
"2795";"360470804003";19;54;116;12;39;240
"2796";"360470806001";91;59;125;16;28;319
"2797";"360470806002";53;12;130;17;39;251
"2798";"360470808001";35;19;71;37;25;187
"2799";"360470810001";154;199;158;18;16;545
"2800";"360470810002";10;24;129;6;3;172
"2801";"360470814001";56;8;93;13;15;185
"2802";"360470814002";156;38;191;22;19;426
"2803";"360470816001";38;5;177;20;29;269
"2804";"360470816002";96;37;108;12;16;269
"2805";"360470818001";302;173;139;5;31;650
"2806";"360470818002";57;8;91;4;15;175
"2807";"360470818003";110;145;135;17;12;419
"2808";"360470820001";221;31;180;6;33;471
"2809";"360470820002";223;61;133;7;21;445
"2810";"360470820003";299;47;113;3;23;485
"2811";"360470822001";79;38;114;3;15;249
"2812";"360470822002";368;248;73;8;18;715
"2813";"360470822003";422;250;157;8;20;857
"2814";"360470822004";91;43;130;6;32;302
"2815";"360470824001";73;17;139;12;19;260
"2816";"360470824002";39;34;48;8;18;147
"2817";"360470824003";53;6;147;62;15;283
"2818";"360470824004";36;34;141;14;33;258
"2819";"360470826001";38;11;98;20;16;183
"2820";"360470826002";34;32;178;48;24;316
"2821";"360470826003";306;174;122;30;38;670
"2822";"360470826004";88;54;85;50;18;295
"2823";"360470828001";82;42;30;11;23;188
"2824";"360470828002";124;77;119;27;35;382
"2825";"360470828003";112;126;228;17;40;523
"2826";"360470830001";133;15;245;32;16;441
"2827";"360470830002";16;4;105;36;20;181
"2828";"360470830003";123;2;45;0;9;179
"2829";"360470830004";100;1;7;1;5;114
"2830";"360470832001";36;6;95;28;18;183
"2831";"360470832002";14;5;83;30;23;155
"2832";"360470834001";37;5;46;18;17;123
"2833";"360470834002";17;2;60;16;11;106
"2834";"360470836001";51;3;79;58;20;211
"2835";"360470836002";20;10;85;48;17;180
"2836";"360470838001";38;23;82;31;8;182
"2837";"360470838002";38;8;88;33;18;185
"2838";"360470840001";86;35;167;113;15;416
"2839";"360470840002";19;8;123;106;18;274
"2840";"360470846001";43;29;90;130;26;318
"2841";"360470846002";81;12;131;96;28;348
"2842";"360470848001";24;1;68;45;14;152
"2843";"360470848002";26;5;77;26;9;143
"2844";"360470850001";18;5;122;164;26;335
"2845";"360470852001";2;10;2;1;1;16
"2846";"360470854001";75;10;72;26;8;191
"2847";"360470854002";36;8;112;41;13;210
"2848";"360470856001";75;42;58;17;19;211
"2849";"360470856002";72;29;49;29;13;192
"2850";"360470856003";78;37;143;15;20;293
"2851";"360470858001";29;15;49;41;12;146
"2852";"360470858002";422;218;100;30;34;804
"2853";"360470860001";77;26;66;8;21;198
"2854";"360470860002";50;26;147;5;38;266
"2855";"360470860003";23;15;33;14;38;123
"2856";"360470862001";58;8;78;8;5;157
"2857";"360470862002";39;15;134;15;31;234
"2858";"360470862003";42;6;41;23;9;121
"2859";"360470864001";121;17;158;98;17;411
"2860";"360470864002";18;12;88;38;18;174
"2861";"360470866001";68;38;210;59;18;393
"2862";"360470866002";60;39;97;20;6;222
"2863";"360470866003";77;17;53;25;18;190
"2864";"360470868001";89;26;83;14;22;234
"2865";"360470868002";77;64;133;42;15;331
"2866";"360470868003";124;46;109;50;36;365
"2867";"360470870001";18;10;73;12;10;123
"2868";"360470870002";31;33;116;15;20;215
"2869";"360470870003";20;5;54;8;9;96
"2870";"360470872001";10;18;60;21;5;114
"2871";"360470872002";25;3;44;13;11;96
"2872";"360470872003";37;9;59;18;18;141
"2873";"360470874011";37;104;216;65;14;436
"2874";"360470874012";69;37;49;17;24;196
"2875";"360470876001";35;90;89;39;10;263
"2876";"360470876002";40;8;67;35;5;155
"2877";"360470878001";43;18;56;24;20;161
"2878";"360470878002";0;1;19;1;16;37
"2879";"360470878003";37;51;78;31;31;228
"2880";"360470880001";39;17;119;41;21;237
"2881";"360470880002";18;17;3;3;0;41
"2882";"360470880003";109;36;70;21;8;244
"2883";"360470882001";196;21;129;7;12;365
"2884";"360470882002";49;19;59;7;42;176
"2885";"360470882003";39;15;48;10;13;125
"2886";"360470882004";40;25;115;30;19;229
"2887";"360470884001";148;34;96;16;25;319
"2888";"360470884002";83;25;94;21;19;242
"2889";"360470884003";85;33;124;14;28;284
"2890";"360470886001";95;5;81;12;9;202
"2891";"360470886002";142;32;96;12;15;297
"2892";"360470886003";106;11;227;47;28;419
"2893";"360470888001";81;19;133;6;33;272
"2894";"360470888002";22;5;104;24;13;168
"2895";"360470888003";29;10;100;66;18;223
"2896";"360470890001";65;13;100;11;10;199
"2897";"360470890002";73;13;54;17;10;167
"2898";"360470890003";36;6;33;16;10;101
"2899";"360470890004";108;8;79;4;20;219
"2900";"360470890005";25;6;58;2;11;102
"2901";"360470890006";39;3;20;0;17;79
"2902";"360470892001";124;14;35;6;17;196
"2903";"360470892002";63;56;52;2;29;202
"2904";"360470892003";125;17;12;3;18;175
"2905";"360470892004";22;2;5;12;12;53
"2906";"360470894001";21;8;19;12;12;72
"2907";"360470894002";44;7;58;9;11;129
"2908";"360470894003";34;8;25;0;15;82
"2909";"360470894004";64;20;70;12;16;182
"2910";"360470896001";26;15;60;22;25;148
"2911";"360470896002";206;31;132;29;30;428
"2912";"360470896003";78;3;66;23;25;195
"2913";"360470898001";29;6;43;31;15;124
"2914";"360470898002";65;11;157;33;26;292
"2915";"360470900001";8;7;30;5;2;52
"2916";"360470900002";9;3;7;4;5;28
"2917";"360470900003";45;18;15;11;16;105
"2918";"360470900004";7;9;69;11;7;103
"2919";"360470900005";42;3;30;14;11;100
"2920";"360470900006";126;67;52;4;23;272
"2921";"360470900007";35;3;6;2;4;50
"2922";"360470902001";63;9;3;8;10;93
"2923";"360470902002";8;0;7;1;1;17
"2924";"360470902003";11;7;43;7;1;69
"2925";"360470902004";40;10;56;24;18;148
"2926";"360470902005";11;4;53;8;8;84
"2927";"360470906001";21;6;6;5;11;49
"2928";"360470906002";73;33;45;56;43;250
"2929";"360470906003";98;4;7;4;7;120
"2930";"360470908001";106;41;155;96;50;448
"2931";"360470908002";21;2;4;2;6;35
"2932";"360470908003";47;7;12;1;20;87
"2933";"360470910001";59;37;3;0;6;105
"2934";"360470910002";228;49;4;1;2;284
"2935";"360470910003";57;2;3;0;1;63
"2936";"360470910004";7;8;55;4;8;82
"2937";"360470912001";132;10;8;5;9;164
"2938";"360470912002";106;16;2;2;3;129
"2939";"360470912003";189;6;5;1;6;207
"2940";"360470916001";22;7;20;4;16;69
"2941";"360470916002";65;17;43;15;14;154
"2942";"360470916003";14;5;38;13;20;90
"2943";"360470916004";90;25;71;22;14;222
"2944";"360470918001";55;9;25;10;17;116
"2945";"360470918002";30;2;86;12;10;140
"2946";"360470920001";10;18;17;16;4;65
"2947";"360470920002";282;34;48;13;15;392
"2948";"360470920003";17;10;94;65;66;252
"2949";"360470922001";79;15;76;31;13;214
"2950";"360470922002";20;6;83;63;7;179
"2951";"360470924001";46;26;59;10;44;185
"2952";"360470924002";24;16;84;22;27;173
"2953";"360470924003";18;3;26;19;6;72
"2954";"360470928001";44;12;129;26;9;220
"2955";"360470928002";43;4;148;208;21;424
"2956";"360470930001";15;4;96;17;10;142
"2957";"360470930002";35;5;156;97;16;309
"2958";"360470932001";48;8;234;235;26;551
"2959";"360470934001";24;11;89;31;17;172
"2960";"360470934002";21;19;54;63;20;177
"2961";"360470936001";51;2;38;19;10;120
"2962";"360470936002";107;9;34;24;9;183
"2963";"360470938001";51;5;47;14;15;132
"2964";"360470938002";18;0;84;38;15;155
"2965";"360470944011";20;5;23;129;1;178
"2966";"360470944012";23;21;91;108;16;259
"2967";"360470944013";73;36;103;95;11;318
"2968";"360470944014";15;25;36;26;8;110
"2969";"360470944021";153;52;22;5;14;246
"2970";"360470946001";10;2;54;21;10;97
"2971";"360470946002";2;3;38;11;6;60
"2972";"360470946003";24;6;102;194;8;334
"2973";"360470950001";127;31;142;18;17;335
"2974";"360470950002";20;4;106;72;11;213
"2975";"360470954001";11;11;84;35;12;153
"2976";"360470954002";45;6;71;21;16;159
"2977";"360470954003";62;22;111;24;11;230
"2978";"360470956001";51;6;86;45;13;201
"2979";"360470956002";103;6;269;33;19;430
"2980";"360470958001";51;14;72;69;15;221
"2981";"360470958002";66;6;410;77;50;609
"2982";"360470960001";14;37;139;261;9;460
"2983";"360470962001";69;19;143;85;17;333
"2984";"360470964001";64;9;103;140;26;342
"2985";"360470964002";85;33;188;113;18;437
"2986";"360470966001";36;5;112;39;25;217
"2987";"360470966002";60;3;96;22;13;194
"2988";"360470968001";57;131;100;28;25;341
"2989";"360470968002";28;0;105;36;18;187
"2990";"360470970001";57;3;104;34;11;209
"2991";"360470970002";51;1;147;68;5;272
"2992";"360470974001";88;6;108;41;28;271
"2993";"360470974002";93;41;192;35;24;385
"2994";"360470982001";191;22;14;32;9;268
"2995";"360470982002";120;34;5;15;13;187
"2996";"360470984001";46;6;133;56;28;269
"2997";"360470986001";46;8;75;16;39;184
"2998";"360470986002";105;4;84;19;14;226
"2999";"360470988001";88;7;59;8;20;182
"3000";"360470988002";37;3;57;5;10;112
"3001";"360470990001";74;48;149;57;17;345
"3002";"360470992001";55;43;271;125;25;519
"3003";"360470994001";82;22;196;110;26;436
"3004";"360470996001";65;6;248;38;15;372
"3005";"360470996002";39;8;140;50;25;262
"3006";"360470998001";87;7;262;33;18;407
"3007";"360470998002";62;20;239;20;17;358
"3008";"360471004001";40;1;169;50;11;271
"3009";"360471006001";22;5;152;33;35;247
"3010";"360471006002";40;3;111;78;12;244
"3011";"360471008001";35;26;90;67;3;221
"3012";"360471008002";15;2;130;85;9;241
"3013";"360471010001";64;33;81;22;11;211
"3014";"360471010002";32;5;136;80;16;269
"3015";"360471012001";11;4;113;36;11;175
"3016";"360471012002";22;9;108;51;14;204
"3017";"360471014001";59;4;52;32;18;165
"3018";"360471014002";34;9;15;17;4;79
"3019";"360471016001";58;3;68;69;7;205
"3020";"360471018001";55;6;26;22;8;117
"3021";"360471020001";59;11;118;82;20;290
"3022";"360471022001";76;9;208;116;37;446
"3023";"360471024001";42;8;182;111;19;362
"3024";"360471026001";129;19;322;79;33;582
"3025";"360471028001";30;19;133;47;21;250
"3026";"360471028002";7;7;80;26;11;131
"3027";"360471034001";396;46;58;34;14;548
"3028";"360471058011";2;0;2;2;6;12
"3029";"360471058012";15;2;34;14;1;66
"3030";"360471058013";12;3;13;4;8;40
"3031";"360471058041";6;0;82;4;0;92
"3032";"360471058042";12;0;7;6;1;26
"3033";"360471058043";8;2;15;8;4;37
"3034";"360471058044";28;1;55;11;6;101
"3035";"360471070001";92;33;107;157;11;400
"3036";"360471078001";14;11;99;19;18;161
"3037";"360471078002";10;37;28;32;8;115
"3038";"360471078003";10;6;48;11;9;84
"3039";"360471078004";18;3;8;21;9;59
"3040";"360471098001";183;16;153;77;23;452
"3041";"360471098002";22;13;186;199;35;455
"3042";"360471104001";22;12;241;142;30;447
"3043";"360471104002";69;8;83;109;30;299
"3044";"360471104003";50;6;54;19;8;137
"3045";"360471104004";15;2;64;46;16;143
"3046";"360471106001";208;6;3;3;4;224
"3047";"360471106002";105;2;3;10;10;130
"3048";"360471110001";263;53;16;16;48;396
"3049";"360471110002";199;11;2;5;5;222
"3050";"360471116001";47;16;112;18;12;205
"3051";"360471116002";31;23;136;69;68;327
"3052";"360471118001";102;10;54;80;27;273
"3053";"360471118002";96;21;115;50;52;334
"3054";"360471120001";25;22;36;23;24;130
"3055";"360471120002";39;21;96;43;44;243
"3056";"360471122001";100;30;153;39;38;360
"3057";"360471122002";34;17;124;17;30;222
"3058";"360471124001";28;6;46;31;21;132
"3059";"360471124002";43;11;30;36;45;165
"3060";"360471124003";38;4;53;17;27;139
"3061";"360471126001";66;3;17;27;14;127
"3062";"360471126002";26;4;33;10;17;90
"3063";"360471126003";33;10;92;16;111;262
"3064";"360471128001";45;4;106;27;44;226
"3065";"360471128002";69;10;27;12;44;162
"3066";"360471128003";142;27;96;43;26;334
"3067";"360471130001";10;1;16;5;2;34
"3068";"360471130002";63;11;50;3;8;135
"3069";"360471130003";127;4;38;8;26;203
"3070";"360471130004";18;6;90;57;20;191
"3071";"360471132001";23;8;91;11;21;154
"3072";"360471132002";20;8;115;75;14;232
"3073";"360471134001";29;6;42;7;7;91
"3074";"360471134002";56;24;10;0;4;94
"3075";"360471134003";40;8;9;5;22;84
"3076";"360471142011";35;3;216;87;22;363
"3077";"360471142012";14;16;314;168;30;542
"3078";"360471142021";95;21;412;70;36;634
"3079";"360471142022";110;5;50;19;15;199
"3080";"360471144001";33;6;154;78;75;346
"3081";"360471144002";41;9;30;33;20;133
"3082";"360471144003";9;6;27;35;24;101
"3083";"360471144004";29;4;26;7;3;69
"3084";"360471146001";176;124;185;55;43;583
"3085";"360471146002";43;208;205;101;45;602
"3086";"360471150001";85;13;81;30;42;251
"3087";"360471150002";39;9;101;47;12;208
"3088";"360471150003";30;9;93;28;35;195
"3089";"360471152001";26;6;128;172;29;361
"3090";"360471152002";100;13;102;40;22;277
"3091";"360471152003";153;23;54;14;41;285
"3092";"360471156001";35;5;83;9;18;150
"3093";"360471156002";220;13;15;2;5;255
"3094";"360471156003";81;9;3;10;3;106
"3095";"360471156004";19;6;22;14;11;72
"3096";"360471158001";36;6;58;10;22;132
"3097";"360471158002";49;16;22;7;16;110
"3098";"360471158003";59;14;20;4;47;144
"3099";"360471160001";17;12;21;12;12;74
"3100";"360471160002";47;10;16;12;8;93
"3101";"360471160003";158;24;37;35;10;264
"3102";"360471162001";38;5;18;15;36;112
"3103";"360471162002";12;3;33;24;12;84
"3104";"360471162003";9;1;99;18;5;132
"3105";"360471164001";20;10;60;32;15;137
"3106";"360471164002";7;3;57;11;7;85
"3107";"360471164003";23;4;52;12;14;105
"3108";"360471166001";41;6;56;14;38;155
"3109";"360471166002";67;10;76;27;16;196
"3110";"360471166003";43;16;65;36;36;196
"3111";"360471168001";59;54;118;77;35;343
"3112";"360471168002";27;7;172;57;39;302
"3113";"360471170001";56;125;104;28;25;338
"3114";"360471170002";118;87;91;52;50;398
"3115";"360471172011";118;32;261;63;29;503
"3116";"360471172012";291;42;95;14;29;471
"3117";"360471172021";34;12;171;23;24;264
"3118";"360471172022";186;58;177;33;50;504
"3119";"360471174001";365;297;258;147;59;1126
"3120";"360471174002";49;106;241;62;160;618
"3121";"360471176011";163;50;211;50;156;630
"3122";"360471176012";127;98;123;13;43;404
"3123";"360471176021";102;49;326;72;43;592
"3124";"360471176022";266;69;223;31;112;701
"3125";"360471178001";81;33;159;83;74;430
"3126";"360471180001";9;59;80;63;26;237
"3127";"360471182011";86;41;347;24;43;541
"3128";"360471182012";81;30;166;22;48;347
"3129";"360471182021";124;82;168;21;33;428
"3130";"360471182022";77;92;186;37;67;459
"3131";"360471184001";123;86;173;44;34;460
"3132";"360471184002";66;93;129;97;69;454
"3133";"360471184003";89;32;84;29;42;276
"3134";"360471186001";41;11;371;38;20;481
"3135";"360471186002";38;27;129;66;37;297
"3136";"360471188001";394;217;156;7;49;823
"3137";"360471188002";73;34;31;18;60;216
"3138";"360471188003";36;11;56;11;50;164
"3139";"360471190001";89;20;209;59;25;402
"3140";"360471190002";36;7;103;17;68;231
"3141";"360471192001";191;59;221;67;43;581
"3142";"360471192002";60;41;78;20;47;246
"3143";"360471192003";67;23;201;71;19;381
"3144";"360471194001";51;10;64;17;35;177
"3145";"360471194002";72;16;190;23;24;325
"3146";"360471194003";113;11;147;39;38;348
"3147";"360471196001";56;23;150;46;26;301
"3148";"360471196002";21;6;94;28;53;202
"3149";"360471196003";57;9;140;20;50;276
"3150";"360471196004";57;10;157;27;32;283
"3151";"360471198001";25;16;125;44;36;246
"3152";"360471198002";29;30;126;61;36;282
"3153";"360471198003";26;20;196;160;95;497
"3154";"360471200001";16;3;68;35;25;147
"3155";"360471200002";70;9;168;11;17;275
"3156";"360471202001";40;23;42;25;33;163
"3157";"360471202002";37;59;28;11;29;164
"3158";"360471208001";44;4;121;27;23;219
"3159";"360471208002";127;32;324;120;51;654
"3160";"360471208003";28;6;7;7;3;51
"3161";"360471208004";12;0;3;8;3;26
"3162";"360471208005";50;13;112;90;25;290
"3163";"360471210001";154;2;2;0;2;160
"3164";"360471210002";44;1;0;1;0;46
"3165";"360471214001";40;6;9;5;4;64
"3166";"360471214002";130;8;8;6;5;157
"3167";"360471220001";163;53;208;277;41;742
"3168";"360471220002";260;41;254;156;55;766
"3169";"360471237001";35;46;245;54;29;409
"3170";"360471237002";26;11;132;20;23;212
"3171";"360471237003";39;38;286;20;48;431
"3172";"360471502001";11;8;75;12;9;115
"3173";"360471502002";11;10;42;8;11;82
"3174";"360471502003";19;16;76;45;29;185
"3175";"360471522001";42;62;154;107;33;398
"3176";"360471522002";25;21;346;47;55;494
"3177";"360471522003";34;25;198;45;23;325
"3178";"360594043002";2;1;1;0;2;6
"3179";"360594043003";3;0;1;0;1;5
"3180";"360594103004";10;0;1;0;0;11
"3181";"360594103005";0;0;1;0;0;1
"3182";"360610001001";0;0;1;0;2;3
"3183";"360610002011";133;10;10;6;8;167
"3184";"360610002012";89;47;26;6;13;181
"3185";"360610002020";0;0;0;1;0;1
"3186";"360610002021";60;33;17;1;28;139
"3187";"360610002022";52;21;31;5;36;145
"3188";"360610002023";372;82;6;2;15;477
"3189";"360610002024";208;31;9;1;9;258
"3190";"360610002025";36;55;25;9;16;141
"3191";"360610005001";0;3;0;0;0;3
"3192";"360610006001";30;148;78;5;73;334
"3193";"360610006002";151;69;103;7;13;343
"3194";"360610006003";53;74;38;18;57;240
"3195";"360610006004";30;21;15;0;35;101
"3196";"360610006005";49;35;35;4;1;124
"3197";"360610006006";17;49;126;3;2;197
"3198";"360610007001";180;620;200;10;442;1452
"3199";"360610008001";26;21;42;9;45;143
"3200";"360610008002";56;11;31;4;35;137
"3201";"360610008003";42;18;25;6;45;136
"3202";"360610008004";9;15;3;0;20;47
"3203";"360610008005";9;21;15;0;24;69
"3204";"360610008006";39;168;298;4;96;605
"3205";"360610009001";64;301;309;8;314;996
"3206";"360610010011";32;9;20;8;7;76
"3207";"360610010020";0;1;0;0;0;1
"3208";"360610010021";90;2;3;0;7;102
"3209";"360610010022";7;1;6;0;1;15
"3210";"360610010023";176;9;46;3;16;250
"3211";"360610012001";169;44;21;9;28;271
"3212";"360610012002";30;9;10;4;15;68
"3213";"360610012003";57;18;23;1;7;106
"3214";"360610013001";12;71;297;9;176;565
"3215";"360610013002";81;139;157;14;352;743
"3216";"360610014011";9;127;58;0;26;220
"3217";"360610014012";8;36;22;2;16;84
"3218";"360610014021";171;204;42;5;73;495
"3219";"360610014022";116;245;32;1;109;503
"3220";"360610015010";0;0;0;0;1;1
"3221";"360610015011";39;269;319;8;176;811
"3222";"360610015012";17;19;218;6;37;297
"3223";"360610015013";45;63;67;6;49;230
"3224";"360610015020";0;1;0;0;0;1
"3225";"360610015021";122;247;346;3;467;1185
"3226";"360610015022";46;225;136;6;112;525
"3227";"360610015023";0;1;0;0;0;1
"3228";"360610016001";41;94;152;7;76;370
"3229";"360610016002";22;24;4;7;44;101
"3230";"360610016003";26;237;159;2;120;544
"3231";"360610016004";199;134;9;4;161;507
"3232";"360610016005";90;808;303;15;227;1443
"3233";"360610018001";339;110;10;10;80;549
"3234";"360610018002";77;169;16;15;159;436
"3235";"360610018003";123;520;24;8;157;832
"3236";"360610018004";12;47;9;6;31;105
"3237";"360610018005";30;202;49;4;151;436
"3238";"360610018006";35;219;3;3;54;314
"3239";"360610018007";82;527;6;5;89;709
"3240";"360610020001";63;10;6;3;10;92
"3241";"360610020002";123;24;9;2;9;167
"3242";"360610020003";65;25;56;5;2;153
"3243";"360610021001";322;172;201;18;316;1029
"3244";"360610021002";27;123;98;14;129;391
"3245";"360610022011";399;146;27;12;52;636
"3246";"360610022012";107;136;49;2;83;377
"3247";"360610022013";392;18;5;0;15;430
"3248";"360610022014";15;1;3;4;7;30
"3249";"360610022021";428;421;43;16;123;1031
"3250";"360610024000";0;3;0;0;0;3
"3251";"360610024001";482;69;13;4;26;594
"3252";"360610024002";106;36;4;1;7;154
"3253";"360610025001";507;25;32;2;31;597
"3254";"360610025002";54;6;13;2;16;91
"3255";"360610025003";82;8;8;0;10;108
"3256";"360610026011";266;208;34;21;73;602
"3257";"360610026012";188;221;55;26;104;594
"3258";"360610026021";173;98;122;48;63;504
"3259";"360610026022";346;308;57;18;95;824
"3260";"360610027001";17;47;331;10;31;436
"3261";"360610028001";32;40;7;7;18;104
"3262";"360610028002";68;47;49;11;22;197
"3263";"360610028003";181;464;40;10;94;789
"3264";"360610028004";56;76;60;55;60;307
"3265";"360610029001";14;35;61;5;55;170
"3266";"360610029002";16;19;23;0;26;84
"3267";"360610029003";28;98;19;5;21;171
"3268";"360610029004";2;25;119;7;43;196
"3269";"360610030011";118;350;32;2;85;587
"3270";"360610030012";108;442;14;9;132;705
"3271";"360610030013";170;66;54;7;76;373
"3272";"360610030014";258;159;15;12;75;519
"3273";"360610030021";181;172;27;12;79;471
"3274";"360610030022";220;431;19;18;161;849
"3275";"360610031001";53;309;359;10;236;967
"3276";"360610032001";241;477;75;23;155;971
"3277";"360610032002";97;208;13;3;100;421
"3278";"360610032003";26;219;43;12;96;396
"3279";"360610032004";30;48;12;11;117;218
"3280";"360610032005";86;143;35;10;37;311
"3281";"360610032006";330;244;17;18;112;721
"3282";"360610032007";78;158;16;13;250;515
"3283";"360610033001";95;174;165;20;151;605
"3284";"360610033002";40;55;73;10;45;223
"3285";"360610033003";16;135;125;6;48;330
"3286";"360610034001";207;286;57;4;80;634
"3287";"360610034002";350;473;67;17;85;992
"3288";"360610034003";242;409;103;25;172;951
"3289";"360610034004";269;127;90;11;233;730
"3290";"360610036011";18;94;8;2;19;141
"3291";"360610036012";100;267;21;3;78;469
"3292";"360610036013";57;213;35;2;153;460
"3293";"360610036021";125;202;48;16;158;549
"3294";"360610036022";51;153;36;14;75;329
"3295";"360610037001";17;268;138;6;60;489
"3296";"360610037002";28;33;237;10;66;374
"3297";"360610037003";25;94;95;7;121;342
"3298";"360610038001";205;525;35;17;505;1287
"3299";"360610038002";26;18;13;2;69;128
"3300";"360610038003";92;115;48;11;86;352
"3301";"360610038004";105;195;5;13;47;365
"3302";"360610038005";91;58;11;10;55;225
"3303";"360610038006";100;49;12;7;50;218
"3304";"360610038007";162;120;23;8;152;465
"3305";"360610039001";52;1572;88;4;47;1763
"3306";"360610039002";41;34;21;0;24;120
"3307";"360610039003";3;2;5;1;3;14
"3308";"360610039004";43;76;74;13;78;284
"3309";"360610040001";174;111;14;11;142;452
"3310";"360610040002";53;20;11;13;22;119
"3311";"360610040003";46;102;15;10;133;306
"3312";"360610040004";137;53;2;5;31;228
"3313";"360610040005";150;125;17;11;102;405
"3314";"360610040006";136;176;30;8;148;498
"3315";"360610041001";57;54;18;6;62;197
"3316";"360610041002";45;192;13;1;62;313
"3317";"360610041003";56;44;21;0;31;152
"3318";"360610041004";75;128;7;4;20;234
"3319";"360610041005";27;54;51;6;76;214
"3320";"360610041006";63;139;12;2;99;315
"3321";"360610042001";59;149;60;11;213;492
"3322";"360610042002";70;77;27;11;119;304
"3323";"360610043001";97;207;62;14;150;530
"3324";"360610043002";33;155;7;2;110;307
"3325";"360610043003";97;187;104;23;191;602
"3326";"360610044001";32;106;38;1;13;190
"3327";"360610044002";28;4;29;1;3;65
"3328";"360610044003";1;2;6;0;6;15
"3329";"360610044004";23;3;8;4;52;90
"3330";"360610044005";10;2;24;2;4;42
"3331";"360610044006";20;2;2;1;6;31
"3332";"360610044007";16;6;35;0;64;121
"3333";"360610044008";11;2;9;1;16;39
"3334";"360610045001";111;247;75;5;370;808
"3335";"360610047001";108;169;68;0;32;377
"3336";"360610047002";150;295;53;11;182;691
"3337";"360610048001";6;7;14;1;31;59
"3338";"360610048002";20;9;9;3;18;59
"3339";"360610048003";4;25;9;1;27;66
"3340";"360610048004";82;114;33;2;106;337
"3341";"360610048005";101;41;43;4;50;239
"3342";"360610048006";106;29;21;5;27;188
"3343";"360610048007";1;6;4;2;18;31
"3344";"360610049001";161;515;66;2;226;970
"3345";"360610049002";94;160;11;12;111;388
"3346";"360610049003";106;171;13;6;51;347
"3347";"360610050001";13;57;33;1;26;130
"3348";"360610050002";37;72;22;3;74;208
"3349";"360610050003";11;43;53;3;474;584
"3350";"360610050004";14;41;14;2;452;523
"3351";"360610050005";64;151;10;2;84;311
"3352";"360610052001";47;173;43;5;382;650
"3353";"360610052002";70;392;92;9;452;1015
"3354";"360610054001";64;196;46;22;256;584
"3355";"360610054002";25;12;38;2;45;122
"3356";"360610054003";20;30;9;3;111;173
"3357";"360610055011";38;236;32;5;160;471
"3358";"360610055012";7;13;15;0;135;170
"3359";"360610055013";10;17;18;2;114;161
"3360";"360610055021";55;169;11;5;53;293
"3361";"360610055022";72;175;153;15;290;705
"3362";"360610056001";80;90;39;5;208;422
"3363";"360610056002";21;135;29;0;269;454
"3364";"360610056003";30;45;5;1;44;125
"3365";"360610057001";19;65;14;4;90;192
"3366";"360610057002";43;161;29;5;401;639
"3367";"360610058001";83;325;85;7;526;1026
"3368";"360610059001";25;14;3;0;97;139
"3369";"360610059002";16;184;6;1;25;232
"3370";"360610059003";86;87;6;5;142;326
"3371";"360610059004";6;8;3;0;39;56
"3372";"360610059005";13;33;4;1;32;83
"3373";"360610060001";171;2;10;1;14;198
"3374";"360610060002";3;18;9;0;28;58
"3375";"360610060003";1;1;1;2;3;8
"3376";"360610061001";53;153;42;8;166;422
"3377";"360610061002";34;23;16;4;72;149
"3378";"360610061003";36;201;99;18;328;682
"3379";"360610062001";8;31;66;7;92;204
"3380";"360610062002";11;6;31;5;9;62
"3381";"360610063001";28;44;24;4;242;342
"3382";"360610063002";39;42;33;3;55;172
"3383";"360610063003";43;70;45;7;51;216
"3384";"360610063004";14;33;2;1;34;84
"3385";"360610063005";15;55;10;2;40;122
"3386";"360610064001";29;41;29;11;59;169
"3387";"360610064002";389;24;14;1;23;451
"3388";"360610064003";8;26;18;1;28;81
"3389";"360610064004";55;27;47;3;65;197
"3390";"360610064005";39;31;23;0;42;135
"3391";"360610064006";7;9;19;2;33;70
"3392";"360610065001";56;178;18;7;184;443
"3393";"360610065002";94;221;22;2;89;428
"3394";"360610065003";44;142;9;5;201;401
"3395";"360610065004";118;272;9;4;169;572
"3396";"360610065005";76;200;29;1;59;365
"3397";"360610066001";100;97;16;1;58;272
"3398";"360610066002";63;44;10;1;100;218
"3399";"360610066003";66;45;12;1;174;298
"3400";"360610066004";18;8;15;2;46;89
"3401";"360610066005";36;144;8;2;32;222
"3402";"360610066006";3;4;18;0;12;37
"3403";"360610066007";12;4;5;1;12;34
"3404";"360610066008";213;35;36;2;123;409
"3405";"360610066009";14;8;7;1;45;75
"3406";"360610067001";116;162;11;3;95;387
"3407";"360610067002";59;187;58;7;119;430
"3408";"360610067003";52;26;24;12;44;158
"3409";"360610067004";88;43;17;9;50;207
"3410";"360610068001";24;123;49;2;70;268
"3411";"360610068002";14;88;12;0;77;191
"3412";"360610068003";29;69;21;1;29;149
"3413";"360610068004";407;31;18;4;32;492
"3414";"360610068005";25;39;25;1;37;127
"3415";"360610068006";77;97;26;1;50;251
"3416";"360610069001";251;331;99;16;198;895
"3417";"360610070001";103;168;21;3;66;361
"3418";"360610070002";135;184;23;5;277;624
"3419";"360610070003";103;35;40;3;76;257
"3420";"360610070004";12;27;16;0;33;88
"3421";"360610070005";3;2;17;0;11;33
"3422";"360610070006";52;24;12;0;43;131
"3423";"360610071001";6;15;6;0;280;307
"3424";"360610071002";14;24;5;5;106;154
"3425";"360610071003";21;54;13;13;78;179
"3426";"360610071004";78;46;32;16;32;204
"3427";"360610071005";21;136;27;3;86;273
"3428";"360610072001";14;6;10;0;19;49
"3429";"360610072002";73;41;111;2;251;478
"3430";"360610072003";51;82;21;3;185;342
"3431";"360610072004";54;90;18;5;184;351
"3432";"360610072005";20;16;13;1;58;108
"3433";"360610072006";18;12;4;0;44;78
"3434";"360610072007";11;15;9;2;50;87
"3435";"360610073001";56;54;15;17;19;161
"3436";"360610073002";37;78;2;3;26;146
"3437";"360610073003";58;130;27;9;26;250
"3438";"360610073004";173;126;12;6;54;371
"3439";"360610073005";21;12;102;2;8;145
"3440";"360610073006";82;116;34;9;41;282
"3441";"360610074001";29;75;35;1;230;370
"3442";"360610074002";22;63;20;2;114;221
"3443";"360610074003";46;186;54;8;249;543
"3444";"360610075001";31;44;62;3;55;195
"3445";"360610075002";37;34;25;11;21;128
"3446";"360610075003";77;83;13;15;22;210
"3447";"360610076001";37;324;97;3;664;1125
"3448";"360610076002";30;89;106;10;242;477
"3449";"360610077001";117;330;15;12;215;689
"3450";"360610077002";77;46;11;6;21;161
"3451";"360610077003";92;216;29;17;118;472
"3452";"360610077004";55;58;21;7;56;197
"3453";"360610077005";28;18;3;7;31;87
"3454";"360610078001";14;88;8;0;28;138
"3455";"360610078002";45;314;11;3;40;413
"3456";"360610078003";15;71;3;0;15;104
"3457";"360610078004";40;143;19;7;59;268
"3458";"360610078005";36;48;4;0;73;161
"3459";"360610078006";24;73;4;1;20;122
"3460";"360610078007";27;83;10;0;2;122
"3461";"360610079001";36;233;95;1;120;485
"3462";"360610079002";16;26;19;1;8;70
"3463";"360610079003";23;46;54;10;54;187
"3464";"360610079004";9;29;25;2;22;87
"3465";"360610080001";20;208;19;7;114;368
"3466";"360610080002";13;60;44;5;144;266
"3467";"360610080003";45;9;38;15;27;134
"3468";"360610080004";20;33;15;3;17;88
"3469";"360610080005";14;23;39;4;21;101
"3470";"360610081001";39;48;12;4;68;171
"3471";"360610081002";35;42;20;7;57;161
"3472";"360610081003";25;28;34;3;54;144
"3473";"360610081004";35;65;17;21;387;525
"3474";"360610081005";56;15;17;11;34;133
"3475";"360610081006";42;41;9;6;77;175
"3476";"360610082001";31;78;57;2;391;559
"3477";"360610082002";10;38;54;1;177;280
"3478";"360610082003";11;19;18;0;27;75
"3479";"360610083001";40;101;53;10;54;258
"3480";"360610083002";24;60;20;6;60;170
"3481";"360610083003";90;108;77;5;94;374
"3482";"360610084001";0;41;28;0;151;220
"3483";"360610084002";40;215;110;8;446;819
"3484";"360610086010";0;1;0;0;6;7
"3485";"360610086011";9;20;28;6;75;138
"3486";"360610086012";23;19;27;0;57;126
"3487";"360610086021";0;8;13;0;104;125
"3488";"360610086030";1;1;1;0;0;3
"3489";"360610086031";6;10;14;3;6;39
"3490";"360610086032";5;9;17;1;11;43
"3491";"360610086033";2;15;18;2;4;41
"3492";"360610086034";37;7;15;2;18;79
"3493";"360610087001";86;165;45;11;123;430
"3494";"360610087002";54;48;12;11;19;144
"3495";"360610087003";26;24;19;19;28;116
"3496";"360610087004";46;85;15;8;40;194
"3497";"360610087005";40;25;4;5;21;95
"3498";"360610088001";24;56;81;3;94;258
"3499";"360610088002";25;93;10;12;29;169
"3500";"360610088003";5;12;28;4;14;63
"3501";"360610088004";5;31;6;0;17;59
"3502";"360610088005";1;6;21;1;19;48
"3503";"360610088006";4;6;21;0;13;44
"3504";"360610088007";6;2;14;1;12;35
"3505";"360610089001";58;32;11;11;15;127
"3506";"360610089002";34;46;26;17;35;158
"3507";"360610089003";105;45;37;2;47;236
"3508";"360610089004";48;15;19;1;47;130
"3509";"360610089005";31;12;9;6;25;83
"3510";"360610090001";124;39;419;1;93;676
"3511";"360610090002";46;10;54;0;13;123
"3512";"360610090003";3;186;326;1;35;551
"3513";"360610090004";26;37;21;4;24;112
"3514";"360610090005";21;22;6;0;58;107
"3515";"360610090006";11;14;5;1;24;55
"3516";"360610091001";84;123;40;11;284;542
"3517";"360610091002";78;64;14;7;116;279
"3518";"360610091003";38;12;9;3;150;212
"3519";"360610091004";38;54;11;5;176;284
"3520";"360610092001";40;67;105;4;770;986
"3521";"360610093001";6;14;23;8;30;81
"3522";"360610093002";14;85;20;7;163;289
"3523";"360610093003";4;16;13;10;20;63
"3524";"360610093004";22;4;5;0;8;39
"3525";"360610093005";38;24;8;5;25;100
"3526";"360610093006";78;89;8;1;16;192
"3527";"360610093007";62;14;11;10;19;116
"3528";"360610094001";7;183;102;6;1023;1321
"3529";"360610095001";85;277;84;11;358;815
"3530";"360610095002";37;63;54;10;131;295
"3531";"360610096001";17;330;201;4;1545;2097
"3532";"360610097001";11;4;31;4;78;128
"3533";"360610097002";370;28;35;6;278;717
"3534";"360610097003";3;0;2;0;1;6
"3535";"360610097004";628;22;10;5;51;716
"3536";"360610098001";15;28;10;0;36;89
"3537";"360610098002";48;90;17;3;25;183
"3538";"360610098003";52;49;27;5;67;200
"3539";"360610098004";29;5;30;2;21;87
"3540";"360610098005";17;18;5;3;21;64
"3541";"360610098006";89;95;118;4;25;331
"3542";"360610098007";71;21;47;4;20;163
"3543";"360610099001";177;400;457;23;679;1736
"3544";"360610100001";8;45;59;9;231;352
"3545";"360610100002";16;44;40;2;141;243
"3546";"360610101001";32;232;93;2;1045;1404
"3547";"360610102001";9;49;108;5;465;636
"3548";"360610103001";132;146;155;4;234;671
"3549";"360610104001";30;105;126;3;655;919
"3550";"360610106010";0;0;0;0;1;1
"3551";"360610106011";10;10;12;1;18;51
"3552";"360610106012";41;6;27;2;10;86
"3553";"360610106013";5;20;7;0;4;36
"3554";"360610106014";1;14;3;0;12;30
"3555";"360610106015";6;2;3;0;4;15
"3556";"360610106016";2;6;49;0;11;68
"3557";"360610106021";11;50;8;1;21;91
"3558";"360610106022";13;253;28;6;145;445
"3559";"360610106023";2;21;17;0;38;78
"3560";"360610108001";8;120;6;1;19;154
"3561";"360610108002";9;10;12;2;11;44
"3562";"360610108003";5;38;18;2;10;73
"3563";"360610108004";1;6;8;0;5;20
"3564";"360610108005";75;22;10;3;16;126
"3565";"360610108006";28;48;10;2;53;141
"3566";"360610108007";10;58;20;3;87;178
"3567";"360610109001";14;853;106;2;1159;2134
"3568";"360610110001";11;52;11;2;12;88
"3569";"360610110002";10;12;16;5;11;54
"3570";"360610110003";46;69;41;2;131;289
"3571";"360610110004";9;105;12;2;32;160
"3572";"360610110005";17;128;4;1;23;173
"3573";"360610110006";60;47;29;12;107;255
"3574";"360610111001";101;97;69;1;218;486
"3575";"360610111002";22;29;27;1;94;173
"3576";"360610111003";100;19;31;0;77;227
"3577";"360610112011";7;37;75;4;303;426
"3578";"360610112021";2;34;53;4;133;226
"3579";"360610112031";3;21;8;1;190;223
"3580";"360610112032";2;8;9;1;107;127
"3581";"360610113001";29;368;213;5;1886;2501
"3582";"360610114011";17;18;19;2;76;132
"3583";"360610114012";5;15;82;2;60;164
"3584";"360610114021";27;32;30;5;203;297
"3585";"360610114022";25;49;24;1;107;206
"3586";"360610115001";28;113;53;1;433;628
"3587";"360610115002";41;88;38;1;243;411
"3588";"360610116001";5;40;20;1;35;101
"3589";"360610116002";12;11;55;1;11;90
"3590";"360610116003";20;251;34;1;13;319
"3591";"360610117001";36;62;106;7;75;286
"3592";"360610118001";8;11;3;0;8;30
"3593";"360610118002";1;8;4;0;13;26
"3594";"360610118003";2;106;22;0;11;141
"3595";"360610118004";79;27;78;8;34;226
"3596";"360610118005";10;13;11;0;16;50
"3597";"360610118006";31;24;20;5;28;108
"3598";"360610118007";9;5;14;0;8;36
"3599";"360610118008";4;6;8;1;18;37
"3600";"360610119001";17;229;61;3;399;709
"3601";"360610119002";119;106;112;2;404;743
"3602";"360610120001";3;19;27;1;21;71
"3603";"360610120002";5;7;10;2;28;52
"3604";"360610120003";18;14;49;19;35;135
"3605";"360610120004";7;29;30;6;68;140
"3606";"360610121001";112;105;105;4;299;625
"3607";"360610121002";6;8;8;0;23;45
"3608";"360610121003";66;30;18;4;144;262
"3609";"360610121004";50;129;41;6;88;314
"3610";"360610121005";246;188;12;0;43;489
"3611";"360610121006";63;38;7;1;45;154
"3612";"360610122001";69;20;22;0;14;125
"3613";"360610122002";6;6;12;1;12;37
"3614";"360610122003";10;13;21;2;21;67
"3615";"360610122004";2;14;35;1;22;74
"3616";"360610124001";59;46;43;12;29;189
"3617";"360610124002";36;94;24;4;27;185
"3618";"360610124003";3;12;26;6;5;52
"3619";"360610124004";15;9;16;9;10;59
"3620";"360610124005";1;9;22;2;5;39
"3621";"360610124006";4;4;7;1;9;25
"3622";"360610124007";1;18;9;3;3;34
"3623";"360610124008";0;3;7;1;6;17
"3624";"360610125001";14;150;95;2;470;731
"3625";"360610125002";41;701;75;5;196;1018
"3626";"360610126001";57;75;71;17;59;279
"3627";"360610126002";7;14;22;1;11;55
"3628";"360610126003";16;2;18;4;19;59
"3629";"360610126004";12;11;16;1;20;60
"3630";"360610126005";5;10;24;1;19;59
"3631";"360610126006";36;28;18;4;39;125
"3632";"360610126007";34;6;15;4;16;75
"3633";"360610126008";28;12;49;1;14;104
"3634";"360610127001";47;151;42;2;47;289
"3635";"360610127002";116;167;28;2;95;408
"3636";"360610127003";111;97;30;3;57;298
"3637";"360610127004";83;103;226;21;72;505
"3638";"360610127005";14;72;34;2;76;198
"3639";"360610128001";29;71;45;10;59;214
"3640";"360610128002";4;4;11;2;19;40
"3641";"360610128003";19;3;22;7;14;65
"3642";"360610128004";4;19;62;6;30;121
"3643";"360610128005";18;10;30;1;15;74
"3644";"360610129000";0;2;0;0;1;3
"3645";"360610129001";112;354;202;31;140;839
"3646";"360610129002";148;581;792;64;162;1747
"3647";"360610130001";7;11;35;1;12;66
"3648";"360610130002";9;2;41;6;43;101
"3649";"360610130003";7;5;18;3;38;71
"3650";"360610130004";11;9;33;0;25;78
"3651";"360610131001";13;63;104;4;283;467
"3652";"360610131002";27;124;47;9;398;605
"3653";"360610132001";27;8;14;4;15;68
"3654";"360610132002";44;18;11;1;67;141
"3655";"360610132003";20;19;17;6;10;72
"3656";"360610132004";53;101;39;10;157;360
"3657";"360610132005";45;14;15;5;13;92
"3658";"360610132006";25;14;23;0;14;76
"3659";"360610132007";9;7;19;1;20;56
"3660";"360610133001";16;42;9;2;40;109
"3661";"360610133002";59;114;31;5;77;286
"3662";"360610133003";103;232;55;0;100;490
"3663";"360610133004";35;66;67;3;43;214
"3664";"360610133005";36;61;37;1;79;214
"3665";"360610134001";34;66;15;2;25;142
"3666";"360610134002";40;10;8;1;30;89
"3667";"360610134003";34;22;17;6;21;100
"3668";"360610134004";0;33;7;2;17;59
"3669";"360610134005";25;174;32;3;31;265
"3670";"360610134006";26;19;22;6;42;115
"3671";"360610134007";55;51;14;2;67;189
"3672";"360610134008";6;39;20;2;162;229
"3673";"360610134009";32;124;19;5;23;203
"3674";"360610135001";78;79;92;4;91;344
"3675";"360610135002";79;95;116;13;134;437
"3676";"360610136001";100;30;19;3;28;180
"3677";"360610136002";39;14;10;4;11;78
"3678";"360610136003";27;9;18;0;15;69
"3679";"360610136004";77;14;93;2;36;222
"3680";"360610136005";11;14;68;5;25;123
"3681";"360610136006";10;5;12;1;4;32
"3682";"360610136007";124;13;21;7;9;174
"3683";"360610136008";69;17;31;2;19;138
"3684";"360610137001";5;24;41;1;59;130
"3685";"360610137002";15;66;66;3;126;276
"3686";"360610137003";23;236;69;3;467;798
"3687";"360610137004";17;104;47;3;241;412
"3688";"360610137005";4;12;74;2;114;206
"3689";"360610137006";11;223;42;0;96;372
"3690";"360610138001";40;19;12;5;15;91
"3691";"360610138002";53;22;14;3;30;122
"3692";"360610138003";42;56;17;1;27;143
"3693";"360610138004";91;65;32;2;73;263
"3694";"360610138005";24;14;22;6;7;73
"3695";"360610138006";71;31;7;6;10;125
"3696";"360610138007";15;5;50;6;39;115
"3697";"360610138008";110;5;15;9;12;151
"3698";"360610138009";9;20;25;0;13;67
"3699";"360610139001";48;21;9;0;71;149
"3700";"360610139002";47;39;21;1;37;145
"3701";"360610139003";134;118;88;12;43;395
"3702";"360610139004";17;22;39;17;30;125
"3703";"360610139005";23;118;34;3;52;230
"3704";"360610139006";7;22;10;1;114;154
"3705";"360610139007";25;19;121;1;116;282
"3706";"360610140001";50;44;19;1;25;139
"3707";"360610140002";49;41;22;1;19;132
"3708";"360610140003";13;108;28;0;39;188
"3709";"360610140004";2;12;32;3;10;59
"3710";"360610140005";11;16;23;3;23;76
"3711";"360610140006";18;11;14;1;13;57
"3712";"360610142001";4;2;8;1;22;37
"3713";"360610142002";16;10;34;5;7;72
"3714";"360610142003";8;12;3;2;5;30
"3715";"360610142004";9;6;26;2;13;56
"3716";"360610142005";41;25;17;0;5;88
"3717";"360610142006";1;74;20;0;9;104
"3718";"360610143001";43;520;175;10;226;974
"3719";"360610144011";15;4;13;2;8;42
"3720";"360610144012";10;5;7;1;10;33
"3721";"360610144013";17;13;16;0;9;55
"3722";"360610144014";8;4;9;6;15;42
"3723";"360610144021";15;8;13;1;8;45
"3724";"360610144022";43;9;6;0;11;69
"3725";"360610144023";51;12;8;5;2;78
"3726";"360610144024";68;24;40;8;31;171
"3727";"360610144025";37;7;15;1;11;71
"3728";"360610145001";14;21;72;1;78;186
"3729";"360610145002";5;6;9;0;31;51
"3730";"360610145003";9;166;120;7;1281;1583
"3731";"360610145004";6;66;54;1;114;241
"3732";"360610146011";15;62;19;3;30;129
"3733";"360610146012";30;273;5;1;18;327
"3734";"360610146013";15;237;30;4;42;328
"3735";"360610146014";110;132;15;13;20;290
"3736";"360610146021";23;343;308;7;34;715
"3737";"360610146022";24;17;12;2;20;75
"3738";"360610146023";34;31;14;3;20;102
"3739";"360610146024";68;41;7;2;50;168
"3740";"360610146025";10;10;34;3;15;72
"3741";"360610146026";16;11;25;1;21;74
"3742";"360610147001";24;20;100;6;52;202
"3743";"360610148011";19;44;17;1;170;251
"3744";"360610148012";7;64;162;2;160;395
"3745";"360610148021";72;35;32;1;27;167
"3746";"360610148022";15;67;36;2;140;260
"3747";"360610148023";25;22;15;1;26;89
"3748";"360610148024";24;26;29;0;7;86
"3749";"360610148025";2;13;51;3;57;126
"3750";"360610149001";7;70;76;5;433;591
"3751";"360610149002";4;10;18;0;62;94
"3752";"360610149003";14;32;67;2;248;363
"3753";"360610149004";2;25;27;0;441;495
"3754";"360610149005";4;11;10;2;98;125
"3755";"360610150011";13;11;7;0;5;36
"3756";"360610150012";2;12;12;3;11;40
"3757";"360610150021";7;8;21;0;9;45
"3758";"360610150022";1;3;10;0;2;16
"3759";"360610150023";7;4;13;9;5;38
"3760";"360610150024";12;5;31;1;14;63
"3761";"360610151001";79;130;27;1;14;251
"3762";"360610151002";236;21;19;0;26;302
"3763";"360610151003";29;21;16;1;17;84
"3764";"360610151004";27;41;50;3;49;170
"3765";"360610152000";0;1;0;0;0;1
"3766";"360610152001";100;7;9;0;6;122
"3767";"360610152002";291;18;16;0;31;356
"3768";"360610152003";10;11;17;0;9;47
"3769";"360610152004";9;10;10;2;7;38
"3770";"360610152005";4;1;18;2;5;30
"3771";"360610152006";8;15;31;4;9;67
"3772";"360610153001";25;26;14;2;206;273
"3773";"360610153002";16;21;38;6;111;192
"3774";"360610153003";9;22;47;2;254;334
"3775";"360610153004";14;15;63;0;259;351
"3776";"360610153005";30;5;11;0;25;71
"3777";"360610153006";32;11;127;3;95;268
"3778";"360610153007";18;184;59;4;35;300
"3779";"360610154001";50;40;23;4;28;145
"3780";"360610154002";21;10;6;2;17;56
"3781";"360610154003";71;18;15;7;25;136
"3782";"360610154004";25;8;18;1;14;66
"3783";"360610154005";95;384;8;0;14;501
"3784";"360610154006";115;27;13;2;18;175
"3785";"360610154007";3;17;7;1;8;36
"3786";"360610154008";17;16;12;2;28;75
"3787";"360610154009";59;12;19;1;24;115
"3788";"360610155001";5;2;7;0;7;21
"3789";"360610155002";2;2;28;2;6;40
"3790";"360610155003";0;3;11;6;3;23
"3791";"360610155004";0;4;17;0;3;24
"3792";"360610155005";1;4;6;0;2;13
"3793";"360610155006";28;17;42;7;27;121
"3794";"360610156011";31;22;17;1;14;85
"3795";"360610156012";20;72;33;11;11;147
"3796";"360610156013";40;30;19;1;21;111
"3797";"360610156014";14;7;28;4;21;74
"3798";"360610156021";88;35;52;4;47;226
"3799";"360610157001";33;25;49;4;15;126
"3800";"360610157002";39;8;32;3;29;111
"3801";"360610157003";32;47;20;0;25;124
"3802";"360610157004";40;9;31;0;22;102
"3803";"360610157005";30;29;10;2;30;101
"3804";"360610157006";31;59;8;11;85;194
"3805";"360610157007";26;31;18;12;305;392
"3806";"360610157008";18;11;14;2;95;140
"3807";"360610158011";6;115;76;7;14;218
"3808";"360610158012";65;43;13;4;20;145
"3809";"360610158013";8;36;17;0;13;74
"3810";"360610158014";15;13;16;6;22;72
"3811";"360610158021";23;12;62;1;26;124
"3812";"360610158022";118;52;98;0;14;282
"3813";"360610159001";10;15;18;0;14;57
"3814";"360610159002";9;9;43;3;12;76
"3815";"360610159003";14;4;29;2;10;59
"3816";"360610159004";7;4;12;1;139;163
"3817";"360610159005";33;111;19;1;171;335
"3818";"360610159006";46;80;31;5;151;313
"3819";"360610159007";3;27;4;1;65;100
"3820";"360610160011";10;2;14;4;4;34
"3821";"360610160012";8;9;24;0;28;69
"3822";"360610160013";7;4;30;0;9;50
"3823";"360610160014";9;4;8;0;7;28
"3824";"360610160021";5;8;202;1;10;226
"3825";"360610160022";41;39;24;2;13;119
"3826";"360610161001";28;32;16;2;57;135
"3827";"360610161002";16;14;5;1;14;50
"3828";"360610161003";45;23;31;5;53;157
"3829";"360610161004";42;24;169;0;22;257
"3830";"360610161005";45;13;105;4;55;222
"3831";"360610161006";43;15;18;1;23;100
"3832";"360610162001";18;14;16;2;27;77
"3833";"360610162002";28;3;14;1;5;51
"3834";"360610162003";147;25;7;2;4;185
"3835";"360610162004";196;57;20;2;17;292
"3836";"360610162005";133;64;72;2;12;283
"3837";"360610163000";0;0;0;0;1;1
"3838";"360610163001";30;11;28;4;22;95
"3839";"360610163002";21;23;42;6;14;106
"3840";"360610163003";102;16;19;6;62;205
"3841";"360610163004";33;109;28;4;85;259
"3842";"360610163005";14;30;50;4;131;229
"3843";"360610164001";97;53;18;6;14;188
"3844";"360610164002";273;112;40;4;28;457
"3845";"360610164003";109;19;16;5;15;164
"3846";"360610164004";57;18;9;1;14;99
"3847";"360610165001";13;21;70;3;54;161
"3848";"360610165002";8;33;8;1;49;99
"3849";"360610165003";13;13;21;8;43;98
"3850";"360610165004";33;26;7;3;11;80
"3851";"360610165005";42;31;18;5;17;113
"3852";"360610166001";52;58;14;2;51;177
"3853";"360610166002";90;48;36;9;15;198
"3854";"360610166003";62;161;30;5;11;269
"3855";"360610166004";68;37;15;1;15;136
"3856";"360610166005";49;28;7;2;8;94
"3857";"360610166006";250;84;24;1;15;374
"3858";"360610167001";26;20;74;1;18;139
"3859";"360610167002";15;8;37;0;32;92
"3860";"360610167003";4;19;32;2;209;266
"3861";"360610167004";43;51;42;4;117;257
"3862";"360610167005";19;42;27;7;45;140
"3863";"360610168001";641;29;15;1;6;692
"3864";"360610168002";213;29;62;1;12;317
"3865";"360610168003";21;56;32;0;19;128
"3866";"360610169001";33;8;13;0;44;98
"3867";"360610169002";34;76;10;3;27;150
"3868";"360610169003";35;67;29;1;144;276
"3869";"360610169004";74;61;125;4;27;291
"3870";"360610169005";22;12;29;1;26;90
"3871";"360610169006";81;3;15;4;2;105
"3872";"360610170001";8;16;64;1;12;101
"3873";"360610170002";335;31;26;0;25;417
"3874";"360610170003";53;62;23;3;29;170
"3875";"360610170004";30;71;45;2;25;173
"3876";"360610170005";67;350;85;2;32;536
"3877";"360610171001";26;65;28;2;159;280
"3878";"360610171002";18;26;16;0;264;324
"3879";"360610171003";62;33;20;2;167;284
"3880";"360610171004";8;12;15;2;7;44
"3881";"360610171005";92;14;15;0;22;143
"3882";"360610171006";22;30;15;2;38;107
"3883";"360610172001";145;203;81;7;101;537
"3884";"360610172002";77;19;14;2;10;122
"3885";"360610172003";32;18;27;11;16;104
"3886";"360610172004";67;427;19;3;57;573
"3887";"360610172005";34;83;20;1;44;182
"3888";"360610173001";17;89;11;0;73;190
"3889";"360610173002";31;11;8;0;11;61
"3890";"360610173003";137;68;22;4;21;252
"3891";"360610173004";72;58;18;7;12;167
"3892";"360610173005";16;4;16;2;9;47
"3893";"360610173006";21;13;7;1;10;52
"3894";"360610173007";22;11;12;1;23;69
"3895";"360610174011";78;20;14;19;10;141
"3896";"360610174012";59;95;13;0;9;176
"3897";"360610174013";98;145;29;0;50;322
"3898";"360610174021";185;82;28;4;58;357
"3899";"360610175001";33;24;31;0;37;125
"3900";"360610175002";17;25;44;0;24;110
"3901";"360610175003";26;10;10;0;25;71
"3902";"360610175004";6;25;14;0;35;80
"3903";"360610175005";16;31;59;0;25;131
"3904";"360610175006";25;29;14;3;46;117
"3905";"360610175007";34;46;21;3;133;237
"3906";"360610177001";58;12;16;1;8;95
"3907";"360610177002";106;36;21;1;19;183
"3908";"360610177003";23;28;20;1;20;92
"3909";"360610177004";457;40;8;1;9;515
"3910";"360610177005";122;30;20;2;16;190
"3911";"360610177006";363;8;7;0;9;387
"3912";"360610177007";7;12;13;1;8;41
"3913";"360610177008";72;8;16;2;12;110
"3914";"360610178001";42;234;56;24;47;403
"3915";"360610178002";90;91;158;8;29;376
"3916";"360610178003";76;117;71;20;40;324
"3917";"360610179001";32;12;25;2;26;97
"3918";"360610179002";4;4;4;1;3;16
"3919";"360610179003";25;11;24;1;12;73
"3920";"360610179004";31;38;17;4;69;159
"3921";"360610179005";44;7;6;0;44;101
"3922";"360610179006";82;131;23;2;73;311
"3923";"360610179007";20;21;43;2;56;142
"3924";"360610180001";128;73;23;7;23;254
"3925";"360610180002";207;140;92;3;70;512
"3926";"360610180003";90;128;57;13;57;345
"3927";"360610180004";98;23;5;0;2;128
"3928";"360610181001";66;29;12;1;17;125
"3929";"360610181002";25;14;9;1;21;70
"3930";"360610181003";34;24;9;0;21;88
"3931";"360610181004";25;22;23;0;5;75
"3932";"360610181005";32;8;6;0;12;58
"3933";"360610181006";27;5;8;3;36;79
"3934";"360610182001";147;180;6;1;80;414
"3935";"360610182002";171;56;17;0;53;297
"3936";"360610182003";72;132;26;5;125;360
"3937";"360610182004";119;38;17;2;5;181
"3938";"360610182005";247;82;5;0;37;371
"3939";"360610183001";73;31;24;6;37;171
"3940";"360610183002";10;4;7;1;8;30
"3941";"360610183003";230;64;12;0;11;317
"3942";"360610183004";17;33;52;4;99;205
"3943";"360610183005";2;25;223;0;111;361
"3944";"360610183006";140;111;100;7;121;479
"3945";"360610183007";40;81;66;3;66;256
"3946";"360610184001";177;155;85;11;118;546
"3947";"360610184002";25;29;37;0;22;113
"3948";"360610184003";190;25;13;0;14;242
"3949";"360610184004";215;36;23;0;6;280
"3950";"360610185001";11;16;12;2;8;49
"3951";"360610185002";87;70;53;5;93;308
"3952";"360610185003";2;6;5;0;16;29
"3953";"360610186001";166;84;28;2;13;293
"3954";"360610186002";178;191;33;1;65;468
"3955";"360610186003";210;99;7;1;9;326
"3956";"360610187001";66;21;15;1;15;118
"3957";"360610187002";45;8;27;2;5;87
"3958";"360610187003";23;9;8;4;31;75
"3959";"360610187004";19;17;5;4;50;95
"3960";"360610187005";47;55;25;6;51;184
"3961";"360610187006";54;94;40;0;72;260
"3962";"360610188001";312;205;41;1;116;675
"3963";"360610188002";254;250;189;7;45;745
"3964";"360610188003";118;195;61;3;121;498
"3965";"360610188004";97;114;33;1;33;278
"3966";"360610189001";64;53;21;5;42;185
"3967";"360610189002";115;74;11;6;37;243
"3968";"360610189003";430;46;15;1;11;503
"3969";"360610189004";44;119;18;6;29;216
"3970";"360610189005";49;71;19;1;56;196
"3971";"360610189006";234;41;21;2;38;336
"3972";"360610190001";228;221;101;21;62;633
"3973";"360610191001";38;15;27;1;27;108
"3974";"360610191002";30;18;26;1;23;98
"3975";"360610191003";12;7;7;0;20;46
"3976";"360610191004";27;26;14;2;14;83
"3977";"360610191005";61;168;40;1;109;379
"3978";"360610191006";39;49;19;2;118;227
"3979";"360610192000";0;0;0;0;1;1
"3980";"360610192001";859;175;76;14;25;1149
"3981";"360610192002";85;27;4;2;4;122
"3982";"360610192003";1;0;0;0;0;1
"3983";"360610193001";63;69;15;0;33;180
"3984";"360610193002";78;207;10;1;37;333
"3985";"360610193003";157;69;9;3;19;257
"3986";"360610193004";78;149;48;4;69;348
"3987";"360610193005";176;500;26;2;85;789
"3988";"360610193006";79;53;21;1;49;203
"3989";"360610194001";277;40;51;7;21;396
"3990";"360610194002";40;31;24;12;28;135
"3991";"360610194003";35;58;23;3;23;142
"3992";"360610194004";97;21;15;6;13;152
"3993";"360610195001";18;32;22;9;68;149
"3994";"360610195002";76;222;55;3;80;436
"3995";"360610195003";172;150;25;5;82;434
"3996";"360610195004";54;34;34;0;22;144
"3997";"360610195005";29;28;23;0;16;96
"3998";"360610196001";110;83;34;1;17;245
"3999";"360610196002";55;38;33;1;63;190
"4000";"360610196003";84;97;114;4;518;817
"4001";"360610197011";67;122;74;11;354;628
"4002";"360610197021";82;102;54;2;102;342
"4003";"360610198001";56;180;65;9;523;833
"4004";"360610198002";3;80;15;5;97;200
"4005";"360610199001";38;31;31;3;59;162
"4006";"360610199002";17;27;19;1;179;243
"4007";"360610199003";46;10;17;2;38;113
"4008";"360610199004";40;13;27;1;7;88
"4009";"360610199005";30;23;32;2;77;164
"4010";"360610199006";29;61;21;1;150;262
"4011";"360610200001";209;96;8;2;35;350
"4012";"360610200002";205;687;200;15;195;1302
"4013";"360610201011";8;9;28;2;56;103
"4014";"360610201021";40;107;35;2;73;257
"4015";"360610201022";105;203;18;3;58;387
"4016";"360610201023";18;88;6;1;19;132
"4017";"360610201024";49;66;5;7;47;174
"4018";"360610203001";5;16;8;3;3;35
"4019";"360610203002";0;9;33;3;50;95
"4020";"360610205001";11;23;19;4;285;342
"4021";"360610205002";44;0;25;2;24;95
"4022";"360610205003";4;7;26;0;41;78
"4023";"360610206001";165;281;41;14;51;552
"4024";"360610206002";256;142;73;23;87;581
"4025";"360610207011";7;4;5;0;5;21
"4026";"360610207012";18;9;6;2;13;48
"4027";"360610208001";235;147;18;8;16;424
"4028";"360610208002";410;147;48;10;44;659
"4029";"360610208003";83;78;75;8;51;295
"4030";"360610209011";36;42;31;12;121;242
"4031";"360610209012";256;98;23;0;36;413
"4032";"360610210001";29;26;49;4;13;121
"4033";"360610210002";41;8;9;1;14;73
"4034";"360610210003";212;46;17;1;20;296
"4035";"360610210004";234;13;12;1;68;328
"4036";"360610211001";25;64;41;1;37;168
"4037";"360610211002";32;58;19;0;13;122
"4038";"360610211003";105;167;71;2;38;383
"4039";"360610211004";56;15;11;2;15;99
"4040";"360610211005";57;68;20;1;7;153
"4041";"360610211006";7;23;7;1;4;42
"4042";"360610211007";30;23;17;1;10;81
"4043";"360610212001";57;64;143;10;46;320
"4044";"360610212002";1;3;9;1;56;70
"4045";"360610212003";11;10;15;2;11;49
"4046";"360610212004";28;33;25;8;74;168
"4047";"360610213031";107;50;11;0;30;198
"4048";"360610213032";20;19;58;10;37;144
"4049";"360610213033";396;208;6;0;17;627
"4050";"360610213034";155;153;19;0;34;361
"4051";"360610214001";38;63;30;0;29;160
"4052";"360610214002";71;40;12;1;36;160
"4053";"360610215001";95;215;43;0;62;415
"4054";"360610215002";243;163;42;6;51;505
"4055";"360610216001";111;200;25;3;150;489
"4056";"360610216002";78;135;8;4;20;245
"4057";"360610216003";77;320;9;1;32;439
"4058";"360610216004";162;190;23;2;24;401
"4059";"360610216005";238;128;42;3;66;477
"4060";"360610217031";34;119;48;5;31;237
"4061";"360610218001";100;210;28;7;43;388
"4062";"360610218002";548;414;57;6;72;1097
"4063";"360610218003";162;316;79;2;78;637
"4064";"360610218004";110;304;44;2;91;551
"4065";"360610219001";168;82;40;5;67;362
"4066";"360610219002";144;181;29;47;11;412
"4067";"360610219003";260;23;21;1;14;319
"4068";"360610219004";121;18;74;2;11;226
"4069";"360610220001";151;86;16;4;23;280
"4070";"360610220002";113;123;24;10;24;294
"4071";"360610220003";104;46;2;0;11;163
"4072";"360610220004";102;142;16;4;33;297
"4073";"360610220005";170;197;15;3;24;409
"4074";"360610221021";131;119;76;10;40;376
"4075";"360610221022";21;62;69;12;81;245
"4076";"360610222001";91;227;70;8;136;532
"4077";"360610222002";137;493;222;10;233;1095
"4078";"360610223011";513;235;17;2;27;794
"4079";"360610223012";448;376;32;4;236;1096
"4080";"360610223013";953;808;45;1;44;1851
"4081";"360610223014";757;340;8;1;26;1132
"4082";"360610223021";137;82;58;3;24;304
"4083";"360610224001";110;70;24;10;35;249
"4084";"360610224002";171;205;106;7;42;531
"4085";"360610224003";619;217;11;4;13;864
"4086";"360610224004";275;16;14;1;17;323
"4087";"360610225001";477;518;45;2;61;1103
"4088";"360610225002";108;34;30;3;41;216
"4089";"360610225003";186;423;32;6;174;821
"4090";"360610225004";84;121;15;0;20;240
"4091";"360610225005";594;380;28;1;39;1042
"4092";"360610226001";205;412;164;42;51;874
"4093";"360610226002";169;84;55;7;58;373
"4094";"360610226003";160;253;64;2;40;519
"4095";"360610227001";115;106;53;5;64;343
"4096";"360610227002";171;20;93;5;27;316
"4097";"360610227003";326;72;139;9;30;576
"4098";"360610228001";231;185;36;2;89;543
"4099";"360610228002";69;61;33;4;92;259
"4100";"360610228003";97;149;7;2;59;314
"4101";"360610228004";22;41;42;5;19;129
"4102";"360610229001";18;20;7;0;17;62
"4103";"360610229002";181;236;26;3;25;471
"4104";"360610229003";377;424;34;7;65;907
"4105";"360610229004";199;316;3;1;25;544
"4106";"360610229005";258;271;11;2;46;588
"4107";"360610230001";259;75;13;4;15;366
"4108";"360610230002";235;88;11;1;24;359
"4109";"360610230003";68;95;114;7;35;319
"4110";"360610230004";565;209;93;2;46;915
"4111";"360610230005";136;64;5;2;34;241
"4112";"360610231001";151;118;59;3;47;378
"4113";"360610231002";248;233;69;9;43;602
"4114";"360610231003";308;274;92;6;67;747
"4115";"360610232001";140;18;30;0;49;237
"4116";"360610232002";659;130;33;11;24;857
"4117";"360610232003";262;33;4;5;18;322
"4118";"360610232004";255;294;21;4;62;636
"4119";"360610233001";248;253;25;5;62;593
"4120";"360610233002";236;199;38;4;29;506
"4121";"360610233003";331;256;60;0;28;675
"4122";"360610234001";440;430;29;36;31;966
"4123";"360610234002";272;213;46;21;28;580
"4124";"360610235011";157;23;23;0;11;214
"4125";"360610235012";539;367;19;4;38;967
"4126";"360610235013";86;23;39;0;6;154
"4127";"360610235014";252;207;60;3;12;534
"4128";"360610235021";128;181;42;3;56;410
"4129";"360610236001";82;19;50;11;21;183
"4130";"360610236002";402;61;10;3;24;500
"4131";"360610236003";51;22;8;0;6;87
"4132";"360610236004";132;34;12;2;21;201
"4133";"360610237001";316;623;19;7;37;1002
"4134";"360610237002";382;362;57;4;33;838
"4135";"360610237003";207;290;49;2;25;573
"4136";"360610238010";0;0;1;0;0;1
"4137";"360610238011";24;10;3;3;21;61
"4138";"360610238021";11;2;2;1;1;17
"4139";"360610238022";20;3;1;0;7;31
"4140";"360610239001";98;51;22;3;43;217
"4141";"360610239002";271;132;11;1;26;441
"4142";"360610240001";2;12;8;3;11;36
"4143";"360610241001";66;24;15;2;22;129
"4144";"360610241002";80;40;17;2;34;173
"4145";"360610241003";185;327;3;5;15;535
"4146";"360610241004";393;348;18;1;23;783
"4147";"360610241005";114;77;9;0;14;214
"4148";"360610242001";126;32;112;13;59;342
"4149";"360610242002";51;8;52;5;58;174
"4150";"360610242003";21;25;67;10;185;308
"4151";"360610243011";87;127;12;1;13;240
"4152";"360610243012";125;56;198;3;44;426
"4153";"360610243013";39;65;8;1;18;131
"4154";"360610243020";1;1;0;1;0;3
"4155";"360610243021";650;45;41;9;32;777
"4156";"360610243023";609;16;5;0;9;639
"4157";"360610245001";299;432;38;0;29;798
"4158";"360610245002";100;124;7;0;14;245
"4159";"360610245003";155;306;15;4;21;501
"4160";"360610245004";286;185;66;0;64;601
"4161";"360610245005";151;120;84;2;43;400
"4162";"360610245006";179;118;35;1;37;370
"4163";"360610245007";158;276;7;0;25;466
"4164";"360610247001";62;133;46;5;14;260
"4165";"360610247002";146;248;12;6;26;438
"4166";"360610247003";101;218;4;0;1;324
"4167";"360610247004";144;248;98;0;40;530
"4168";"360610247005";192;135;53;3;17;400
"4169";"360610249001";120;80;41;3;15;259
"4170";"360610251001";154;141;64;7;57;423
"4171";"360610251002";89;183;90;0;39;401
"4172";"360610253001";184;348;21;1;10;564
"4173";"360610253002";193;309;8;5;23;538
"4174";"360610253003";183;342;45;2;37;609
"4175";"360610253004";140;102;28;2;47;319
"4176";"360610253005";402;241;43;2;32;720
"4177";"360610253006";186;58;68;9;21;342
"4178";"360610255001";35;17;52;9;9;122
"4179";"360610255002";117;102;59;0;34;312
"4180";"360610255003";199;98;26;1;20;344
"4181";"360610255004";56;16;18;2;7;99
"4182";"360610257001";110;150;63;2;134;459
"4183";"360610257002";43;38;74;2;53;210
"4184";"360610257003";48;149;10;5;40;252
"4185";"360610259001";1039;488;126;19;26;1698
"4186";"360610259002";46;216;211;10;31;514
"4187";"360610261001";243;261;41;0;52;597
"4188";"360610261002";85;294;8;7;20;414
"4189";"360610261003";126;45;5;0;8;184
"4190";"360610261004";196;246;12;2;24;480
"4191";"360610261005";143;399;332;10;24;908
"4192";"360610261006";67;400;8;2;11;488
"4193";"360610261007";75;254;37;13;25;404
"4194";"360610263001";89;151;46;1;34;321
"4195";"360610263002";387;113;17;2;23;542
"4196";"360610263003";130;237;62;7;31;467
"4197";"360610263004";204;215;39;1;38;497
"4198";"360610263005";327;289;33;3;18;670
"4199";"360610265001";92;44;5;0;5;146
"4200";"360610265002";573;97;104;0;39;813
"4201";"360610265003";16;37;42;3;13;111
"4202";"360610265004";313;220;24;1;37;595
"4203";"360610265005";72;20;7;0;36;135
"4204";"360610267001";490;54;51;12;13;620
"4205";"360610269001";110;67;12;1;18;208
"4206";"360610269002";147;258;27;0;9;441
"4207";"360610269003";49;35;53;2;16;155
"4208";"360610269004";119;478;38;11;40;686
"4209";"360610269005";151;141;43;2;42;379
"4210";"360610269006";335;219;11;5;14;584
"4211";"360610271001";233;231;18;1;15;498
"4212";"360610271002";189;449;24;5;45;712
"4213";"360610271003";131;89;132;10;29;391
"4214";"360610271004";350;130;92;2;22;596
"4215";"360610271005";109;11;14;1;11;146
"4216";"360610273001";114;88;117;5;17;341
"4217";"360610273002";61;27;28;1;12;129
"4218";"360610273003";136;216;46;1;45;444
"4219";"360610273004";51;29;19;0;20;119
"4220";"360610275000";0;0;1;0;1;2
"4221";"360610275001";15;19;40;4;6;84
"4222";"360610275002";3;4;11;0;1;19
"4223";"360610277001";326;261;48;2;26;663
"4224";"360610277002";108;127;4;7;13;259
"4225";"360610277003";121;419;17;7;28;592
"4226";"360610277004";128;96;4;0;9;237
"4227";"360610279001";77;45;29;1;24;176
"4228";"360610279002";809;293;29;2;17;1150
"4229";"360610279003";247;299;27;14;24;611
"4230";"360610279004";489;407;75;16;33;1020
"4231";"360610279005";594;75;44;3;14;730
"4232";"360610279006";69;52;37;0;5;163
"4233";"360610279007";101;61;17;0;2;181
"4234";"360610281001";8;5;7;15;11;46
"4235";"360610281002";127;76;120;4;24;351
"4236";"360610283001";20;180;13;0;14;227
"4237";"360610283002";762;580;92;4;43;1481
"4238";"360610283003";152;99;25;3;12;291
"4239";"360610283004";232;856;64;0;26;1178
"4240";"360610285001";227;734;243;4;45;1253
"4241";"360610285002";345;410;8;4;15;782
"4242";"360610285003";224;367;13;1;3;608
"4243";"360610285004";704;958;22;4;23;1711
"4244";"360610287001";186;464;144;8;46;848
"4245";"360610287002";219;219;21;3;16;478
"4246";"360610287003";335;1204;56;8;37;1640
"4247";"360610291001";369;295;4;4;26;698
"4248";"360610291002";96;79;30;1;9;215
"4249";"360610291003";367;93;8;4;21;493
"4250";"360610291004";517;185;36;1;23;762
"4251";"360610291005";119;219;14;2;18;372
"4252";"360610291006";206;209;3;0;19;437
"4253";"360610291007";276;527;22;0;18;843
"4254";"360610293001";327;516;23;7;20;893
"4255";"360610293002";138;124;13;0;21;296
"4256";"360610293003";331;525;56;19;38;969
"4257";"360610293004";341;554;59;1;36;991
"4258";"360610293005";148;212;7;6;19;392
"4259";"360610295001";126;417;98;5;17;663
"4260";"360610295002";139;813;92;2;37;1083
"4261";"360610295003";299;167;85;2;14;567
"4262";"360610295004";351;71;81;7;19;529
"4263";"360610297001";35;320;79;11;20;465
"4264";"360610299000";0;0;0;0;1;1
"4265";"360610299001";662;25;23;1;16;727
"4266";"360610299002";56;163;107;20;52;398
"4267";"360610303001";351;678;74;6;27;1136
"4268";"360610303002";184;112;31;4;41;372
"4269";"360610303003";140;198;64;10;26;438
"4270";"360610307001";145;254;109;9;26;543
"4271";"360610307002";11;13;114;4;0;142
"4272";"360610307003";278;144;47;1;14;484
"4273";"360610309001";443;99;70;1;27;640
"4274";"360610309002";84;43;100;2;23;252
"4275";"360610309003";307;53;65;1;15;441
"4276";"360610309004";346;198;230;5;25;804
"4277";"360610311001";43;184;87;9;23;346
"4278";"360610317031";10;63;59;2;29;163
"4279";"360610317032";5;81;50;3;9;148
"4280";"360610317041";20;134;75;1;19;249
"4281";"360610317042";26;16;12;9;3;66
"4282";"360610317043";21;139;124;5;8;297
"4283";"360610317044";26;45;154;9;22;256
"4284";"360610319001";0;8;18;0;19;45
"4285";"360810001001";92;372;573;64;54;1155
"4286";"360810002001";88;13;251;59;48;459
"4287";"360810002002";275;67;253;75;51;721
"4288";"360810004001";111;34;351;32;26;554
"4289";"360810004002";63;18;264;139;38;522
"4290";"360810004003";84;21;328;104;58;595
"4291";"360810006001";45;24;149;30;39;287
"4292";"360810006002";28;15;143;62;35;283
"4293";"360810006003";105;69;316;186;30;706
"4294";"360810007001";50;41;128;27;27;273
"4295";"360810007002";20;63;128;36;29;276
"4296";"360810007003";21;55;367;33;30;506
"4297";"360810007004";41;359;364;58;103;925
"4298";"360810008001";150;41;164;113;59;527
"4299";"360810008002";100;11;345;84;50;590
"4300";"360810010001";34;21;112;17;32;216
"4301";"360810010002";89;21;325;41;42;518
"4302";"360810012001";89;16;199;45;40;389
"4303";"360810012002";70;10;188;84;27;379
"4304";"360810012003";136;32;196;50;84;498
"4305";"360810014001";63;17;437;139;27;683
"4306";"360810014002";77;15;136;51;62;341
"4307";"360810014003";55;21;195;75;110;456
"4308";"360810016001";103;17;124;31;35;310
"4309";"360810016002";309;46;129;54;37;575
"4310";"360810018001";103;21;118;40;50;332
"4311";"360810018002";216;40;239;70;51;616
"4312";"360810019001";67;108;874;176;110;1335
"4313";"360810020001";83;31;281;97;50;542
"4314";"360810022001";44;10;207;33;39;333
"4315";"360810022002";77;27;136;44;37;321
"4316";"360810024001";95;4;109;29;23;260
"4317";"360810024002";96;43;384;42;31;596
"4318";"360810025001";53;15;10;1;1;80
"4319";"360810025002";46;16;3;0;2;67
"4320";"360810025003";162;37;3;0;8;210
"4321";"360810025004";213;15;59;6;6;299
"4322";"360810025005";129;12;10;1;2;154
"4323";"360810025006";130;22;15;2;7;176
"4324";"360810026001";20;36;92;45;33;226
"4325";"360810026002";99;37;75;43;49;303
"4326";"360810028001";184;29;161;82;61;517
"4327";"360810028002";117;44;191;77;46;475
"4328";"360810030001";56;7;164;79;32;338
"4329";"360810031001";37;153;143;24;19;376
"4330";"360810031002";22;30;312;33;51;448
"4331";"360810032001";103;38;207;96;79;523
"4332";"360810033001";46;200;348;3;61;658
"4333";"360810033002";19;14;233;52;37;355
"4334";"360810033003";21;11;161;147;25;365
"4335";"360810033004";13;9;179;63;24;288
"4336";"360810034001";25;26;227;82;47;407
"4337";"360810034002";57;43;169;108;45;422
"4338";"360810036001";91;29;252;110;50;532
"4339";"360810036002";146;26;211;116;57;556
"4340";"360810037001";275;97;122;14;10;518
"4341";"360810038001";125;26;106;39;29;325
"4342";"360810038002";73;18;141;35;54;321
"4343";"360810039001";39;18;263;130;43;493
"4344";"360810040011";44;49;233;46;24;396
"4345";"360810040012";61;7;138;42;41;289
"4346";"360810040021";42;19;154;68;59;342
"4347";"360810042001";58;23;261;125;101;568
"4348";"360810042002";18;3;135;25;21;202
"4349";"360810042003";90;19;87;50;43;289
"4350";"360810043001";387;147;99;67;34;734
"4351";"360810043002";2;2;79;54;12;149
"4352";"360810044011";35;23;100;76;65;299
"4353";"360810044012";56;8;193;81;37;375
"4354";"360810045001";16;21;90;53;41;221
"4355";"360810045002";2;2;8;17;1;30
"4356";"360810045003";6;22;14;8;1;51
"4357";"360810047001";32;24;142;14;25;237
"4358";"360810047002";340;57;16;3;10;426
"4359";"360810050001";5;2;27;9;1;44
"4360";"360810051001";52;77;91;14;27;261
"4361";"360810051002";64;22;142;44;26;298
"4362";"360810052001";97;36;216;88;74;511
"4363";"360810052002";73;28;152;82;27;362
"4364";"360810053001";23;15;135;2;38;213
"4365";"360810053002";166;11;216;9;38;440
"4366";"360810053003";46;5;47;0;24;122
"4367";"360810053004";53;19;146;2;39;259
"4368";"360810054001";9;11;70;30;23;143
"4369";"360810054002";38;14;127;34;47;260
"4370";"360810054003";85;98;227;85;91;586
"4371";"360810054004";116;21;233;94;86;550
"4372";"360810055001";84;257;738;120;53;1252
"4373";"360810057001";207;84;97;13;29;430
"4374";"360810057002";20;38;59;18;32;167
"4375";"360810057003";83;282;123;13;21;522
"4376";"360810058001";45;32;250;118;56;501
"4377";"360810058002";12;7;49;39;16;123
"4378";"360810058003";31;13;72;62;48;226
"4379";"360810058004";37;53;160;49;27;326
"4380";"360810059001";37;56;117;1;28;239
"4381";"360810059002";107;19;160;4;15;305
"4382";"360810059003";46;145;93;3;46;333
"4383";"360810061001";46;98;111;2;23;280
"4384";"360810061002";91;187;59;0;39;376
"4385";"360810061003";61;167;34;2;45;309
"4386";"360810061004";52;25;64;1;12;154
"4387";"360810062011";12;4;31;4;4;55
"4388";"360810062012";93;18;249;55;98;513
"4389";"360810062021";1;6;51;37;18;113
"4390";"360810062022";27;6;110;25;22;190
"4391";"360810062023";49;8;94;61;78;290
"4392";"360810062024";90;2;96;19;9;216
"4393";"360810062025";72;7;81;41;15;216
"4394";"360810062026";48;8;110;47;16;229
"4395";"360810062027";57;5;178;41;48;329
"4396";"360810063001";35;26;89;4;28;182
"4397";"360810063002";60;40;65;10;26;201
"4398";"360810063003";62;36;43;2;21;164
"4399";"360810063004";39;95;87;5;44;270
"4400";"360810065011";68;79;37;3;17;204
"4401";"360810065012";20;6;110;7;17;160
"4402";"360810065013";45;12;55;5;2;119
"4403";"360810065021";49;239;129;11;43;471
"4404";"360810065022";35;10;134;9;24;212
"4405";"360810065023";129;76;148;4;41;398
"4406";"360810069001";54;27;154;3;21;259
"4407";"360810069002";167;41;269;10;52;539
"4408";"360810069003";33;81;73;5;29;221
"4409";"360810071001";14;116;132;6;23;291
"4410";"360810071002";21;5;9;0;14;49
"4411";"360810071003";26;13;161;1;13;214
"4412";"360810071004";51;544;134;3;108;840
"4413";"360810073001";67;33;110;3;45;258
"4414";"360810073002";35;5;33;2;4;79
"4415";"360810073003";117;28;106;0;24;275
"4416";"360810075001";44;10;88;3;24;169
"4417";"360810075002";82;91;51;7;29;260
"4418";"360810075003";18;8;18;1;9;54
"4419";"360810077001";53;22;137;13;35;260
"4420";"360810079001";117;36;291;49;37;530
"4421";"360810079002";11;14;116;22;17;180
"4422";"360810081001";59;63;205;66;32;425
"4423";"360810083001";46;25;502;40;23;636
"4424";"360810083002";142;104;203;71;67;587
"4425";"360810085001";83;26;351;98;22;580
"4426";"360810085002";6;42;187;58;14;307
"4427";"360810086001";143;14;164;76;67;464
"4428";"360810086002";59;15;101;84;32;291
"4429";"360810087001";542;43;64;2;10;661
"4430";"360810087002";45;26;84;49;21;225
"4431";"360810087003";151;63;24;15;6;259
"4432";"360810088001";94;34;277;121;64;590
"4433";"360810088002";38;64;277;70;62;511
"4434";"360810091001";16;5;67;20;19;127
"4435";"360810091002";64;22;246;24;22;378
"4436";"360810094001";78;63;133;43;163;480
"4437";"360810094002";114;14;176;45;72;421
"4438";"360810095001";22;5;60;2;16;105
"4439";"360810095002";31;33;112;20;25;221
"4440";"360810096001";132;12;273;64;112;593
"4441";"360810096002";147;31;229;34;96;537
"4442";"360810097001";31;8;25;3;14;81
"4443";"360810097002";10;46;51;28;26;161
"4444";"360810097003";13;10;31;4;19;77
"4445";"360810097004";22;26;46;1;36;131
"4446";"360810098001";66;22;202;42;49;381
"4447";"360810098002";198;50;196;33;102;579
"4448";"360810099001";10;57;7;2;4;80
"4449";"360810100001";249;42;182;39;100;612
"4450";"360810100002";234;40;245;57;111;687
"4451";"360810101001";22;19;129;14;36;220
"4452";"360810101002";23;29;128;13;31;224
"4453";"360810102001";117;10;110;49;67;353
"4454";"360810102002";99;26;195;46;78;444
"4455";"360810103001";55;83;84;14;22;258
"4456";"360810103002";23;34;60;13;27;157
"4457";"360810103003";31;16;57;0;16;120
"4458";"360810103004";48;27;34;7;11;127
"4459";"360810104001";143;77;194;20;108;542
"4460";"360810104002";247;11;314;47;86;705
"4461";"360810105001";47;23;15;2;7;94
"4462";"360810105002";17;13;24;3;9;66
"4463";"360810105003";20;18;42;7;30;117
"4464";"360810105004";14;9;35;1;6;65
"4465";"360810106001";34;2;240;40;82;398
"4466";"360810106002";175;30;377;65;113;760
"4467";"360810107011";4;15;41;34;10;104
"4468";"360810108001";99;22;248;36;74;479
"4469";"360810108002";56;21;360;58;97;592
"4470";"360810110001";38;18;171;49;41;317
"4471";"360810110002";220;15;516;50;109;910
"4472";"360810111001";85;26;76;13;12;212
"4473";"360810111002";15;13;144;8;11;191
"4474";"360810112001";155;13;220;54;59;501
"4475";"360810112002";71;17;252;18;70;428
"4476";"360810113001";56;17;25;3;24;125
"4477";"360810113002";64;49;57;4;22;196
"4478";"360810113003";34;100;154;4;28;320
"4479";"360810114001";134;11;230;146;50;571
"4480";"360810115001";33;80;200;13;82;408
"4481";"360810115002";14;53;84;2;142;295
"4482";"360810116001";214;40;81;43;30;408
"4483";"360810116002";80;17;215;57;52;421
"4484";"360810117001";20;76;139;2;20;257
"4485";"360810117002";17;66;40;4;18;145
"4486";"360810117003";24;28;218;15;45;330
"4487";"360810117004";28;15;152;18;12;225
"4488";"360810118001";83;5;307;68;83;546
"4489";"360810118002";31;7;162;45;58;303
"4490";"360810119001";17;30;141;3;24;215
"4491";"360810119002";10;5;72;12;21;120
"4492";"360810120001";30;6;110;18;27;191
"4493";"360810120002";19;20;283;51;54;427
"4494";"360810121001";28;9;91;6;34;168
"4495";"360810121002";9;10;22;1;27;69
"4496";"360810122001";41;135;238;33;101;548
"4497";"360810122002";154;23;179;51;69;476
"4498";"360810123011";32;135;139;100;41;447
"4499";"360810123012";8;12;113;79;20;232
"4500";"360810123013";6;49;63;39;47;204
"4501";"360810124001";75;38;92;43;38;286
"4502";"360810124002";86;30;195;89;40;440
"4503";"360810125001";23;18;104;12;31;188
"4504";"360810125002";8;58;56;7;34;163
"4505";"360810126011";71;8;158;68;112;417
"4506";"360810126012";50;17;164;45;52;328
"4507";"360810126021";82;15;97;21;50;265
"4508";"360810126022";111;27;197;80;60;475
"4509";"360810128001";53;6;84;34;33;210
"4510";"360810128002";100;30;97;23;38;288
"4511";"360810130001";4;5;73;53;13;148
"4512";"360810130002";62;57;85;26;20;250
"4513";"360810132001";21;11;42;3;13;90
"4514";"360810132002";30;19;109;23;37;218
"4515";"360810134001";527;11;43;8;15;604
"4516";"360810134002";17;12;740;3;26;798
"4517";"360810134003";246;10;236;8;15;515
"4518";"360810134004";17;0;16;1;3;37
"4519";"360810135001";11;6;80;29;30;156
"4520";"360810136001";5;4;56;10;22;97
"4521";"360810136002";45;191;43;1;10;290
"4522";"360810137001";60;49;246;86;48;489
"4523";"360810138001";52;10;59;4;12;137
"4524";"360810138002";93;22;435;26;59;635
"4525";"360810140001";42;7;270;23;27;369
"4526";"360810140002";127;15;221;8;40;411
"4527";"360810141001";25;50;25;2;9;111
"4528";"360810141002";48;24;179;160;44;455
"4529";"360810142011";30;23;174;19;46;292
"4530";"360810142012";57;17;247;42;116;479
"4531";"360810142021";105;46;301;32;75;559
"4532";"360810142022";73;24;216;69;37;419
"4533";"360810143001";36;5;122;5;18;186
"4534";"360810143002";71;370;127;7;80;655
"4535";"360810144001";144;59;430;39;123;795
"4536";"360810145001";18;3;202;109;22;354
"4537";"360810145002";157;20;183;60;13;433
"4538";"360810147001";12;6;110;20;20;168
"4539";"360810147002";51;13;123;27;15;229
"4540";"360810147003";28;70;107;3;26;234
"4541";"360810148001";135;24;215;53;127;554
"4542";"360810149001";40;30;47;6;12;135
"4543";"360810149002";36;35;138;9;50;268
"4544";"360810150001";640;17;128;39;91;915
"4545";"360810150002";110;20;121;20;55;326
"4546";"360810151001";53;30;115;11;11;220
"4547";"360810151002";36;48;115;48;17;264
"4548";"360810152001";38;11;144;38;61;292
"4549";"360810152002";51;8;203;99;58;419
"4550";"360810153001";12;9;118;24;29;192
"4551";"360810153002";33;78;141;18;16;286
"4552";"360810154001";77;36;124;17;37;291
"4553";"360810154002";83;41;231;75;54;484
"4554";"360810155001";72;160;151;2;38;423
"4555";"360810155002";39;144;136;0;89;408
"4556";"360810156001";103;26;244;62;54;489
"4557";"360810156002";82;33;168;47;116;446
"4558";"360810157001";47;98;100;43;93;381
"4559";"360810158011";47;10;85;44;33;219
"4560";"360810158012";67;13;111;67;46;304
"4561";"360810158013";101;37;185;83;76;482
"4562";"360810158021";156;34;246;53;127;616
"4563";"360810158022";215;29;178;35;89;546
"4564";"360810158023";99;32;128;24;80;363
"4565";"360810159001";38;125;110;3;15;291
"4566";"360810159002";169;23;23;17;58;290
"4567";"360810159003";48;9;21;8;16;102
"4568";"360810159004";30;25;104;3;26;188
"4569";"360810161001";26;7;61;6;34;134
"4570";"360810161002";79;81;89;4;47;300
"4571";"360810163001";20;6;120;25;12;183
"4572";"360810163002";106;63;13;20;7;209
"4573";"360810163003";299;32;8;9;21;369
"4574";"360810164001";52;12;185;74;60;383
"4575";"360810164002";129;32;189;79;110;539
"4576";"360810166001";211;39;378;40;102;770
"4577";"360810166002";67;115;119;32;41;374
"4578";"360810168001";160;20;191;52;77;500
"4579";"360810168002";176;12;186;135;94;603
"4580";"360810169001";70;5;37;11;9;132
"4581";"360810169002";86;9;55;3;32;185
"4582";"360810169003";44;10;74;6;24;158
"4583";"360810169004";22;27;26;6;18;99
"4584";"360810170001";93;2;183;39;65;382
"4585";"360810170002";86;42;187;32;44;391
"4586";"360810171001";8;77;289;56;34;464
"4587";"360810172001";148;18;129;61;70;426
"4588";"360810172002";31;35;93;63;41;263
"4589";"360810174001";83;12;110;82;29;316
"4590";"360810174002";94;3;189;63;108;457
"4591";"360810176001";87;9;151;66;49;362
"4592";"360810176002";58;11;63;27;12;171
"4593";"360810178001";131;13;175;51;42;412
"4594";"360810178002";79;6;115;65;31;296
"4595";"360810179001";12;3;169;29;34;247
"4596";"360810179002";77;55;126;22;40;320
"4597";"360810180001";74;29;143;63;67;376
"4598";"360810181011";40;23;47;0;7;117
"4599";"360810181012";67;23;29;5;4;128
"4600";"360810181013";62;18;33;2;15;130
"4601";"360810181021";27;13;20;7;15;82
"4602";"360810181022";53;89;21;8;13;184
"4603";"360810181023";43;90;38;5;23;199
"4604";"360810182001";54;13;56;38;32;193
"4605";"360810182002";38;2;99;84;38;261
"4606";"360810183001";38;19;159;13;18;247
"4607";"360810183002";55;8;33;3;8;107
"4608";"360810183003";84;39;31;2;15;171
"4609";"360810183004";94;58;64;4;31;251
"4610";"360810183005";62;179;36;7;38;322
"4611";"360810184011";197;25;188;148;48;606
"4612";"360810184021";30;8;87;52;38;215
"4613";"360810184022";12;8;74;31;22;147
"4614";"360810185011";32;7;220;1;27;287
"4615";"360810185012";8;6;17;2;3;36
"4616";"360810185013";57;40;82;2;29;210
"4617";"360810185021";18;3;10;0;15;46
"4618";"360810185022";155;20;35;2;19;231
"4619";"360810185023";33;59;13;3;30;138
"4620";"360810186001";121;17;233;118;72;561
"4621";"360810187001";57;40;154;22;27;300
"4622";"360810187002";15;3;27;5;14;64
"4623";"360810187003";27;17;131;13;16;204
"4624";"360810188001";59;19;139;75;53;345
"4625";"360810189001";276;19;97;6;43;441
"4626";"360810189002";116;12;155;32;27;342
"4627";"360810189003";55;5;48;4;10;122
"4628";"360810190001";31;17;101;82;41;272
"4629";"360810190002";44;13;180;97;45;379
"4630";"360810192001";117;14;166;46;79;422
"4631";"360810192002";68;19;83;47;33;250
"4632";"360810194001";59;12;84;81;56;292
"4633";"360810194002";108;8;201;107;49;473
"4634";"360810196001";71;19;96;83;69;338
"4635";"360810196002";87;16;219;113;42;477
"4636";"360810198001";31;16;106;84;50;287
"4637";"360810198002";63;12;93;81;40;289
"4638";"360810198003";21;10;104;41;20;196
"4639";"360810199001";0;8;461;33;37;539
"4640";"360810199002";5;9;308;201;44;567
"4641";"360810202001";67;29;271;167;62;596
"4642";"360810204001";40;15;151;197;55;458
"4643";"360810204002";75;33;218;206;57;589
"4644";"360810205001";2;4;78;61;17;162
"4645";"360810205002";17;4;145;105;11;282
"4646";"360810206001";102;21;262;151;62;598
"4647";"360810208001";77;18;177;48;55;375
"4648";"360810208002";24;35;315;185;110;669
"4649";"360810212001";10;51;78;22;73;234
"4650";"360810212002";126;17;64;20;39;266
"4651";"360810214001";116;11;72;0;16;215
"4652";"360810214002";47;6;152;24;17;246
"4653";"360810214003";52;33;236;99;77;497
"4654";"360810216001";11;12;69;2;44;138
"4655";"360810216002";72;4;116;18;15;225
"4656";"360810216003";40;9;70;23;20;162
"4657";"360810219001";1;11;223;295;17;547
"4658";"360810220011";11;0;71;2;13;97
"4659";"360810220012";81;8;161;24;9;283
"4660";"360810220013";96;31;122;7;10;266
"4661";"360810220014";10;9;5;0;1;25
"4662";"360810220021";5;4;122;5;9;145
"4663";"360810220022";106;3;103;13;17;242
"4664";"360810220023";111;12;124;5;16;268
"4665";"360810220024";92;13;74;6;30;215
"4666";"360810229001";1;1;36;38;7;83
"4667";"360810230001";40;8;73;22;12;155
"4668";"360810230002";40;3;51;6;30;130
"4669";"360810232001";11;2;26;3;4;46
"4670";"360810232002";27;7;159;3;28;224
"4671";"360810232003";36;9;215;42;46;348
"4672";"360810235001";74;28;71;17;58;248
"4673";"360810235002";60;67;44;11;14;196
"4674";"360810235003";35;28;115;8;9;195
"4675";"360810235004";61;90;88;7;50;296
"4676";"360810236001";27;11;82;18;24;162
"4677";"360810236002";55;17;27;3;28;130
"4678";"360810238001";505;4;42;4;21;576
"4679";"360810238002";24;9;30;8;25;96
"4680";"360810238003";134;6;31;1;13;185
"4681";"360810238004";19;6;40;3;12;80
"4682";"360810240001";45;40;52;8;26;171
"4683";"360810240002";218;27;87;5;56;393
"4684";"360810240003";58;19;13;1;19;110
"4685";"360810243001";14;59;72;109;34;288
"4686";"360810243002";15;2;75;96;37;225
"4687";"360810243003";54;12;148;77;32;323
"4688";"360810243004";45;8;158;114;60;385
"4689";"360810245001";3;1;23;2;8;37
"4690";"360810245002";49;3;82;15;26;175
"4691";"360810245003";2;7;27;1;5;42
"4692";"360810245004";55;3;118;9;13;198
"4693";"360810246001";1;5;56;3;28;93
"4694";"360810247001";22;5;126;4;40;197
"4695";"360810249001";44;36;152;4;22;258
"4696";"360810249002";38;7;37;2;16;100
"4697";"360810249003";30;20;104;2;25;181
"4698";"360810251001";17;21;50;5;31;124
"4699";"360810251002";28;4;65;6;15;118
"4700";"360810251003";159;68;378;4;34;643
"4701";"360810251004";50;47;25;3;22;147
"4702";"360810253011";51;36;40;6;11;144
"4703";"360810253012";77;8;45;1;20;151
"4704";"360810253013";47;7;18;2;28;102
"4705";"360810253014";65;42;34;0;12;153
"4706";"360810253021";24;4;5;0;7;40
"4707";"360810253022";97;45;106;11;35;294
"4708";"360810254001";95;26;125;59;68;373
"4709";"360810254002";22;14;87;22;38;183
"4710";"360810254003";110;36;45;21;24;236
"4711";"360810254004";52;8;56;14;26;156
"4712";"360810254005";91;18;337;198;65;709
"4713";"360810254006";49;23;98;71;43;284
"4714";"360810255001";42;20;355;145;75;637
"4715";"360810257001";63;74;321;65;51;574
"4716";"360810258001";83;19;69;71;28;270
"4717";"360810258002";28;1;39;24;24;116
"4718";"360810259001";52;31;261;25;40;409
"4719";"360810259002";230;29;136;6;75;476
"4720";"360810260001";107;23;44;18;30;222
"4721";"360810260002";41;11;104;91;39;286
"4722";"360810261001";7;13;71;10;25;126
"4723";"360810261002";139;9;210;0;33;391
"4724";"360810261003";63;104;37;8;45;257
"4725";"360810261004";51;51;182;12;26;322
"4726";"360810262001";34;11;93;81;55;274
"4727";"360810263001";43;75;162;20;30;330
"4728";"360810263002";72;71;160;12;49;364
"4729";"360810263003";42;10;156;0;21;229
"4730";"360810264001";80;11;30;41;34;196
"4731";"360810264002";60;7;63;75;53;258
"4732";"360810265001";42;87;279;19;47;474
"4733";"360810265002";36;9;155;9;33;242
"4734";"360810266001";56;14;70;43;34;217
"4735";"360810267001";63;12;53;8;26;162
"4736";"360810267002";23;62;79;1;133;298
"4737";"360810267003";66;18;373;4;78;539
"4738";"360810269011";26;40;25;1;28;120
"4739";"360810269012";39;4;11;0;5;59
"4740";"360810269013";40;3;39;4;6;92
"4741";"360810269014";23;17;90;2;20;152
"4742";"360810269021";72;29;83;0;40;224
"4743";"360810269022";56;9;87;0;39;191
"4744";"360810270001";77;26;187;214;106;610
"4745";"360810271001";103;212;240;0;7;562
"4746";"360810271002";113;11;35;1;16;176
"4747";"360810271003";69;8;145;1;14;237
"4748";"360810271004";35;3;34;0;37;109
"4749";"360810271005";47;1;27;0;27;102
"4750";"360810272001";56;0;53;37;40;186
"4751";"360810272002";24;6;87;18;21;156
"4752";"360810273001";9;14;22;1;2;48
"4753";"360810273002";97;21;32;5;23;178
"4754";"360810273003";144;103;31;2;23;303
"4755";"360810273004";42;19;66;11;31;169
"4756";"360810273005";70;105;157;3;20;355
"4757";"360810274001";60;13;109;40;35;257
"4758";"360810275001";20;9;20;8;0;57
"4759";"360810275002";169;29;160;11;36;405
"4760";"360810275003";183;22;296;7;47;555
"4761";"360810276001";83;25;107;82;31;328
"4762";"360810277001";3;3;17;4;2;29
"4763";"360810277002";94;17;79;10;37;237
"4764";"360810277003";98;8;29;2;13;150
"4765";"360810277004";33;6;27;13;22;101
"4766";"360810277005";232;11;97;5;46;391
"4767";"360810278001";225;51;31;14;24;345
"4768";"360810278002";92;5;7;0;8;112
"4769";"360810279001";55;21;162;12;21;271
"4770";"360810279002";155;29;140;6;25;355
"4771";"360810279003";68;45;18;2;10;143
"4772";"360810279004";13;24;21;2;1;61
"4773";"360810280001";131;14;69;52;39;305
"4774";"360810281001";130;58;103;4;22;317
"4775";"360810281002";148;14;73;6;7;248
"4776";"360810281003";21;41;29;3;11;105
"4777";"360810281004";44;23;22;4;17;110
"4778";"360810282001";53;34;111;42;49;289
"4779";"360810283001";27;21;19;1;3;71
"4780";"360810283002";77;6;10;3;5;101
"4781";"360810283003";32;55;31;3;24;145
"4782";"360810283004";25;27;12;2;18;84
"4783";"360810283005";136;23;10;0;12;181
"4784";"360810284001";70;5;141;92;43;351
"4785";"360810284002";64;9;44;39;35;191
"4786";"360810285001";11;17;14;3;4;49
"4787";"360810285002";11;18;14;1;2;46
"4788";"360810285003";31;36;74;4;11;156
"4789";"360810285004";130;45;76;3;12;266
"4790";"360810287001";79;14;35;3;13;144
"4791";"360810287002";25;25;49;3;5;107
"4792";"360810287003";117;60;111;10;27;325
"4793";"360810287004";102;83;59;2;9;255
"4794";"360810288001";35;5;40;40;22;142
"4795";"360810288002";35;12;53;42;25;167
"4796";"360810288003";42;4;31;65;34;176
"4797";"360810288004";36;6;61;61;47;211
"4798";"360810289001";130;18;57;0;9;214
"4799";"360810289002";50;9;98;3;14;174
"4800";"360810289003";105;60;98;9;51;323
"4801";"360810291001";25;8;105;4;18;160
"4802";"360810291002";73;9;111;5;23;221
"4803";"360810291003";72;31;44;4;14;165
"4804";"360810291004";25;48;94;4;25;196
"4805";"360810293001";12;9;227;42;39;329
"4806";"360810294001";28;6;74;44;27;179
"4807";"360810294002";52;12;107;27;33;231
"4808";"360810294003";40;7;106;42;18;213
"4809";"360810294004";42;3;22;21;24;112
"4810";"360810294005";29;18;33;44;31;155
"4811";"360810294006";17;7;89;78;22;213
"4812";"360810295001";22;5;199;47;6;279
"4813";"360810295002";55;1;536;172;27;791
"4814";"360810297001";24;87;315;140;38;604
"4815";"360810297002";54;14;397;129;40;634
"4816";"360810299001";0;0;7;12;13;32
"4817";"360810306001";20;6;154;61;27;268
"4818";"360810306002";39;16;81;74;19;229
"4819";"360810306003";100;21;115;77;38;351
"4820";"360810306004";16;28;77;37;30;188
"4821";"360810309021";28;4;64;21;13;130
"4822";"360810309022";43;2;175;12;31;263
"4823";"360810309023";53;5;162;16;24;260
"4824";"360810309024";34;6;163;4;19;226
"4825";"360810309025";29;0;436;15;16;496
"4826";"360810309031";88;47;279;10;55;479
"4827";"360810309032";92;15;222;19;33;381
"4828";"360810309033";57;25;192;12;43;329
"4829";"360810309041";68;22;252;45;39;426
"4830";"360810309042";32;9;123;4;32;200
"4831";"360810317001";73;25;245;30;33;406
"4832";"360810317002";11;7;102;10;10;140
"4833";"360810317003";33;12;184;30;15;274
"4834";"360810317004";37;3;88;25;39;192
"4835";"360810320001";25;9;64;65;23;186
"4836";"360810320002";2;7;68;34;15;126
"4837";"360810320003";79;16;193;117;95;500
"4838";"360810320004";24;4;38;83;23;172
"4839";"360810327001";45;20;195;15;40;315
"4840";"360810327002";111;129;88;4;39;371
"4841";"360810328001";35;7;30;45;32;149
"4842";"360810328002";46;18;34;37;30;165
"4843";"360810329001";36;8;67;64;27;202
"4844";"360810329002";19;8;96;27;26;176
"4845";"360810329003";31;19;153;20;32;255
"4846";"360810330001";77;24;102;97;54;354
"4847";"360810330002";11;2;30;26;17;86
"4848";"360810330003";35;5;57;45;100;242
"4849";"360810330004";25;3;78;42;18;166
"4850";"360810330005";14;2;66;39;28;149
"4851";"360810331001";2;5;32;9;6;54
"4852";"360810334011";54;11;78;78;54;275
"4853";"360810334012";102;16;176;199;60;553
"4854";"360810334021";7;1;9;2;1;20
"4855";"360810334022";8;4;6;0;0;18
"4856";"360810334023";3;8;5;0;1;17
"4857";"360810334024";12;14;1;0;3;30
"4858";"360810334025";14;43;18;8;8;91
"4859";"360810334026";46;19;132;127;19;343
"4860";"360810337001";55;3;173;22;61;314
"4861";"360810337002";35;50;143;7;49;284
"4862";"360810339001";26;24;52;10;31;143
"4863";"360810339002";47;6;7;0;7;67
"4864";"360810339003";29;39;113;5;11;197
"4865";"360810347001";71;12;205;73;27;388
"4866";"360810347002";58;7;207;27;29;328
"4867";"360810351001";69;3;72;18;24;186
"4868";"360810351002";82;27;152;18;24;303
"4869";"360810351003";36;64;111;19;27;257
"4870";"360810352001";26;13;109;57;23;228
"4871";"360810352002";37;5;39;77;26;184
"4872";"360810353001";39;15;113;22;28;217
"4873";"360810353002";99;7;131;6;27;270
"4874";"360810357001";72;7;432;25;23;559
"4875";"360810357002";148;25;378;26;36;613
"4876";"360810357003";100;19;237;20;30;406
"4877";"360810358001";42;9;38;30;17;136
"4878";"360810358002";68;12;71;77;21;249
"4879";"360810358003";30;4;32;59;20;145
"4880";"360810358004";4;0;5;28;31;68
"4881";"360810361001";203;24;116;32;70;445
"4882";"360810361002";94;10;119;23;18;264
"4883";"360810363001";102;10;108;35;25;280
"4884";"360810363002";63;13;144;16;26;262
"4885";"360810365001";90;15;226;24;44;399
"4886";"360810365002";81;17;271;43;48;460
"4887";"360810366001";23;26;115;103;70;337
"4888";"360810366002";32;60;90;75;35;292
"4889";"360810367001";25;5;43;18;14;105
"4890";"360810367002";76;12;225;79;62;454
"4891";"360810368001";24;10;47;33;12;126
"4892";"360810368002";46;7;61;31;25;170
"4893";"360810371001";39;7;345;37;47;475
"4894";"360810373001";47;13;191;58;20;329
"4895";"360810373002";425;190;322;46;45;1028
"4896";"360810375001";85;21;180;25;28;339
"4897";"360810375002";70;174;184;8;24;460
"4898";"360810376001";16;13;37;33;42;141
"4899";"360810376002";56;12;44;37;37;186
"4900";"360810376003";16;5;18;14;8;61
"4901";"360810376004";25;3;44;49;14;135
"4902";"360810376005";24;4;56;39;14;137
"4903";"360810377001";88;39;388;16;57;588
"4904";"360810377002";86;7;171;25;21;310
"4905";"360810379001";150;27;548;25;58;808
"4906";"360810379002";88;40;423;34;17;602
"4907";"360810379003";56;11;193;30;34;324
"4908";"360810381001";136;38;316;20;42;552
"4909";"360810381002";157;7;337;59;42;602
"4910";"360810381003";68;56;243;46;35;448
"4911";"360810383011";174;173;38;96;15;496
"4912";"360810383021";75;699;201;51;72;1098
"4913";"360810384001";38;4;55;28;32;157
"4914";"360810384002";27;9;95;68;52;251
"4915";"360810394001";30;7;60;51;31;179
"4916";"360810394002";32;13;38;38;27;148
"4917";"360810394003";20;3;33;26;16;98
"4918";"360810398001";25;9;34;21;22;111
"4919";"360810398002";8;11;30;6;6;61
"4920";"360810399001";41;10;214;22;20;307
"4921";"360810399002";62;5;125;17;21;230
"4922";"360810399003";75;8;130;47;10;270
"4923";"360810400001";8;2;68;19;16;113
"4924";"360810400002";13;4;16;49;15;97
"4925";"360810401001";245;17;339;62;33;696
"4926";"360810401002";73;97;173;43;39;425
"4927";"360810401003";55;12;204;24;32;327
"4928";"360810402001";24;4;21;32;20;101
"4929";"360810402002";26;8;19;47;24;124
"4930";"360810403001";168;66;422;26;61;743
"4931";"360810403002";40;15;142;16;39;252
"4932";"360810403003";49;2;148;7;31;237
"4933";"360810404001";33;3;26;16;13;91
"4934";"360810404002";46;6;29;67;25;173
"4935";"360810404003";33;36;31;27;22;149
"4936";"360810404004";49;4;60;39;22;174
"4937";"360810405001";57;64;81;19;24;245
"4938";"360810405002";28;53;131;12;59;283
"4939";"360810407001";53;10;196;25;18;302
"4940";"360810407002";54;14;57;23;49;197
"4941";"360810407003";32;7;89;9;18;155
"4942";"360810407004";102;8;208;11;7;336
"4943";"360810407005";16;40;37;4;6;103
"4944";"360810409001";86;25;198;29;17;355
"4945";"360810409002";58;4;85;23;10;180
"4946";"360810409003";28;9;122;6;4;169
"4947";"360810409004";23;25;93;4;25;170
"4948";"360810411001";126;19;132;27;14;318
"4949";"360810411002";100;6;148;31;21;306
"4950";"360810413001";101;26;302;29;39;497
"4951";"360810413002";45;46;266;13;24;394
"4952";"360810414001";141;18;110;139;47;455
"4953";"360810414002";50;21;4;18;14;107
"4954";"360810414003";48;6;70;81;37;242
"4955";"360810415001";77;32;249;49;48;455
"4956";"360810415002";54;28;133;27;26;268
"4957";"360810424001";63;23;70;80;27;263
"4958";"360810424002";24;3;11;15;14;67
"4959";"360810424003";18;7;15;16;5;61
"4960";"360810426001";26;18;12;8;8;72
"4961";"360810427001";80;21;261;22;28;412
"4962";"360810427002";112;51;409;24;52;648
"4963";"360810432001";27;29;45;66;44;211
"4964";"360810434001";57;12;78;59;41;247
"4965";"360810437011";62;18;169;14;26;289
"4966";"360810437012";27;8;86;25;17;163
"4967";"360810437021";221;23;97;20;10;371
"4968";"360810437022";141;13;520;32;17;723
"4969";"360810437023";166;12;261;27;27;493
"4970";"360810439001";74;18;325;33;27;477
"4971";"360810439002";141;46;401;26;39;653
"4972";"360810440001";56;18;239;161;85;559
"4973";"360810440002";73;9;100;91;38;311
"4974";"360810440003";91;12;117;90;39;349
"4975";"360810443011";59;10;168;8;12;257
"4976";"360810443012";57;22;142;16;19;256
"4977";"360810443021";95;11;210;14;19;349
"4978";"360810443022";71;13;160;22;16;282
"4979";"360810443023";133;219;179;23;42;596
"4980";"360810444001";59;20;166;8;46;299
"4981";"360810444002";30;266;245;27;53;621
"4982";"360810444003";77;11;155;89;148;480
"4983";"360810446011";32;36;27;3;64;162
"4984";"360810446012";75;46;32;3;41;197
"4985";"360810446021";35;27;63;16;74;215
"4986";"360810446022";79;34;30;3;32;178
"4987";"360810448001";81;48;117;18;178;442
"4988";"360810448002";12;1;64;7;9;93
"4989";"360810450001";29;7;93;26;36;191
"4990";"360810450002";12;13;74;16;34;149
"4991";"360810452001";33;16;59;8;27;143
"4992";"360810454001";70;15;180;9;27;301
"4993";"360810454002";56;6;117;14;49;242
"4994";"360810455001";102;13;7;0;5;127
"4995";"360810455002";12;16;2;0;5;35
"4996";"360810455003";45;9;22;4;2;82
"4997";"360810455004";41;1;6;0;3;51
"4998";"360810455005";9;1;10;0;4;24
"4999";"360810455006";0;0;9;1;2;12
"5000";"360810456001";31;2;74;13;29;149
"5001";"360810457001";71;6;179;10;28;294
"5002";"360810457002";30;13;205;0;19;267
"5003";"360810458001";130;85;249;12;50;526
"5004";"360810459001";46;2;195;16;24;283
"5005";"360810459002";60;3;111;8;15;197
"5006";"360810460001";50;7;41;1;38;137
"5007";"360810460002";135;9;31;6;42;223
"5008";"360810460003";57;18;30;4;15;124
"5009";"360810461001";85;35;309;6;26;461
"5010";"360810462001";80;17;96;8;56;257
"5011";"360810462002";93;178;156;7;87;521
"5012";"360810462003";154;109;243;8;86;600
"5013";"360810463001";63;11;260;2;21;357
"5014";"360810463002";79;28;245;11;28;391
"5015";"360810464001";34;10;111;3;12;170
"5016";"360810465001";138;40;149;36;26;389
"5017";"360810465002";71;15;112;4;37;239
"5018";"360810466001";53;44;131;2;21;251
"5019";"360810466002";10;10;121;0;25;166
"5020";"360810467001";108;9;98;2;20;237
"5021";"360810467002";92;7;422;3;27;551
"5022";"360810467003";64;12;157;1;18;252
"5023";"360810467004";99;9;29;0;19;156
"5024";"360810468001";47;16;78;0;57;198
"5025";"360810468002";141;27;224;51;67;510
"5026";"360810469001";128;49;104;11;39;331
"5027";"360810469002";178;12;60;1;15;266
"5028";"360810469003";16;3;80;0;8;107
"5029";"360810469004";23;4;12;3;12;54
"5030";"360810469005";49;3;22;0;10;84
"5031";"360810470001";48;18;97;6;36;205
"5032";"360810470002";179;42;115;31;69;436
"5033";"360810471001";87;80;90;8;45;310
"5034";"360810471002";97;11;107;2;23;240
"5035";"360810472001";68;4;72;1;15;160
"5036";"360810472002";23;2;94;32;33;184
"5037";"360810472003";33;13;4;2;8;60
"5038";"360810473001";24;7;187;0;11;229
"5039";"360810473002";21;18;116;10;92;257
"5040";"360810473003";12;6;22;0;6;46
"5041";"360810475001";62;13;179;7;34;295
"5042";"360810475002";104;11;305;18;29;467
"5043";"360810476001";12;1;8;10;128;159
"5044";"360810476002";17;2;14;10;9;52
"5045";"360810478001";53;6;57;23;25;164
"5046";"360810478002";57;7;77;91;23;255
"5047";"360810478003";102;12;103;18;37;272
"5048";"360810479001";104;9;151;22;40;326
"5049";"360810479002";7;19;73;22;50;171
"5050";"360810479003";45;11;163;14;28;261
"5051";"360810480001";131;14;137;52;32;366
"5052";"360810480002";36;2;64;33;21;156
"5053";"360810481001";49;4;124;2;21;200
"5054";"360810481002";70;0;126;4;14;214
"5055";"360810481003";169;8;44;4;16;241
"5056";"360810481004";45;20;18;1;147;231
"5057";"360810482001";91;12;128;77;60;368
"5058";"360810483001";34;12;169;4;34;253
"5059";"360810483002";63;12;263;36;35;409
"5060";"360810484001";83;14;65;43;53;258
"5061";"360810484002";96;19;110;67;45;337
"5062";"360810484003";37;6;72;19;38;172
"5063";"360810484004";62;31;101;42;18;254
"5064";"360810485001";7;11;76;6;7;107
"5065";"360810485002";22;5;69;25;18;139
"5066";"360810485003";50;49;239;25;58;421
"5067";"360810489001";22;14;284;164;68;552
"5068";"360810489002";9;3;80;36;25;153
"5069";"360810492001";344;24;163;44;18;593
"5070";"360810492002";14;2;18;12;22;68
"5071";"360810492003";120;9;98;40;50;317
"5072";"360810493011";35;7;328;91;51;512
"5073";"360810493012";34;0;213;77;27;351
"5074";"360810493021";42;39;156;23;52;312
"5075";"360810493022";9;5;244;93;45;396
"5076";"360810495001";16;3;258;34;33;344
"5077";"360810496001";68;4;51;23;38;184
"5078";"360810496002";73;11;73;74;47;278
"5079";"360810496003";25;10;81;54;37;207
"5080";"360810497001";66;7;160;48;19;300
"5081";"360810497002";6;10;132;65;22;235
"5082";"360810499001";19;11;105;55;33;223
"5083";"360810499002";33;5;189;29;41;297
"5084";"360810499003";32;3;213;56;53;357
"5085";"360810500001";79;25;83;38;40;265
"5086";"360810500002";158;17;128;58;44;405
"5087";"360810502011";70;10;60;66;26;232
"5088";"360810502021";107;7;47;23;26;210
"5089";"360810504001";62;3;39;44;20;168
"5090";"360810504002";17;5;18;16;28;84
"5091";"360810505001";50;3;186;34;16;289
"5092";"360810506001";27;16;24;56;14;137
"5093";"360810506002";28;9;12;22;12;83
"5094";"360810507001";54;5;234;85;41;419
"5095";"360810507002";23;5;124;53;23;228
"5096";"360810508001";47;21;42;67;28;205
"5097";"360810508002";55;132;50;43;29;309
"5098";"360810510001";17;5;13;36;18;89
"5099";"360810510002";14;6;17;25;25;87
"5100";"360810511001";11;10;233;56;28;338
"5101";"360810511002";2;5;224;43;18;292
"5102";"360810512001";5;2;76;33;20;136
"5103";"360810512002";34;8;30;27;15;114
"5104";"360810512003";13;5;50;42;14;124
"5105";"360810513001";71;3;263;53;37;427
"5106";"360810513002";28;5;215;47;16;311
"5107";"360810515001";11;13;205;41;28;298
"5108";"360810515002";45;8;153;13;7;226
"5109";"360810515003";12;5;185;99;25;326
"5110";"360810516001";23;2;52;37;13;127
"5111";"360810516002";16;8;41;35;19;119
"5112";"360810517001";23;4;158;29;37;251
"5113";"360810517002";47;6;203;78;26;360
"5114";"360810518001";90;22;23;15;15;165
"5115";"360810518002";11;3;34;40;27;115
"5116";"360810520001";49;24;72;46;28;219
"5117";"360810521001";9;10;72;19;12;122
"5118";"360810521002";13;18;240;74;48;393
"5119";"360810522001";53;10;55;47;18;183
"5120";"360810524001";45;2;21;12;13;93
"5121";"360810524002";25;3;55;29;50;162
"5122";"360810525001";11;2;290;90;50;443
"5123";"360810525002";20;18;201;134;23;396
"5124";"360810526001";18;6;60;30;25;139
"5125";"360810526002";11;10;45;30;37;133
"5126";"360810528001";118;24;71;32;23;268
"5127";"360810530001";10;6;38;19;14;87
"5128";"360810530002";30;4;31;37;13;115
"5129";"360810531001";28;13;333;205;49;628
"5130";"360810531002";19;2;168;26;13;228
"5131";"360810531003";11;20;134;86;25;276
"5132";"360810532001";29;8;86;31;9;163
"5133";"360810532002";24;11;35;27;21;118
"5134";"360810534011";37;16;25;30;20;128
"5135";"360810534012";20;2;24;20;18;84
"5136";"360810535001";18;27;251;105;58;459
"5137";"360810536011";12;6;40;36;23;117
"5138";"360810536012";8;3;22;34;7;74
"5139";"360810538001";28;1;15;42;20;106
"5140";"360810538002";40;7;13;44;17;121
"5141";"360810539001";113;37;223;139;25;537
"5142";"360810539002";47;29;106;24;25;231
"5143";"360810539003";219;55;142;14;34;464
"5144";"360810540001";84;8;113;116;62;383
"5145";"360810540002";61;7;83;153;34;338
"5146";"360810540003";41;5;51;36;25;158
"5147";"360810542001";60;15;53;35;33;196
"5148";"360810542002";105;11;100;65;89;370
"5149";"360810542003";75;14;104;50;97;340
"5150";"360810542004";47;13;66;32;60;218
"5151";"360810545001";99;37;186;10;36;368
"5152";"360810545002";59;43;77;2;8;189
"5153";"360810545003";76;100;52;2;23;253
"5154";"360810547001";110;256;74;0;22;462
"5155";"360810547002";120;37;67;7;14;245
"5156";"360810547003";80;30;54;2;22;188
"5157";"360810548001";119;12;40;37;56;264
"5158";"360810548002";20;0;54;21;31;126
"5159";"360810549001";53;30;105;12;17;217
"5160";"360810549002";88;13;77;5;27;210
"5161";"360810549003";91;49;46;3;21;210
"5162";"360810549004";383;53;14;4;25;479
"5163";"360810551001";48;31;93;4;22;198
"5164";"360810551002";31;20;18;0;17;86
"5165";"360810551003";37;23;22;3;43;128
"5166";"360810551004";72;27;38;7;6;150
"5167";"360810552001";73;5;32;28;26;164
"5168";"360810552002";97;11;102;51;82;343
"5169";"360810553001";23;72;194;10;18;317
"5170";"360810553002";139;91;38;4;27;299
"5171";"360810554001";21;1;73;19;27;141
"5172";"360810554002";31;11;57;27;29;155
"5173";"360810555001";21;21;99;11;10;162
"5174";"360810555002";63;61;120;25;24;293
"5175";"360810556001";50;14;143;25;49;281
"5176";"360810556002";24;1;16;14;17;72
"5177";"360810557001";81;21;112;12;42;268
"5178";"360810557002";41;314;191;13;21;580
"5179";"360810557003";38;10;21;5;12;86
"5180";"360810558001";41;4;38;17;36;136
"5181";"360810558002";52;8;41;59;37;197
"5182";"360810559001";71;58;189;65;60;443
"5183";"360810560001";6;0;31;12;10;59
"5184";"360810560002";26;0;14;8;20;68
"5185";"360810561001";3;109;77;25;14;228
"5186";"360810562001";56;12;101;13;35;217
"5187";"360810564001";49;4;46;23;21;143
"5188";"360810565001";218;103;316;144;30;811
"5189";"360810566001";39;6;21;10;17;93
"5190";"360810566002";36;2;53;15;46;152
"5191";"360810567001";25;2;324;125;20;496
"5192";"360810567002";48;12;704;160;206;1130
"5193";"360810567003";65;27;331;57;41;521
"5194";"360810567004";74;16;189;30;39;348
"5195";"360810568001";35;9;110;44;45;243
"5196";"360810568002";34;8;26;68;26;162
"5197";"360810568003";8;6;16;32;24;86
"5198";"360810568004";48;27;126;87;44;332
"5199";"360810577001";36;9;90;4;21;160
"5200";"360810577002";65;22;464;21;19;591
"5201";"360810577003";12;8;254;14;14;302
"5202";"360810579001";34;150;73;23;9;289
"5203";"360810579002";47;6;91;21;13;178
"5204";"360810580001";22;3;14;18;8;65
"5205";"360810580002";41;16;18;34;15;124
"5206";"360810580003";59;6;39;70;24;198
"5207";"360810580004";14;4;19;32;16;85
"5208";"360810581001";26;3;218;18;19;284
"5209";"360810581002";26;103;262;3;16;410
"5210";"360810582001";14;10;157;66;33;280
"5211";"360810582002";36;6;101;73;33;249
"5212";"360810582003";8;6;63;33;14;124
"5213";"360810583001";44;69;42;3;48;206
"5214";"360810583002";88;21;166;4;32;311
"5215";"360810583003";7;12;82;6;11;118
"5216";"360810585001";24;8;90;5;56;183
"5217";"360810585002";14;10;151;22;20;217
"5218";"360810585003";57;58;94;18;32;259
"5219";"360810587001";39;8;265;4;21;337
"5220";"360810587002";10;8;89;0;9;116
"5221";"360810587003";22;13;65;1;20;121
"5222";"360810589001";72;18;137;5;23;255
"5223";"360810589002";43;38;59;15;17;172
"5224";"360810589003";66;98;106;17;17;304
"5225";"360810590001";21;5;10;44;21;101
"5226";"360810591001";49;21;162;20;17;269
"5227";"360810591002";37;23;187;9;27;283
"5228";"360810591003";73;16;336;6;24;455
"5229";"360810591004";41;9;338;2;12;402
"5230";"360810592001";22;3;39;106;27;197
"5231";"360810593001";337;10;151;11;15;524
"5232";"360810593002";38;24;283;11;38;394
"5233";"360810594001";1;3;19;31;6;60
"5234";"360810594002";16;1;6;16;6;45
"5235";"360810595001";87;25;193;89;29;423
"5236";"360810595002";48;14;111;7;15;195
"5237";"360810595003";15;14;98;38;20;185
"5238";"360810595004";64;64;168;23;43;362
"5239";"360810596001";6;1;19;43;9;78
"5240";"360810596002";5;1;12;38;10;66
"5241";"360810598001";26;5;29;18;10;88
"5242";"360810598002";18;9;38;26;10;101
"5243";"360810599001";11;1;156;36;24;228
"5244";"360810599002";40;154;118;65;26;403
"5245";"360810600001";29;11;34;35;16;125
"5246";"360810601001";38;10;179;71;46;344
"5247";"360810601002";93;219;163;60;45;580
"5248";"360810603001";29;7;300;99;36;471
"5249";"360810606001";18;4;51;35;11;119
"5250";"360810606002";13;2;16;27;9;67
"5251";"360810607011";3;3;130;43;9;188
"5252";"360810608001";35;191;56;76;13;371
"5253";"360810610001";20;9;85;71;9;194
"5254";"360810612001";4;4;26;26;6;66
"5255";"360810612002";12;2;52;37;16;119
"5256";"360810613011";68;18;290;39;44;459
"5257";"360810613012";41;43;662;58;49;853
"5258";"360810613013";18;9;164;9;26;226
"5259";"360810613014";24;27;83;9;17;160
"5260";"360810613021";0;0;9;3;2;14
"5261";"360810614001";13;3;19;11;17;63
"5262";"360810616011";1;1;12;10;5;29
"5263";"360810616012";2;1;4;27;10;44
"5264";"360810616013";4;1;10;15;17;47
"5265";"360810616021";6;0;18;27;7;58
"5266";"360810616022";10;2;18;34;10;74
"5267";"360810618001";12;0;4;10;5;31
"5268";"360810618002";17;14;36;22;13;102
"5269";"360810619001";63;38;359;86;46;592
"5270";"360810619002";15;4;128;28;12;187
"5271";"360810620001";25;4;27;56;24;136
"5272";"360810621001";62;12;138;18;30;260
"5273";"360810621002";27;1;74;49;16;167
"5274";"360810621003";39;6;144;16;25;230
"5275";"360810622001";8;21;55;46;5;135
"5276";"360810622002";10;8;28;37;13;96
"5277";"360810623001";30;4;129;56;18;237
"5278";"360810623002";27;8;361;88;9;493
"5279";"360810624001";1;0;5;2;0;8
"5280";"360810625001";16;20;165;6;21;228
"5281";"360810625002";106;27;338;24;45;540
"5282";"360810626001";8;7;29;38;7;89
"5283";"360810626002";14;17;36;32;17;116
"5284";"360810626003";10;2;8;23;10;53
"5285";"360810627001";62;3;284;22;28;399
"5286";"360810627002";41;7;201;2;30;281
"5287";"360810629001";20;5;309;38;31;403
"5288";"360810629002";29;16;54;10;7;116
"5289";"360810629003";26;25;163;12;15;241
"5290";"360810630001";7;13;38;35;13;106
"5291";"360810630002";13;0;34;39;5;91
"5292";"360810632001";5;0;19;18;11;53
"5293";"360810632002";25;29;89;53;26;222
"5294";"360810633011";26;7;264;145;22;464
"5295";"360810633021";2;5;100;51;16;174
"5296";"360810633022";14;3;215;35;22;289
"5297";"360810635001";18;3;86;39;13;159
"5298";"360810635002";20;2;178;60;16;276
"5299";"360810637001";7;9;115;67;29;227
"5300";"360810637002";12;11;179;99;38;339
"5301";"360810637003";19;14;76;43;20;172
"5302";"360810638001";29;13;52;33;6;133
"5303";"360810638002";25;19;50;23;16;133
"5304";"360810638003";15;2;29;37;7;90
"5305";"360810638004";8;0;16;58;25;107
"5306";"360810638005";13;11;36;27;14;101
"5307";"360810639001";15;2;207;69;31;324
"5308";"360810639002";76;16;452;29;27;600
"5309";"360810641011";22;11;102;35;3;173
"5310";"360810641021";28;43;270;74;30;445
"5311";"360810645001";4;2;34;54;15;109
"5312";"360810645002";16;13;104;37;29;199
"5313";"360810646001";12;2;44;48;9;115
"5314";"360810646002";17;4;51;50;15;137
"5315";"360810650001";15;4;39;35;14;107
"5316";"360810650002";24;2;53;57;42;178
"5317";"360810654001";13;13;48;72;23;169
"5318";"360810654002";63;12;51;31;25;182
"5319";"360810654003";16;7;19;44;9;95
"5320";"360810655011";1;60;46;11;5;123
"5321";"360810656001";42;26;110;37;32;247
"5322";"360810656002";25;1;14;21;16;77
"5323";"360810656003";104;5;117;66;18;310
"5324";"360810657021";40;26;215;30;40;351
"5325";"360810657031";12;12;274;40;33;371
"5326";"360810657032";26;6;71;17;19;139
"5327";"360810657033";12;4;125;81;32;254
"5328";"360810659001";6;3;53;44;37;143
"5329";"360810659002";8;12;168;37;20;245
"5330";"360810660001";67;6;74;26;28;201
"5331";"360810660002";60;6;43;72;25;206
"5332";"360810661001";25;4;88;33;16;166
"5333";"360810663001";7;2;106;31;12;158
"5334";"360810663002";1;6;89;35;27;158
"5335";"360810663003";1;9;68;39;28;145
"5336";"360810664001";17;2;25;15;7;66
"5337";"360810664002";24;4;46;72;19;165
"5338";"360810664003";38;8;43;24;24;137
"5339";"360810664004";55;5;24;27;30;141
"5340";"360810664005";26;3;42;38;13;122
"5341";"360810664006";39;6;40;39;9;133
"5342";"360810664007";54;4;83;43;14;198
"5343";"360810664008";29;2;86;46;19;182
"5344";"360810665011";3;8;70;36;7;124
"5345";"360810665012";2;2;75;18;6;103
"5346";"360810665013";12;3;93;28;17;153
"5347";"360810665014";36;2;37;10;11;96
"5348";"360810667011";53;5;231;75;45;409
"5349";"360810667012";2;1;153;31;15;202
"5350";"360810669001";27;3;173;24;34;261
"5351";"360810669002";7;4;282;37;45;375
"5352";"360810671001";4;6;87;27;32;156
"5353";"360810671002";1;5;94;81;25;206
"5354";"360810677001";1;3;63;41;9;117
"5355";"360810677002";7;4;79;23;11;124
"5356";"360810679001";3;1;108;31;5;148
"5357";"360810679002";133;9;106;10;21;279
"5358";"360810679003";41;48;538;58;21;706
"5359";"360810680001";33;11;51;38;26;159
"5360";"360810680002";32;5;41;110;42;230
"5361";"360810680003";34;13;60;59;36;202
"5362";"360810680004";30;2;107;34;11;184
"5363";"360810682001";3;0;30;27;19;79
"5364";"360810682002";16;1;29;26;14;86
"5365";"360810683001";133;9;39;5;18;204
"5366";"360810683002";34;17;82;7;49;189
"5367";"360810683003";36;5;47;8;33;129
"5368";"360810687001";10;7;9;3;9;38
"5369";"360810687002";32;16;134;6;8;196
"5370";"360810687003";183;7;391;28;42;651
"5371";"360810690001";29;7;71;76;21;204
"5372";"360810690002";128;7;82;114;28;359
"5373";"360810693001";226;18;482;0;37;763
"5374";"360810693002";25;10;87;10;21;153
"5375";"360810694001";29;10;77;72;28;216
"5376";"360810694002";113;74;162;52;21;422
"5377";"360810695001";65;4;147;18;18;252
"5378";"360810695002";20;8;126;9;14;177
"5379";"360810697011";55;11;30;4;9;109
"5380";"360810697012";40;1;198;3;21;263
"5381";"360810697013";24;9;71;3;11;118
"5382";"360810697021";9;2;24;18;11;64
"5383";"360810697022";6;1;36;49;7;99
"5384";"360810697023";23;2;67;43;7;142
"5385";"360810697024";13;4;37;13;12;79
"5386";"360810703001";14;7;52;48;25;146
"5387";"360810703002";12;11;238;53;34;348
"5388";"360810707001";3;1;16;3;14;37
"5389";"360810707002";6;3;24;1;10;44
"5390";"360810707003";11;1;50;9;12;83
"5391";"360810709001";7;3;125;3;11;149
"5392";"360810709002";14;28;38;8;8;96
"5393";"360810711001";9;9;76;5;7;106
"5394";"360810711002";127;37;183;2;47;396
"5395";"360810711003";13;10;65;1;4;93
"5396";"360810711004";23;52;76;4;128;283
"5397";"360810713031";52;7;53;1;4;117
"5398";"360810713032";102;19;48;1;35;205
"5399";"360810713033";92;16;52;0;8;168
"5400";"360810713041";25;1;35;1;8;70
"5401";"360810713042";9;8;25;0;5;47
"5402";"360810713043";11;1;2;0;1;15
"5403";"360810713044";49;6;51;0;8;114
"5404";"360810713051";32;14;14;0;10;70
"5405";"360810713052";16;13;33;1;6;69
"5406";"360810713053";64;17;147;3;19;250
"5407";"360810713061";186;9;90;3;5;293
"5408";"360810713062";71;11;134;11;17;244
"5409";"360810713063";36;11;48;0;22;117
"5410";"360810713064";33;13;44;6;33;129
"5411";"360810716001";0;1;41;4;15;61
"5412";"360810717011";40;18;9;0;7;74
"5413";"360810717012";28;21;90;0;7;146
"5414";"360810717013";3;4;14;0;2;23
"5415";"360810717014";25;16;49;2;5;97
"5416";"360810717021";16;18;137;3;33;207
"5417";"360810717022";3;1;68;1;2;75
"5418";"360810719001";78;5;129;5;12;229
"5419";"360810719002";84;11;277;4;34;410
"5420";"360810721001";16;10;39;3;1;69
"5421";"360810721002";19;5;21;3;4;52
"5422";"360810721003";111;8;77;1;10;207
"5423";"360810721004";9;7;130;1;1;148
"5424";"360810721005";41;11;165;0;13;230
"5425";"360810723001";3;14;12;8;3;40
"5426";"360810723002";3;3;50;9;9;74
"5427";"360810723003";3;4;25;1;10;43
"5428";"360810729001";33;6;37;5;9;90
"5429";"360810729002";18;7;163;12;28;228
"5430";"360810731001";11;40;14;1;18;84
"5431";"360810731002";22;149;45;9;10;235
"5432";"360810737001";16;149;36;0;59;260
"5433";"360810737002";1;11;8;3;6;29
"5434";"360810739001";6;1;34;0;2;43
"5435";"360810739002";23;7;26;1;3;60
"5436";"360810739003";9;15;27;1;14;66
"5437";"360810739004";9;6;24;6;9;54
"5438";"360810739005";21;15;4;1;4;45
"5439";"360810741001";3;2;16;0;2;23
"5440";"360810741002";35;6;48;5;8;102
"5441";"360810741003";2;3;10;1;3;19
"5442";"360810741004";2;4;21;9;3;39
"5443";"360810743001";5;0;27;1;12;45
"5444";"360810743002";8;2;78;2;12;102
"5445";"360810743003";62;7;54;2;5;130
"5446";"360810743004";39;11;22;1;8;81
"5447";"360810745001";68;5;54;6;14;147
"5448";"360810745002";43;14;86;0;11;154
"5449";"360810747001";106;23;100;25;24;278
"5450";"360810747002";23;9;33;4;7;76
"5451";"360810749001";5;0;6;1;0;12
"5452";"360810749002";6;1;11;5;4;27
"5453";"360810757011";61;95;126;0;41;323
"5454";"360810757012";9;9;25;1;9;53
"5455";"360810757013";18;14;53;0;32;117
"5456";"360810757021";83;5;53;9;8;158
"5457";"360810757022";3;10;124;14;19;170
"5458";"360810757023";11;9;14;1;1;36
"5459";"360810769011";28;24;13;3;9;77
"5460";"360810769012";151;30;49;2;15;247
"5461";"360810769021";35;28;137;10;36;246
"5462";"360810773001";21;47;75;3;4;150
"5463";"360810773002";57;8;39;2;23;129
"5464";"360810775001";54;7;78;14;21;174
"5465";"360810775002";36;2;98;5;17;158
"5466";"360810775003";22;227;78;4;35;366
"5467";"360810779021";1;2;36;4;8;51
"5468";"360810779022";0;5;50;11;13;79
"5469";"360810779023";5;6;43;19;4;77
"5470";"360810779024";8;7;9;1;2;27
"5471";"360810779025";6;1;41;2;19;69
"5472";"360810779031";7;1;17;2;3;30
"5473";"360810779032";14;1;10;0;0;25
"5474";"360810779033";25;5;37;5;4;76
"5475";"360810779041";6;0;11;18;19;54
"5476";"360810779042";46;7;109;6;35;203
"5477";"360810779043";38;16;72;4;17;147
"5478";"360810779044";17;5;58;4;11;95
"5479";"360810779051";13;40;56;38;17;164
"5480";"360810779052";1;1;13;0;0;15
"5481";"360810779061";35;15;38;10;13;111
"5482";"360810779062";44;11;162;79;50;346
"5483";"360810779071";34;8;101;29;20;192
"5484";"360810779072";24;4;67;6;13;114
"5485";"360810779081";20;9;29;4;8;70
"5486";"360810779082";136;19;47;7;9;218
"5487";"360810788001";91;12;51;55;33;242
"5488";"360810788002";21;2;23;29;18;93
"5489";"360810790001";39;10;63;78;46;236
"5490";"360810790002";75;17;135;111;57;395
"5491";"360810792001";136;14;70;76;18;314
"5492";"360810792002";55;3;105;69;51;283
"5493";"360810793001";0;0;1;2;7;10
"5494";"360810797011";19;2;8;1;3;33
"5495";"360810797012";43;5;1;0;12;61
"5496";"360810797013";5;1;3;0;9;18
"5497";"360810797014";6;3;15;1;21;46
"5498";"360810797021";9;18;288;13;26;354
"5499";"360810797022";44;1;112;7;29;193
"5500";"360810797023";18;0;10;0;4;32
"5501";"360810799001";44;30;411;24;77;586
"5502";"360810799002";37;14;493;9;42;595
"5503";"360810803011";22;8;96;11;32;169
"5504";"360810803012";31;2;232;9;25;299
"5505";"360810803013";29;9;154;17;30;239
"5506";"360810803021";19;1;91;38;24;173
"5507";"360810803022";8;2;72;37;43;162
"5508";"360810803023";7;3;77;29;30;146
"5509";"360810809001";46;9;34;3;3;95
"5510";"360810809002";22;3;100;6;0;131
"5511";"360810809003";6;0;49;2;12;69
"5512";"360810809004";22;16;128;34;40;240
"5513";"360810809005";6;1;39;7;6;59
"5514";"360810809006";6;2;15;23;1;47
"5515";"360810809007";9;17;88;59;6;179
"5516";"360810814001";73;10;155;70;47;355
"5517";"360810814002";33;19;53;43;36;184
"5518";"360810814003";82;4;46;68;36;236
"5519";"360810818001";111;103;96;76;76;462
"5520";"360810818002";77;9;54;53;59;252
"5521";"360810818003";78;13;97;55;51;294
"5522";"360810837001";19;24;120;32;34;229
"5523";"360810837002";12;1;157;55;76;301
"5524";"360810837003";6;2;107;25;25;165
"5525";"360810837004";30;14;101;25;33;203
"5526";"360810838001";43;13;89;120;46;311
"5527";"360810838002";61;16;83;45;59;264
"5528";"360810838003";48;13;106;39;59;265
"5529";"360810838004";54;13;153;38;50;308
"5530";"360810840001";142;73;131;103;66;515
"5531";"360810840002";159;82;128;43;74;486
"5532";"360810840003";59;26;118;24;54;281
"5533";"360810840004";63;12;129;22;35;261
"5534";"360810840005";154;6;96;21;46;323
"5535";"360810845001";25;0;5;0;1;31
"5536";"360810845002";229;10;10;0;14;263
"5537";"360810845003";11;10;286;7;58;372
"5538";"360810846011";91;8;188;93;49;429
"5539";"360810846012";69;5;157;55;34;320
"5540";"360810846021";30;12;238;206;24;510
"5541";"360810849001";102;10;114;4;61;291
"5542";"360810849002";26;4;77;1;25;133
"5543";"360810849003";56;4;215;11;51;337
"5544";"360810849004";2;17;216;16;66;317
"5545";"360810853001";9;25;42;2;71;149
"5546";"360810853002";8;10;22;0;30;70
"5547";"360810853003";7;15;91;0;7;120
"5548";"360810853004";9;3;18;1;21;52
"5549";"360810855001";52;26;12;0;16;106
"5550";"360810855002";44;24;28;1;13;110
"5551";"360810855003";21;26;96;0;7;150
"5552";"360810855004";46;33;125;0;11;215
"5553";"360810857001";34;24;36;1;17;112
"5554";"360810857002";51;3;75;3;8;140
"5555";"360810857003";67;5;40;0;31;143
"5556";"360810859001";34;9;33;0;40;116
"5557";"360810859002";37;10;125;1;148;321
"5558";"360810859003";18;16;82;0;15;131
"5559";"360810861001";35;1;31;0;14;81
"5560";"360810861002";15;6;69;2;77;169
"5561";"360810863001";18;1;16;0;13;48
"5562";"360810863002";30;4;48;1;3;86
"5563";"360810863003";132;2;5;0;21;160
"5564";"360810863004";60;3;114;0;139;316
"5565";"360810864001";62;76;281;33;64;516
"5566";"360810864002";52;25;74;41;34;226
"5567";"360810865001";61;20;81;3;14;179
"5568";"360810865002";24;75;63;2;61;225
"5569";"360810869001";18;31;203;10;61;323
"5570";"360810869002";5;8;222;31;33;299
"5571";"360810871001";215;55;103;0;66;439
"5572";"360810871002";13;49;150;8;101;321
"5573";"360810884001";31;5;109;57;53;255
"5574";"360810884002";4;4;41;17;23;89
"5575";"360810884003";4;0;30;23;28;85
"5576";"360810884004";10;5;17;29;57;118
"5577";"360810884005";32;11;40;17;28;128
"5578";"360810884006";44;12;260;74;51;441
"5579";"360810884007";2;2;39;32;18;93
"5580";"360810884008";6;4;78;57;17;162
"5581";"360810889011";84;7;219;46;83;439
"5582";"360810889012";15;12;14;11;2;54
"5583";"360810889013";26;13;26;2;5;72
"5584";"360810889014";7;5;16;1;10;39
"5585";"360810889015";5;2;39;0;2;48
"5586";"360810889016";74;29;52;6;15;176
"5587";"360810889017";31;11;58;0;25;125
"5588";"360810892001";34;8;19;13;39;113
"5589";"360810892002";56;19;57;16;11;159
"5590";"360810892003";15;9;61;32;41;158
"5591";"360810892004";7;3;17;36;32;95
"5592";"360810892005";15;5;24;20;34;98
"5593";"360810892006";13;1;8;4;23;49
"5594";"360810892007";8;2;11;11;20;52
"5595";"360810892008";16;265;17;6;24;328
"5596";"360810907001";33;20;306;153;60;572
"5597";"360810916011";0;2;3;0;2;7
"5598";"360810916012";2;1;0;0;4;7
"5599";"360810916013";2;0;1;1;3;7
"5600";"360810916014";9;2;17;0;14;42
"5601";"360810916021";0;0;17;2;2;21
"5602";"360810918001";1;2;0;0;0;3
"5603";"360810919001";33;3;117;36;24;213
"5604";"360810919002";133;40;277;59;70;579
"5605";"360810919003";35;14;208;59;27;343
"5606";"360810922001";13;1;4;2;7;27
"5607";"360810922002";6;0;15;4;22;47
"5608";"360810922003";5;4;111;0;23;143
"5609";"360810925001";78;35;196;78;24;411
"5610";"360810925002";80;31;177;54;37;379
"5611";"360810925003";62;11;212;47;31;363
"5612";"360810928001";37;20;26;0;22;105
"5613";"360810928002";10;4;56;3;22;95
"5614";"360810928003";4;0;11;6;6;27
"5615";"360810929000";0;2;0;0;0;2
"5616";"360810929001";178;35;291;174;95;773
"5617";"360810929002";62;15;309;189;67;642
"5618";"360810929003";35;5;105;41;18;204
"5619";"360810929004";7;5;42;25;4;83
"5620";"360810934010";1;0;0;0;1;2
"5621";"360810934011";7;6;28;4;14;59
"5622";"360810934012";21;7;73;8;16;125
"5623";"360810934013";6;17;97;1;14;135
"5624";"360810934021";89;12;99;8;33;241
"5625";"360810934022";8;1;67;2;13;91
"5626";"360810934023";58;2;97;14;36;207
"5627";"360810938001";16;1;9;1;58;85
"5628";"360810938002";50;41;375;2;44;512
"5629";"360810938003";284;206;152;8;171;821
"5630";"360810939001";135;41;217;114;82;589
"5631";"360810939002";53;8;148;67;35;311
"5632";"360810939003";58;11;147;96;48;360
"5633";"360810942011";219;333;255;21;51;879
"5634";"360810942020";0;1;0;0;0;1
"5635";"360810942021";407;104;113;29;22;675
"5636";"360810942022";164;37;102;30;56;389
"5637";"360810942031";85;112;87;5;29;318
"5638";"360810942032";3;25;43;4;4;79
"5639";"360810942033";47;16;19;1;3;86
"5640";"360810942034";8;4;18;1;11;42
"5641";"360810942035";3;31;8;8;1;51
"5642";"360810945000";0;1;2;0;0;3
"5643";"360810945001";46;51;138;90;58;383
"5644";"360810945002";63;22;92;56;66;299
"5645";"360810947001";78;317;230;55;76;756
"5646";"360810947002";73;16;134;110;50;383
"5647";"360810954001";76;10;41;8;35;170
"5648";"360810954002";144;18;37;9;13;221
"5649";"360810954003";39;11;71;21;29;171
"5650";"360810964001";93;12;58;10;40;213
"5651";"360810964002";79;66;163;48;45;401
"5652";"360810972021";308;12;3;14;36;373
"5653";"360810972031";29;4;7;39;17;96
"5654";"360810972032";63;10;10;9;7;99
"5655";"360810972033";86;9;20;10;8;133
"5656";"360810972034";184;11;7;1;2;205
"5657";"360810972041";91;20;8;1;14;134
"5658";"360810972042";31;8;55;24;26;144
"5659";"360810972043";7;7;5;1;0;20
"5660";"360810973001";27;70;42;34;11;184
"5661";"360810973002";23;7;19;8;8;65
"5662";"360810973003";6;11;10;8;19;54
"5663";"360810981001";23;15;31;18;26;113
"5664";"360810981002";15;16;66;22;21;140
"5665";"360810987001";36;32;80;50;54;252
"5666";"360810987002";34;67;109;41;32;283
"5667";"360810991001";9;7;55;27;3;101
"5668";"360810991002";1;0;37;4;5;47
"5669";"360810991003";8;4;32;22;12;78
"5670";"360810991004";32;4;35;16;19;106
"5671";"360810991005";14;4;59;35;20;132
"5672";"360810992001";107;8;59;19;35;228
"5673";"360810992002";473;18;80;44;11;626
"5674";"360810997011";15;6;24;24;11;80
"5675";"360810997012";17;2;88;13;22;142
"5676";"360810997013";1;4;40;16;6;67
"5677";"360810997031";38;13;100;36;32;219
"5678";"360810997032";1;5;25;9;1;41
"5679";"360810997033";6;3;39;31;12;91
"5680";"360810997041";26;1;25;27;17;96
"5681";"360810997042";144;5;36;17;8;210
"5682";"360810997043";7;2;28;7;22;66
"5683";"360810997044";5;13;29;11;9;67
"5684";"360810997051";21;10;60;33;12;136
"5685";"360810998011";60;9;78;15;39;201
"5686";"360810998012";107;4;21;0;7;139
"5687";"360810998013";142;12;114;12;22;302
"5688";"360810998014";14;0;8;0;1;23
"5689";"360810998015";58;8;76;20;26;188
"5690";"360810998021";177;50;38;53;47;365
"5691";"360810998022";50;1;3;4;3;61
"5692";"360810998023";6;6;2;0;2;16
"5693";"360810999001";0;3;2;0;5;10
"5694";"360811008011";158;24;33;20;5;240
"5695";"360811008012";91;14;37;17;20;179
"5696";"360811008021";115;57;108;20;37;337
"5697";"360811008022";43;4;60;28;26;161
"5698";"360811008023";59;5;41;14;20;139
"5699";"360811008024";65;8;34;34;27;168
"5700";"360811010011";134;19;123;17;29;322
"5701";"360811010012";71;9;66;19;16;181
"5702";"360811010013";74;138;131;15;27;385
"5703";"360811010014";86;11;49;7;12;165
"5704";"360811010021";6;8;50;11;20;95
"5705";"360811010022";298;25;94;17;32;466
"5706";"360811017001";7;3;51;12;8;81
"5707";"360811017002";19;1;24;30;17;91
"5708";"360811017003";19;4;21;10;12;66
"5709";"360811017004";6;0;58;11;5;80
"5710";"360811017005";5;2;15;11;20;53
"5711";"360811017006";15;31;69;31;25;171
"5712";"360811017007";5;3;26;19;11;64
"5713";"360811029001";21;7;132;55;27;242
"5714";"360811029002";8;36;68;41;14;167
"5715";"360811032011";112;2;96;46;30;286
"5716";"360811032012";136;12;47;21;51;267
"5717";"360811032013";93;17;21;15;13;159
"5718";"360811032021";38;4;82;15;30;169
"5719";"360811032022";6;0;7;25;3;41
"5720";"360811032023";145;23;53;14;15;250
"5721";"360811032024";129;13;45;7;19;213
"5722";"360811033001";24;2;87;37;29;179
"5723";"360811033002";11;4;58;20;28;121
"5724";"360811033003";8;5;21;5;15;54
"5725";"360811033004";7;0;20;14;13;54
"5726";"360811039001";66;12;110;40;27;255
"5727";"360811039002";34;11;162;108;69;384
"5728";"360811039003";26;24;57;33;56;196
"5729";"360811039004";45;13;57;46;15;176
"5730";"360811047001";18;8;90;22;45;183
"5731";"360811047002";8;9;43;51;31;142
"5732";"360811047003";28;10;146;35;23;242
"5733";"360811047004";15;2;140;22;33;212
"5734";"360811047005";15;3;175;68;30;291
"5735";"360811059001";12;9;16;8;13;58
"5736";"360811059002";24;1;37;25;31;118
"5737";"360811059003";5;7;4;10;15;41
"5738";"360811059004";2;2;27;17;133;181
"5739";"360811072011";42;17;188;80;66;393
"5740";"360811072020";2;2;5;2;1;12
"5741";"360811072021";0;0;2;0;1;3
"5742";"360811085001";27;9;40;23;14;113
"5743";"360811085002";5;4;73;9;33;124
"5744";"360811085003";5;1;110;20;34;170
"5745";"360811093001";2;3;21;6;7;39
"5746";"360811093002";4;6;51;6;19;86
"5747";"360811093003";11;2;8;4;13;38
"5748";"360811097001";3;4;7;8;11;33
"5749";"360811097002";24;6;34;28;15;107
"5750";"360811097003";8;4;28;9;14;63
"5751";"360811099001";3;3;79;32;55;172
"5752";"360811099002";14;0;39;19;27;99
"5753";"360811099003";21;125;69;16;33;264
"5754";"360811113001";18;2;39;1;29;89
"5755";"360811113002";0;0;30;18;22;70
"5756";"360811113003";15;3;24;16;14;72
"5757";"360811123001";19;6;114;4;16;159
"5758";"360811123002";16;73;206;15;45;355
"5759";"360811129001";10;1;42;7;19;79
"5760";"360811129002";3;1;15;5;19;43
"5761";"360811129003";24;3;50;11;9;97
"5762";"360811133001";7;3;31;5;8;54
"5763";"360811133002";1;3;18;16;12;50
"5764";"360811139001";15;8;79;10;13;125
"5765";"360811139002";107;5;133;16;11;272
"5766";"360811139003";22;4;74;18;15;133
"5767";"360811141001";19;48;41;22;21;151
"5768";"360811141002";9;9;47;15;29;109
"5769";"360811147001";5;1;25;19;18;68
"5770";"360811147002";8;4;38;19;31;100
"5771";"360811151001";3;27;45;10;46;131
"5772";"360811155001";60;3;62;6;41;172
"5773";"360811155002";43;21;50;3;17;134
"5774";"360811157001";9;14;84;6;28;141
"5775";"360811157002";75;16;77;2;20;190
"5776";"360811157003";27;1;54;0;10;92
"5777";"360811159001";3;6;31;2;11;53
"5778";"360811159002";8;8;95;10;16;137
"5779";"360811159003";165;3;118;2;17;305
"5780";"360811161001";61;5;129;1;35;231
"5781";"360811161002";54;5;29;0;19;107
"5782";"360811163001";28;2;11;0;5;46
"5783";"360811163002";25;4;48;0;14;91
"5784";"360811163003";57;12;88;0;12;169
"5785";"360811163004";113;7;28;3;16;167
"5786";"360811163005";23;54;122;2;20;221
"5787";"360811167001";34;47;1122;10;78;1291
"5788";"360811171001";11;48;108;38;55;260
"5789";"360811171002";46;13;47;3;28;137
"5790";"360811171003";28;5;65;3;22;123
"5791";"360811175001";8;5;106;2;27;148
"5792";"360811175002";39;12;125;4;19;199
"5793";"360811175003";19;7;84;22;6;138
"5794";"360811175004";35;67;129;35;52;318
"5795";"360811181001";10;6;152;15;28;211
"5796";"360811181002";10;6;163;32;44;255
"5797";"360811185001";17;11;135;39;37;239
"5798";"360811185002";8;7;133;16;17;181
"5799";"360811187001";23;0;70;8;11;112
"5800";"360811187002";73;7;326;21;41;468
"5801";"360811189001";15;3;126;27;63;234
"5802";"360811189002";2;2;86;13;30;133
"5803";"360811191001";36;10;176;34;59;315
"5804";"360811191002";20;11;112;11;35;189
"5805";"360811193001";19;5;91;11;47;173
"5806";"360811193002";27;5;82;6;15;135
"5807";"360811195001";45;6;134;47;35;267
"5808";"360811199001";42;5;93;59;38;237
"5809";"360811201001";29;3;158;12;54;256
"5810";"360811203001";12;7;47;4;23;93
"5811";"360811203002";6;6;50;2;43;107
"5812";"360811205001";29;27;399;9;45;509
"5813";"360811207001";12;1;33;36;31;113
"5814";"360811207002";29;6;133;39;64;271
"5815";"360811211001";1;4;44;9;3;61
"5816";"360811215001";76;4;199;49;27;355
"5817";"360811215002";7;4;232;60;58;361
"5818";"360811215003";26;4;323;55;56;464
"5819";"360811223001";37;5;211;26;22;301
"5820";"360811223002";4;3;67;38;34;146
"5821";"360811223003";45;6;75;56;52;234
"5822";"360811227011";22;31;302;15;24;394
"5823";"360811227012";14;2;125;19;15;175
"5824";"360811227013";33;9;220;27;52;341
"5825";"360811227014";32;4;31;1;8;76
"5826";"360811227015";138;5;177;11;9;340
"5827";"360811227016";1;1;7;2;0;11
"5828";"360811227017";42;5;40;9;6;102
"5829";"360811227021";304;7;12;18;5;346
"5830";"360811227022";116;34;57;15;19;241
"5831";"360811227023";667;11;22;19;30;749
"5832";"360811227024";21;0;81;23;18;143
"5833";"360811227025";51;6;29;10;12;108
"5834";"360811241001";27;3;82;44;18;174
"5835";"360811241002";13;3;35;44;27;122
"5836";"360811241003";83;7;95;22;20;227
"5837";"360811247001";25;3;41;62;24;155
"5838";"360811247002";15;2;39;23;16;95
"5839";"360811247003";54;2;45;28;23;152
"5840";"360811257001";59;31;129;11;30;260
"5841";"360811257002";275;385;300;8;759;1727
"5842";"360811257003";134;342;846;7;456;1785
"5843";"360811265001";54;2;57;29;37;179
"5844";"360811265002";23;34;71;12;745;885
"5845";"360811267001";49;14;59;17;23;162
"5846";"360811267002";20;6;165;32;45;268
"5847";"360811267003";85;6;51;26;45;213
"5848";"360811277001";48;10;46;29;23;156
"5849";"360811277002";65;8;30;26;33;162
"5850";"360811277003";13;3;19;28;9;72
"5851";"360811277004";1;9;25;15;11;61
"5852";"360811283001";1;32;116;5;7;161
"5853";"360811291021";19;2;38;20;26;105
"5854";"360811291022";24;6;8;9;6;53
"5855";"360811291023";10;2;4;2;19;37
"5856";"360811291024";16;3;7;5;6;37
"5857";"360811291031";10;1;17;8;5;41
"5858";"360811291032";24;1;8;8;2;43
"5859";"360811291033";8;2;24;26;5;65
"5860";"360811291041";4;2;1;0;4;11
"5861";"360811291042";11;0;26;11;3;51
"5862";"360811291043";3;21;35;5;7;71
"5863";"360811291044";4;2;18;10;16;50
"5864";"360811291045";24;2;113;4;2;145
"5865";"360811301001";3;1;30;10;15;59
"5866";"360811301002";18;9;14;10;9;60
"5867";"360811301003";55;7;62;23;27;174
"5868";"360811301004";13;1;34;19;18;85
"5869";"360811333001";12;1;85;63;7;168
"5870";"360811333002";3;0;63;17;8;91
"5871";"360811333003";104;11;87;23;59;284
"5872";"360811333004";24;10;76;33;16;159
"5873";"360811339001";96;5;103;39;26;269
"5874";"360811341001";31;5;152;52;47;287
"5875";"360811341002";28;2;56;65;39;190
"5876";"360811341003";4;1;51;17;16;89
"5877";"360811347001";39;24;78;13;8;162
"5878";"360811347002";4;2;77;20;6;109
"5879";"360811347003";13;4;44;30;3;94
"5880";"360811347004";35;3;66;14;7;125
"5881";"360811347005";84;5;95;22;10;216
"5882";"360811367001";17;23;96;11;22;169
"5883";"360811367002";20;5;18;12;11;66
"5884";"360811367003";8;0;48;9;0;65
"5885";"360811367004";6;3;23;16;14;62
"5886";"360811367005";2;3;45;77;5;132
"5887";"360811377001";25;3;55;4;6;93
"5888";"360811377002";23;2;87;18;17;147
"5889";"360811377003";8;2;94;18;12;134
"5890";"360811377004";11;1;35;20;18;85
"5891";"360811385011";5;8;43;9;8;73
"5892";"360811385012";22;1;93;6;9;131
"5893";"360811385013";10;5;50;15;9;89
"5894";"360811385014";13;5;68;25;46;157
"5895";"360811385021";4;10;23;9;5;51
"5896";"360811399001";0;1;22;15;20;58
"5897";"360811399002";16;2;32;13;12;75
"5898";"360811403001";1;1;14;7;5;28
"5899";"360811403002";19;2;55;19;39;134
"5900";"360811409011";4;1;16;13;14;48
"5901";"360811409021";17;5;87;19;37;165
"5902";"360811409022";17;6;164;39;19;245
"5903";"360811417001";6;1;28;23;11;69
"5904";"360811417002";9;4;22;14;34;83
"5905";"360811417003";3;2;8;7;26;46
"5906";"360811417004";21;3;27;19;21;91
"5907";"360811417005";20;2;58;4;16;100
"5908";"360811429001";2;4;17;2;21;46
"5909";"360811429002";29;4;35;16;29;113
"5910";"360811429003";10;1;21;15;24;71
"5911";"360811429004";7;3;38;33;17;98
"5912";"360811435001";13;3;59;9;32;116
"5913";"360811435002";9;1;18;17;15;60
"5914";"360811441001";9;1;17;4;15;46
"5915";"360811441002";37;5;41;2;4;89
"5916";"360811441003";4;0;16;4;7;31
"5917";"360811441004";3;2;15;1;6;27
"5918";"360811447001";19;3;121;15;50;208
"5919";"360811447002";19;12;128;58;51;268
"5920";"360811451011";15;10;43;13;38;119
"5921";"360811451021";8;2;21;16;23;70
"5922";"360811451022";52;0;37;39;18;146
"5923";"360811459001";10;6;16;13;9;54
"5924";"360811459002";10;25;24;13;26;98
"5925";"360811459003";19;3;32;16;15;85
"5926";"360811463001";8;5;112;31;37;193
"5927";"360811463002";19;5;109;67;32;232
"5928";"360811467001";32;52;238;27;35;384
"5929";"360811467002";68;2;6;1;3;80
"5930";"360811467003";18;2;119;20;16;175
"5931";"360811471001";35;10;242;43;48;378
"5932";"360811471002";32;5;63;9;18;127
"5933";"360811479001";11;9;132;9;34;195
"5934";"360811479002";21;13;143;4;24;205
"5935";"360811479003";6;8;91;16;20;141
"5936";"360811483001";4;11;34;11;10;70
"5937";"360811483002";12;3;55;9;28;107
"5938";"360811483003";17;4;20;6;16;63
"5939";"360811483004";15;3;23;14;17;72
"5940";"360811507011";12;5;20;20;27;84
"5941";"360811507012";3;3;29;21;15;71
"5942";"360811507013";5;2;17;14;9;47
"5943";"360811507021";1;1;24;14;11;51
"5944";"360811507022";5;0;15;6;2;28
"5945";"360811507023";10;2;26;9;10;57
"5946";"360811507024";6;104;116;12;11;249
"5947";"360811529011";1;3;48;16;13;81
"5948";"360811529012";44;13;202;38;28;325
"5949";"360811529013";3;11;61;33;13;121
"5950";"360811529021";2;1;9;18;4;34
"5951";"360811529022";3;2;24;23;7;59
"5952";"360811529023";17;1;58;13;28;117
"5953";"360811529024";3;9;43;4;12;71
"5954";"360811551011";0;0;0;0;2;2
"5955";"360811551021";6;4;106;8;6;130
"5956";"360811551022";2;0;13;11;7;33
"5957";"360811551023";14;19;160;11;40;244
"5958";"360811551024";0;4;52;23;19;98
"5959";"360811551025";2;3;35;9;5;54
"5960";"360811551026";2;0;24;15;1;42
"5961";"360811567001";11;9;63;11;29;123
"5962";"360811571011";1;1;18;7;4;31
"5963";"360811571012";10;69;85;4;33;201
"5964";"360811571013";0;1;25;19;3;48
"5965";"360811571014";10;2;22;25;19;78
"5966";"360811571015";37;1;28;35;22;123
"5967";"360811571016";18;21;41;37;46;163
"5968";"360811571017";3;14;67;22;36;142
"5969";"360811571018";2;2;16;14;9;43
"5970";"360811571021";3;1;42;15;23;84
"5971";"360811571022";7;7;76;27;21;138
"5972";"360811579011";12;4;38;8;22;84
"5973";"360811579012";2;1;18;6;25;52
"5974";"360811579013";1;0;6;9;9;25
"5975";"360811579014";28;3;8;8;8;55
"5976";"360811579015";5;0;44;18;10;77
"5977";"360811579016";5;23;17;11;29;85
"5978";"360811579021";2;89;18;12;15;136
"5979";"360811579022";46;2;47;15;13;123
"5980";"360811579023";23;84;24;7;10;148
"5981";"360811579024";18;2;12;10;10;52
"5982";"360811579025";7;39;44;9;32;131
"5983";"360811579031";25;0;24;16;23;88
"5984";"360811579032";9;12;64;15;32;132
"5985";"360811579033";14;4;38;28;27;111
"5986";"360811579034";13;24;268;88;70;463
"5987";"360811617001";20;2;69;33;53;177
"5988";"360811617002";11;3;17;21;12;64
"5989";"360811617003";2;3;38;19;43;105
"5990";"360811617004";41;10;98;53;52;254
"5991";"360811621001";55;6;30;11;31;133
"5992";"360811621002";49;15;72;20;39;195
"5993";"360811621003";47;8;27;22;22;126
"5994";"360811621004";10;3;27;16;36;92
"5995";"360811621005";61;18;122;29;37;267
"5996";"360850003001";63;2;54;3;37;159
"5997";"360850003002";27;21;71;48;37;204
"5998";"360850006001";15;164;39;31;25;274
"5999";"360850006002";31;20;146;59;34;290
"6000";"360850007001";120;14;15;8;31;188
"6001";"360850007002";21;7;154;15;14;211
"6002";"360850007003";62;13;104;28;5;212
"6003";"360850007004";127;14;97;16;25;279
"6004";"360850008001";31;7;88;54;54;234
"6005";"360850008002";93;10;129;15;20;267
"6006";"360850008003";12;13;49;37;29;140
"6007";"360850009001";199;11;204;48;21;483
"6008";"360850009002";28;10;44;25;33;140
"6009";"360850011001";40;66;120;64;44;334
"6010";"360850011002";132;10;30;23;31;226
"6011";"360850011003";68;23;64;32;30;217
"6012";"360850017001";6;1;29;9;10;55
"6013";"360850017002";52;12;47;50;25;186
"6014";"360850018001";0;1;0;0;2;3
"6015";"360850020011";16;1;94;86;17;214
"6016";"360850020012";10;1;81;20;14;126
"6017";"360850020021";67;7;102;68;26;270
"6018";"360850020022";5;5;36;34;14;94
"6019";"360850021001";225;48;100;57;72;502
"6020";"360850021002";60;143;124;73;115;515
"6021";"360850021003";101;191;121;102;89;604
"6022";"360850027001";92;78;67;70;84;391
"6023";"360850029001";39;14;198;126;45;422
"6024";"360850029002";306;63;14;13;8;404
"6025";"360850029003";133;105;88;60;34;420
"6026";"360850029004";34;13;51;36;26;160
"6027";"360850033001";30;3;63;35;11;142
"6028";"360850033002";82;45;303;159;62;651
"6029";"360850036001";48;3;84;52;28;215
"6030";"360850036002";55;5;57;23;18;158
"6031";"360850039001";9;1;34;20;1;65
"6032";"360850039002";50;0;152;32;10;244
"6033";"360850040001";65;3;61;45;34;208
"6034";"360850040002";339;57;27;52;19;494
"6035";"360850040003";239;11;30;18;9;307
"6036";"360850040004";81;5;36;11;16;149
"6037";"360850040005";24;26;16;6;15;87
"6038";"360850040006";57;9;33;20;24;143
"6039";"360850040007";50;3;28;51;25;157
"6040";"360850047001";23;10;70;43;31;177
"6041";"360850047002";15;11;42;9;8;85
"6042";"360850050001";7;7;43;30;10;97
"6043";"360850050002";20;1;48;24;9;102
"6044";"360850050003";10;4;38;34;4;90
"6045";"360850059001";109;45;223;54;24;455
"6046";"360850059002";20;16;41;9;22;108
"6047";"360850064001";16;1;43;10;18;88
"6048";"360850064002";9;1;25;11;14;60
"6049";"360850064003";145;20;196;23;27;411
"6050";"360850067001";13;4;20;16;16;69
"6051";"360850067002";34;11;76;19;24;164
"6052";"360850067003";15;3;16;30;14;78
"6053";"360850070001";50;40;161;77;62;390
"6054";"360850070002";8;4;286;17;17;332
"6055";"360850070003";46;27;78;94;47;292
"6056";"360850070004";24;6;63;24;28;145
"6057";"360850074001";34;9;196;70;26;335
"6058";"360850074002";98;17;106;52;49;322
"6059";"360850075001";43;10;52;32;30;167
"6060";"360850075002";42;4;92;16;37;191
"6061";"360850075003";80;14;88;62;41;285
"6062";"360850077001";95;21;25;48;32;221
"6063";"360850081001";58;39;61;43;31;232
"6064";"360850081002";52;8;36;22;10;128
"6065";"360850081003";280;65;44;59;56;504
"6066";"360850096011";67;14;166;116;34;397
"6067";"360850096012";17;2;130;33;37;219
"6068";"360850096021";11;4;62;37;15;129
"6069";"360850096022";54;5;42;27;29;157
"6070";"360850096023";8;8;58;18;25;117
"6071";"360850097001";45;11;68;56;30;210
"6072";"360850097002";36;2;39;23;18;118
"6073";"360850097003";27;22;18;27;16;110
"6074";"360850105001";24;41;27;20;17;129
"6075";"360850105002";12;31;42;14;21;120
"6076";"360850105003";11;7;55;23;7;103
"6077";"360850105004";35;9;137;68;43;292
"6078";"360850105005";90;56;42;48;23;259
"6079";"360850112011";40;10;111;29;73;263
"6080";"360850112012";116;57;169;65;64;471
"6081";"360850112021";61;21;99;35;51;267
"6082";"360850112022";43;46;100;48;32;269
"6083";"360850112023";50;13;52;22;24;161
"6084";"360850112024";0;1;2;3;0;6
"6085";"360850114011";41;17;87;14;12;171
"6086";"360850114012";519;18;42;15;23;617
"6087";"360850114021";8;4;15;11;22;60
"6088";"360850114022";49;2;26;14;28;119
"6089";"360850114023";3;3;15;17;13;51
"6090";"360850121001";9;2;24;21;8;64
"6091";"360850121002";3;2;37;11;11;64
"6092";"360850121003";6;5;43;12;17;83
"6093";"360850122001";10;3;24;12;14;63
"6094";"360850122002";10;17;23;19;18;87
"6095";"360850122003";7;7;19;11;12;56
"6096";"360850122004";42;298;18;22;20;400
"6097";"360850125001";525;92;93;83;93;886
"6098";"360850125002";98;162;56;39;18;373
"6099";"360850125003";22;4;19;13;7;65
"6100";"360850128041";84;13;130;95;69;391
"6101";"360850128042";108;24;252;54;156;594
"6102";"360850128051";12;5;61;46;54;178
"6103";"360850128061";6;3;19;15;8;51
"6104";"360850128062";24;7;24;24;6;85
"6105";"360850128063";46;7;60;8;33;154
"6106";"360850128064";62;10;94;33;43;242
"6107";"360850132011";11;3;18;6;2;40
"6108";"360850132012";2;10;25;2;6;45
"6109";"360850132031";21;1;47;24;8;101
"6110";"360850132032";16;2;53;15;25;111
"6111";"360850132033";46;8;68;36;28;186
"6112";"360850132041";11;0;64;22;25;122
"6113";"360850132042";30;5;80;42;21;178
"6114";"360850132043";9;2;38;24;26;99
"6115";"360850133011";232;6;18;14;18;288
"6116";"360850133021";23;5;91;91;39;249
"6117";"360850133022";32;30;85;84;55;286
"6118";"360850133023";191;33;124;102;55;505
"6119";"360850134001";24;4;66;29;23;146
"6120";"360850134002";7;3;55;23;23;111
"6121";"360850134003";11;1;50;31;33;126
"6122";"360850138001";12;3;7;7;10;39
"6123";"360850138002";17;1;52;10;28;108
"6124";"360850138003";4;2;33;18;12;69
"6125";"360850138004";5;0;16;15;20;56
"6126";"360850138005";10;6;40;28;25;109
"6127";"360850141001";46;12;38;30;26;152
"6128";"360850141002";31;2;22;34;20;109
"6129";"360850146041";11;4;61;6;13;95
"6130";"360850146042";18;14;57;13;22;124
"6131";"360850146043";24;8;79;24;16;151
"6132";"360850146044";22;20;124;13;15;194
"6133";"360850146051";27;42;124;37;36;266
"6134";"360850146052";72;36;43;12;24;187
"6135";"360850146061";24;10;174;32;31;271
"6136";"360850146062";30;6;146;12;58;252
"6137";"360850146063";46;4;60;15;32;157
"6138";"360850146064";12;2;102;16;11;143
"6139";"360850146071";35;11;138;33;31;248
"6140";"360850146072";73;40;25;29;8;175
"6141";"360850146081";8;8;212;19;20;267
"6142";"360850146082";15;12;45;29;18;119
"6143";"360850147001";2;0;9;13;5;29
"6144";"360850147002";22;9;67;31;19;148
"6145";"360850147003";14;1;76;21;22;134
"6146";"360850151001";40;7;39;45;53;184
"6147";"360850151002";16;4;19;16;16;71
"6148";"360850151003";2;2;19;28;10;61
"6149";"360850151004";20;1;16;17;12;66
"6150";"360850151005";50;13;37;17;12;129
"6151";"360850154001";2;0;2;0;1;5
"6152";"360850156011";26;50;39;18;21;154
"6153";"360850156012";31;1;25;13;11;81
"6154";"360850156013";10;7;46;50;22;135
"6155";"360850156014";28;0;50;5;10;93
"6156";"360850156015";11;3;9;9;6;38
"6157";"360850156016";14;11;25;17;3;70
"6158";"360850156021";7;8;32;3;13;63
"6159";"360850156022";5;1;40;4;27;77
"6160";"360850156023";20;1;19;2;9;51
"6161";"360850156024";2;0;26;8;6;42
"6162";"360850156031";10;8;26;7;19;70
"6163";"360850156032";14;18;85;27;47;191
"6164";"360850156033";18;186;113;35;36;388
"6165";"360850169011";9;2;46;29;45;131
"6166";"360850169012";30;7;101;34;22;194
"6167";"360850170051";58;17;49;31;50;205
"6168";"360850170052";66;117;58;28;33;302
"6169";"360850170071";30;51;77;21;27;206
"6170";"360850170072";38;14;106;14;21;193
"6171";"360850170081";28;6;116;44;34;228
"6172";"360850170082";28;2;180;22;29;261
"6173";"360850170083";34;5;198;31;33;301
"6174";"360850170091";25;0;59;4;27;115
"6175";"360850170092";10;3;30;45;24;112
"6176";"360850170093";6;1;52;26;19;104
"6177";"360850170101";21;3;141;24;26;215
"6178";"360850170102";27;7;113;32;15;194
"6179";"360850170103";71;5;251;25;34;386
"6180";"360850170104";10;4;54;19;34;121
"6181";"360850170111";12;3;56;38;15;124
"6182";"360850170112";24;8;73;47;16;168
"6183";"360850170121";23;7;83;27;65;205
"6184";"360850170122";5;3;32;12;18;70
"6185";"360850170123";14;1;67;23;11;116
"6186";"360850173001";17;10;49;24;9;109
"6187";"360850173002";245;22;7;2;16;292
"6188";"360850176001";20;5;53;6;7;91
"6189";"360850176002";6;1;22;10;17;56
"6190";"360850176003";14;3;17;13;15;62
"6191";"360850176004";27;1;25;12;25;90
"6192";"360850177001";16;1;14;4;10;45
"6193";"360850177002";14;6;20;11;15;66
"6194";"360850177003";15;7;13;20;21;76
"6195";"360850177004";15;2;23;4;11;55
"6196";"360850177005";3;4;30;19;75;131
"6197";"360850177006";0;1;0;2;4;7
"6198";"360850181001";11;1;25;5;11;53
"6199";"360850181002";14;9;27;7;18;75
"6200";"360850181003";5;4;19;1;14;43
"6201";"360850187011";25;15;47;34;89;210
"6202";"360850187012";14;4;24;23;21;86
"6203";"360850187021";39;3;51;48;12;153
"6204";"360850187022";32;4;52;28;26;142
"6205";"360850187023";23;10;85;39;18;175
"6206";"360850187024";38;2;121;52;28;241
"6207";"360850189011";82;18;137;58;134;429
"6208";"360850189012";16;7;41;23;32;119
"6209";"360850189021";23;1;45;24;13;106
"6210";"360850189022";12;4;59;31;16;122
"6211";"360850189023";54;9;43;15;20;141
"6212";"360850197001";4;3;14;23;7;51
"6213";"360850197002";46;6;49;12;9;122
"6214";"360850198001";0;8;2;4;2;16
"6215";"360850198002";21;5;96;30;30;182
"6216";"360850198003";17;6;21;12;23;79
"6217";"360850198004";24;4;86;19;35;168
"6218";"360850201001";74;13;38;24;41;190
"6219";"360850201002";13;15;34;23;27;112
"6220";"360850201003";12;10;20;14;26;82
"6221";"360850207001";140;31;166;64;86;487
"6222";"360850207002";44;10;64;50;39;207
"6223";"360850207003";158;16;99;77;45;395
"6224";"360850207004";62;20;97;71;58;308
"6225";"360850208011";11;7;102;36;25;181
"6226";"360850208012";16;2;81;25;54;178
"6227";"360850208013";29;3;131;29;41;233
"6228";"360850208014";46;14;98;40;26;224
"6229";"360850208031";31;4;223;40;21;319
"6230";"360850208032";22;27;56;31;54;190
"6231";"360850208033";8;3;33;9;19;72
"6232";"360850208041";29;4;47;19;24;123
"6233";"360850208042";11;1;60;72;34;178
"6234";"360850208043";1;3;80;15;28;127
"6235";"360850213001";66;17;104;76;43;306
"6236";"360850213002";50;35;24;26;28;163
"6237";"360850213003";90;7;77;39;34;247
"6238";"360850213004";55;5;72;38;23;193
"6239";"360850213005";16;6;79;18;28;147
"6240";"360850223001";59;24;89;101;50;323
"6241";"360850223002";46;11;163;133;59;412
"6242";"360850226001";2;7;165;73;45;292
"6243";"360850226002";19;7;115;38;51;230
"6244";"360850226003";25;15;159;39;27;265
"6245";"360850226004";26;11;34;31;47;149
"6246";"360850228001";11;20;31;25;32;119
"6247";"360850231001";125;26;114;57;64;386
"6248";"360850231002";37;11;43;29;21;141
"6249";"360850239001";83;33;99;71;69;355
"6250";"360850239002";47;12;70;40;64;233
"6251";"360850244011";10;5;16;11;30;72
"6252";"360850244012";25;1;40;13;51;130
"6253";"360850244013";17;8;25;12;34;96
"6254";"360850244021";23;3;39;9;13;87
"6255";"360850244022";15;31;80;43;33;202
"6256";"360850247001";56;10;54;27;35;182
"6257";"360850247002";51;31;61;90;28;261
"6258";"360850248001";36;23;141;23;40;263
"6259";"360850248002";17;12;58;32;14;133
"6260";"360850248003";26;131;83;17;44;301
"6261";"360850251001";47;12;52;36;33;180
"6262";"360850251002";9;7;17;24;12;69
"6263";"360850251003";28;5;47;38;33;151
"6264";"360850273011";1;1;41;13;3;59
"6265";"360850273012";35;7;127;89;26;284
"6266";"360850273021";49;51;125;34;28;287
"6267";"360850273022";7;4;48;8;7;74
"6268";"360850277021";25;4;79;19;10;137
"6269";"360850277022";19;6;36;29;9;99
"6270";"360850277023";47;9;91;23;22;192
"6271";"360850277041";16;1;452;53;17;539
"6272";"360850277042";27;9;76;14;17;143
"6273";"360850277051";27;11;192;112;43;385
"6274";"360850277052";45;1;80;23;14;163
"6275";"360850277053";10;10;64;20;18;122
"6276";"360850277061";30;5;71;112;112;330
"6277";"360850277062";14;1;42;13;16;86
"6278";"360850277063";5;2;54;19;11;91
"6279";"360850279001";15;13;63;27;28;146
"6280";"360850279002";15;1;26;1;12;55
"6281";"360850291021";9;8;95;41;28;181
"6282";"360850291022";50;17;245;77;47;436
"6283";"360850291031";35;12;137;36;43;263
"6284";"360850291032";2;0;13;6;5;26
"6285";"360850291033";44;6;37;11;24;122
"6286";"360850291034";32;1;23;31;17;104
"6287";"360850291035";57;6;60;78;41;242
"6288";"360850291041";49;1;119;57;37;263
"6289";"360850291042";44;13;74;19;14;164
"6290";"360850291043";8;5;68;29;17;127
"6291";"360850291044";34;12;53;47;35;181
"6292";"360850303011";111;9;181;93;44;438
"6293";"360850303012";18;7;34;36;21;116
"6294";"360850303021";24;11;79;27;31;172
"6295";"360850303022";53;15;204;48;18;338
"6296";"360850303023";16;7;120;39;10;192
"6297";"360850303024";45;5;19;15;11;95
"6298";"360850319011";127;15;36;11;14;203
"6299";"360850319012";43;8;36;25;29;141
"6300";"360850319021";62;0;25;19;7;113
"6301";"360850319022";151;6;59;72;60;348
"6302";"360850319023";39;10;146;88;23;306
"6303";"360850323001";76;1;33;60;53;223
"6304";"361190002031";0;0;2;1;0;3
"6305";"361190015031";8;0;20;3;1;32
"6306";"361190026001";3;0;2;1;0;6
"6307";"361190026003";13;2;9;6;0;30
"6308";"361190029002";0;0;4;3;0;7
