"";"Data";"0";"1";"3";"4";"5";"sum"
"1";"360050001001";3;1;6;0;2;12
"2";"360050002001";89;67;511;52;17;736
"3";"360050002002";241;229;439;81;29;1019
"4";"360050002003";60;53;138;46;21;318
"5";"360050004000";0;1;0;0;0;1
"6";"360050004001";13;28;193;13;5;252
"7";"360050004002";104;22;358;58;22;564
"8";"360050004003";183;654;70;14;13;934
"9";"360050004004";12;35;44;19;2;112
"10";"360050016001";89;5;11;0;3;108
"11";"360050016002";19;14;124;32;15;204
"12";"360050016003";24;6;115;0;2;147
"13";"360050016004";15;51;303;18;14;401
"14";"360050019001";155;248;740;41;47;1231
"15";"360050019002";6;5;15;2;5;33
"16";"360050019003";70;192;286;49;38;635
"17";"360050019004";14;122;93;6;8;243
"18";"360050020001";50;13;186;26;33;308
"19";"360050020002";98;112;124;23;18;375
"20";"360050020003";126;57;76;5;12;276
"21";"360050020004";145;118;11;0;3;277
"22";"360050020005";37;2;10;0;0;49
"23";"360050020006";112;7;111;21;12;263
"24";"360050023001";38;41;67;1;23;170
"25";"360050023002";50;2;36;3;3;94
"26";"360050023003";114;28;57;1;21;221
"27";"360050024000";2;6;28;0;1;37
"28";"360050024001";72;190;42;0;17;321
"29";"360050025001";45;228;23;0;24;320
"30";"360050025002";47;7;14;5;7;80
"31";"360050025003";86;76;21;1;14;198
"32";"360050025004";52;21;13;1;8;95
"33";"360050025005";40;9;46;3;2;100
"34";"360050027011";235;66;102;13;10;426
"35";"360050027012";144;117;98;5;51;415
"36";"360050027021";117;37;103;4;6;267
"37";"360050027022";20;11;44;15;43;133
"38";"360050027023";27;28;171;5;16;247
"39";"360050027024";182;34;55;5;6;282
"40";"360050028001";27;100;228;22;16;393
"41";"360050028002";36;78;62;1;3;180
"42";"360050028003";13;8;22;0;2;45
"43";"360050028004";17;26;28;2;3;76
"44";"360050031001";481;220;484;28;35;1248
"45";"360050033001";102;37;176;40;4;359
"46";"360050033002";24;64;27;9;21;145
"47";"360050033003";29;54;129;25;5;242
"48";"360050035001";95;75;399;23;10;602
"49";"360050035002";116;99;49;2;15;281
"50";"360050035003";122;294;182;7;42;647
"51";"360050037001";12;61;39;3;16;131
"52";"360050038001";165;34;209;53;8;469
"53";"360050039001";17;43;22;4;21;107
"54";"360050039002";92;39;101;4;10;246
"55";"360050039003";54;31;83;11;9;188
"56";"360050039004";11;6;56;8;8;89
"57";"360050039005";170;357;53;15;30;625
"58";"360050040011";35;88;145;17;16;301
"59";"360050041001";334;74;34;4;10;456
"60";"360050041002";95;29;202;24;33;383
"61";"360050041003";3;4;32;0;4;43
"62";"360050041004";161;44;42;11;20;278
"63";"360050042001";40;4;3;1;1;49
"64";"360050042002";116;7;0;3;8;134
"65";"360050042003";55;23;29;9;6;122
"66";"360050042004";11;5;25;7;2;50
"67";"360050042005";27;7;29;27;17;107
"68";"360050042006";0;3;6;4;1;14
"69";"360050042007";28;8;3;1;3;43
"70";"360050043001";198;79;56;5;26;364
"71";"360050043002";66;18;99;3;31;217
"72";"360050043003";209;32;64;6;20;331
"73";"360050043004";131;32;83;6;9;261
"74";"360050044001";90;41;27;0;7;165
"75";"360050044002";56;5;1;1;5;68
"76";"360050044003";98;44;52;10;11;215
"77";"360050044004";54;14;47;5;8;128
"78";"360050046001";133;66;58;42;14;313
"79";"360050048001";86;159;62;12;41;360
"80";"360050048002";80;76;188;9;22;375
"81";"360050050011";148;98;281;14;17;558
"82";"360050050012";197;201;116;7;18;539
"83";"360050050013";98;264;94;6;196;658
"84";"360050050014";19;16;93;2;9;139
"85";"360050050021";199;435;195;17;44;890
"86";"360050050022";314;38;81;5;8;446
"87";"360050050023";342;77;39;0;20;478
"88";"360050050024";33;29;26;6;7;101
"89";"360050051001";44;93;242;14;50;443
"90";"360050051002";282;75;158;33;60;608
"91";"360050051003";2552;10;35;4;6;2607
"92";"360050052001";64;44;223;44;14;389
"93";"360050052002";96;276;74;9;10;465
"94";"360050053001";285;37;7;0;16;345
"95";"360050053002";29;19;13;1;4;66
"96";"360050054001";17;14;90;7;12;140
"97";"360050054002";73;32;338;17;22;482
"98";"360050054003";37;14;154;11;11;227
"99";"360050054004";31;434;36;11;15;527
"100";"360050056001";282;21;81;2;5;391
"101";"360050056002";57;3;78;4;3;145
"102";"360050056003";100;78;101;10;13;302
"103";"360050059021";92;54;195;8;101;450
"104";"360050059022";23;82;124;12;6;247
"105";"360050060001";86;445;277;38;21;867
"106";"360050061001";24;4;40;1;1;70
"107";"360050061002";17;12;35;0;1;65
"108";"360050061003";4;36;48;6;5;99
"109";"360050062001";392;29;110;2;17;550
"110";"360050062002";53;17;1045;4;3;1122
"111";"360050062003";89;39;35;8;11;182
"112";"360050062004";84;85;32;1;14;216
"113";"360050062005";5;6;45;0;3;59
"114";"360050063001";82;164;32;5;68;351
"115";"360050063002";124;135;261;38;62;620
"116";"360050063003";25;128;65;5;118;341
"117";"360050063004";72;237;18;8;25;360
"118";"360050063005";63;141;34;7;29;274
"119";"360050063006";205;1012;1810;42;73;3142
"120";"360050064001";156;24;179;11;11;381
"121";"360050064002";66;14;27;0;8;115
"122";"360050064003";11;7;51;4;3;76
"123";"360050064004";50;46;96;12;5;209
"124";"360050065001";73;21;102;10;40;246
"125";"360050065002";257;138;46;8;23;472
"126";"360050065003";15;6;53;1;11;86
"127";"360050065004";15;12;86;1;49;163
"128";"360050067001";77;175;809;18;37;1116
"129";"360050067002";55;104;110;6;12;287
"130";"360050067003";48;28;12;1;0;89
"131";"360050067004";27;20;38;2;6;93
"132";"360050067005";28;3;18;3;21;73
"133";"360050067006";42;23;72;0;1;138
"134";"360050068001";79;33;81;8;17;218
"135";"360050068002";14;13;43;7;8;85
"136";"360050068003";94;130;311;21;49;605
"137";"360050069001";106;99;84;23;13;325
"138";"360050069002";108;146;248;22;9;533
"139";"360050069003";43;2;6;1;0;52
"140";"360050069004";46;3;3;0;1;53
"141";"360050070001";100;77;253;19;21;470
"142";"360050070002";44;2511;83;9;39;2686
"143";"360050070003";319;326;112;5;14;776
"144";"360050071001";61;34;95;11;4;205
"145";"360050071002";475;542;160;14;80;1271
"146";"360050072001";63;27;83;8;19;200
"147";"360050072002";70;15;86;8;17;196
"148";"360050072003";31;75;68;20;106;300
"149";"360050072004";17;54;78;2;8;159
"150";"360050073001";109;138;128;12;15;402
"151";"360050073002";67;52;98;13;21;251
"152";"360050073003";37;7;105;9;15;173
"153";"360050074001";8;26;210;15;3;262
"154";"360050074002";12;20;56;19;13;120
"155";"360050074003";15;15;11;1;1;43
"156";"360050075001";109;65;606;24;16;820
"157";"360050075002";202;69;332;22;20;645
"158";"360050075003";68;3;9;1;3;84
"159";"360050075004";16;35;5;0;3;59
"160";"360050076001";25;5;14;5;3;52
"161";"360050076002";251;37;1514;7;99;1908
"162";"360050076003";9;6;64;1;7;87
"163";"360050076004";100;110;178;17;45;450
"164";"360050076005";18;11;125;6;11;171
"165";"360050077001";73;62;182;26;19;362
"166";"360050078001";28;26;154;12;33;253
"167";"360050078002";185;99;296;32;156;768
"168";"360050078003";50;46;33;8;10;147
"169";"360050078004";48;82;91;4;9;234
"170";"360050079001";86;31;31;9;30;187
"171";"360050079002";118;9;71;5;7;210
"172";"360050079003";41;18;26;9;5;99
"173";"360050079004";14;65;91;8;9;187
"174";"360050079005";43;15;9;0;2;69
"175";"360050079006";39;38;5;0;6;88
"176";"360050083001";54;177;54;14;5;304
"177";"360050083002";37;21;28;4;7;97
"178";"360050083003";168;104;125;10;3;410
"179";"360050083004";64;60;100;6;11;241
"180";"360050083005";30;98;49;15;15;207
"181";"360050083006";41;41;93;8;13;196
"182";"360050084001";7;1;75;18;7;108
"183";"360050084002";96;39;276;34;11;456
"184";"360050085001";125;352;232;17;40;766
"185";"360050085002";99;282;168;7;17;573
"186";"360050085003";18;25;108;4;11;166
"187";"360050085004";7;64;58;0;4;133
"188";"360050085005";24;30;75;18;1;148
"189";"360050086001";20;4;135;15;10;184
"190";"360050086002";175;16;4;2;47;244
"191";"360050086003";105;7;11;0;4;127
"192";"360050087001";39;141;97;10;26;313
"193";"360050087002";340;57;18;14;14;443
"194";"360050087003";74;49;34;4;7;168
"195";"360050087004";14;44;19;3;2;82
"196";"360050087005";40;48;16;0;8;112
"197";"360050089001";81;17;85;4;31;218
"198";"360050089002";204;125;166;2;10;507
"199";"360050090001";66;275;34;41;3;419
"200";"360050090002";31;94;47;20;4;196
"201";"360050090003";122;12;10;2;3;149
"202";"360050090004";26;33;114;17;13;203
"203";"360050090005";119;20;15;3;7;164
"204";"360050092001";87;17;95;2;13;214
"205";"360050092002";218;13;113;3;7;354
"206";"360050092003";224;46;183;8;28;489
"207";"360050092004";33;25;122;4;12;196
"208";"360050092005";51;54;93;2;6;206
"209";"360050093000";3;2;0;1;5;11
"210";"360050093001";36;45;118;36;16;251
"211";"360050093002";107;45;151;28;21;352
"212";"360050093003";75;37;77;11;22;222
"213";"360050093004";54;56;85;27;11;233
"214";"360050093005";89;25;270;30;47;461
"215";"360050093006";74;137;154;61;19;445
"216";"360050096001";59;17;281;13;18;388
"217";"360050096002";95;229;276;64;23;687
"218";"360050098001";51;71;311;32;21;486
"219";"360050098002";16;7;70;9;7;109
"220";"360050098003";59;15;96;13;7;190
"221";"360050098004";29;16;101;23;9;178
"222";"360050098005";143;39;20;4;19;225
"223";"360050110001";92;528;58;35;22;735
"224";"360050115021";127;94;161;51;20;453
"225";"360050115022";198;114;86;6;16;420
"226";"360050115023";16;29;67;17;3;132
"227";"360050117000";0;1;0;1;1;3
"228";"360050117001";50;72;87;16;21;246
"229";"360050117002";2;75;20;30;4;131
"230";"360050118000";2;1;1;0;0;4
"231";"360050118001";26;12;103;27;20;188
"232";"360050118002";12;49;41;7;7;116
"233";"360050118003";63;27;305;26;12;433
"234";"360050119001";102;37;39;2;68;248
"235";"360050119002";28;13;39;9;3;92
"236";"360050119003";19;8;18;9;9;63
"237";"360050119004";24;10;9;3;4;50
"238";"360050119005";43;96;8;12;15;174
"239";"360050121011";42;18;48;14;15;137
"240";"360050121012";102;75;163;7;17;364
"241";"360050121021";72;221;46;21;37;397
"242";"360050123001";202;34;87;17;12;352
"243";"360050123002";127;20;95;8;17;267
"244";"360050123003";31;74;36;13;5;159
"245";"360050125001";96;95;260;17;35;503
"246";"360050125002";160;154;126;6;8;454
"247";"360050127011";88;34;58;18;16;214
"248";"360050127012";4;9;34;6;9;62
"249";"360050129011";115;222;135;14;39;525
"250";"360050129012";471;74;125;29;102;801
"251";"360050130001";16;9;273;18;18;334
"252";"360050131001";61;22;38;14;18;153
"253";"360050131002";155;111;184;40;22;512
"254";"360050131003";153;144;99;16;34;446
"255";"360050132001";110;15;107;9;16;257
"256";"360050132002";217;57;141;14;16;445
"257";"360050132003";84;21;117;15;20;257
"258";"360050132004";43;74;274;18;22;431
"259";"360050132005";92;8;198;31;18;347
"260";"360050133001";55;57;32;1;6;151
"261";"360050133002";71;25;64;7;8;175
"262";"360050133003";13;12;8;1;5;39
"263";"360050133004";18;25;15;0;0;58
"264";"360050135001";106;21;126;9;16;278
"265";"360050135002";38;11;9;3;4;65
"266";"360050135003";144;93;127;3;13;380
"267";"360050138001";72;32;184;9;27;324
"268";"360050138002";41;14;325;33;23;436
"269";"360050141001";166;72;109;6;14;367
"270";"360050141002";221;366;266;21;206;1080
"271";"360050141003";199;80;251;57;32;619
"272";"360050143001";48;193;225;46;10;522
"273";"360050144001";14;8;13;6;3;44
"274";"360050144002";48;4;11;6;0;69
"275";"360050144003";15;25;3;6;1;50
"276";"360050144004";29;13;24;1;0;67
"277";"360050144005";92;27;217;32;15;383
"278";"360050144006";75;4;156;37;13;285
"279";"360050145001";146;45;70;3;9;273
"280";"360050145002";32;10;2;1;2;47
"281";"360050145003";58;37;46;31;6;178
"282";"360050145004";79;72;102;35;11;299
"283";"360050147011";60;51;19;0;0;130
"284";"360050147012";64;34;57;3;8;166
"285";"360050147013";1482;16;88;19;22;1627
"286";"360050147021";1058;817;10;2;6;1893
"287";"360050147022";741;210;36;10;30;1027
"288";"360050147023";48;3;30;2;2;85
"289";"360050147024";11;106;45;0;1;163
"290";"360050149001";84;81;103;24;24;316
"291";"360050149002";141;57;55;8;17;278
"292";"360050149003";98;172;179;2;21;472
"293";"360050151001";91;60;39;11;8;209
"294";"360050151002";102;163;123;9;13;410
"295";"360050151003";182;33;95;7;9;326
"296";"360050151004";99;211;419;17;48;794
"297";"360050152001";22;7;259;37;12;337
"298";"360050152002";87;24;766;36;36;949
"299";"360050153001";103;102;362;37;20;624
"300";"360050153002";16;272;48;16;11;363
"301";"360050153003";29;11;167;18;14;239
"302";"360050155001";116;150;68;11;9;354
"303";"360050155002";36;27;42;9;7;121
"304";"360050157001";166;197;227;8;24;622
"305";"360050157002";205;469;273;6;14;967
"306";"360050157003";117;41;231;13;10;412
"307";"360050158001";47;14;165;29;15;270
"308";"360050159001";76;182;49;3;26;336
"309";"360050159002";67;8;105;10;5;195
"310";"360050160001";95;16;289;10;26;436
"311";"360050160002";21;9;100;5;11;146
"312";"360050160003";20;10;142;15;7;194
"313";"360050160004";41;7;103;13;7;171
"314";"360050161001";304;322;62;24;47;759
"315";"360050161002";100;168;53;4;10;335
"316";"360050161003";66;8;44;2;24;144
"317";"360050161004";278;400;24;23;58;783
"318";"360050162001";49;6;123;16;15;209
"319";"360050162002";60;11;92;12;17;192
"320";"360050163001";4;50;29;6;24;113
"321";"360050164001";60;166;75;13;19;333
"322";"360050165001";94;262;316;68;17;757
"323";"360050166001";239;69;274;25;23;630
"324";"360050166002";28;10;73;27;29;167
"325";"360050167001";13;5;51;6;6;81
"326";"360050167002";136;94;263;57;11;561
"327";"360050169001";102;112;170;14;10;408
"328";"360050171001";73;281;79;18;55;506
"329";"360050173001";44;79;82;6;8;219
"330";"360050173002";167;104;64;108;11;454
"331";"360050173003";278;55;55;32;27;447
"332";"360050173004";68;50;53;3;11;185
"333";"360050175001";26;30;29;27;7;119
"334";"360050175002";12;35;106;31;7;191
"335";"360050175003";112;38;34;13;5;202
"336";"360050175004";90;65;45;8;26;234
"337";"360050175005";19;19;9;0;4;51
"338";"360050175006";38;10;42;4;4;98
"339";"360050177011";105;127;185;14;7;438
"340";"360050177012";73;78;31;11;5;198
"341";"360050177013";1188;69;65;27;33;1382
"342";"360050177021";22;13;49;8;1;93
"343";"360050177022";94;106;225;51;12;488
"344";"360050177023";34;104;108;8;22;276
"345";"360050177024";48;45;48;6;5;152
"346";"360050179011";112;480;71;13;15;691
"347";"360050179012";28;14;21;0;1;64
"348";"360050179013";89;62;39;5;18;213
"349";"360050179021";112;162;111;9;60;454
"350";"360050179022";28;56;116;8;12;220
"351";"360050179023";31;723;1165;1;32;1952
"352";"360050181011";87;54;102;28;10;281
"353";"360050181012";55;4;30;5;5;99
"354";"360050181013";45;79;60;2;5;191
"355";"360050181021";46;42;48;16;5;157
"356";"360050181022";79;71;25;16;15;206
"357";"360050181023";87;39;30;0;8;164
"358";"360050181024";106;120;37;4;14;281
"359";"360050183011";60;84;49;4;7;204
"360";"360050183012";63;73;43;3;2;184
"361";"360050183013";136;728;92;9;22;987
"362";"360050183021";87;574;61;13;23;758
"363";"360050183022";28;291;74;5;21;419
"364";"360050183023";147;214;194;2;13;570
"365";"360050184001";136;2;87;15;5;245
"366";"360050184002";100;18;167;39;15;339
"367";"360050184003";18;64;170;29;24;305
"368";"360050184004";43;30;174;15;18;280
"369";"360050185001";311;396;342;79;65;1193
"370";"360050185002";79;45;49;14;6;193
"371";"360050185003";91;69;245;22;24;451
"372";"360050185004";60;31;101;7;9;208
"373";"360050185005";106;48;87;18;10;269
"374";"360050189001";126;130;240;19;15;530
"375";"360050189002";34;87;49;4;2;176
"376";"360050189003";1158;1307;1699;34;418;4616
"377";"360050189004";301;196;435;26;30;988
"378";"360050193001";292;265;71;23;24;675
"379";"360050193002";45;12;12;0;1;70
"380";"360050193003";16;24;3;2;0;45
"381";"360050193004";138;118;164;12;74;506
"382";"360050194001";176;113;403;51;77;820
"383";"360050195001";107;180;96;19;12;414
"384";"360050195002";194;150;90;19;58;511
"385";"360050195003";97;286;38;13;9;443
"386";"360050195004";195;272;35;21;13;536
"387";"360050197001";34;117;55;3;14;223
"388";"360050197002";88;120;50;3;6;267
"389";"360050197003";101;422;30;6;22;581
"390";"360050197004";38;49;25;7;3;122
"391";"360050197005";83;72;44;8;69;276
"392";"360050199001";46;222;41;4;9;322
"393";"360050199002";254;190;40;0;15;499
"394";"360050199003";40;21;16;5;1;83
"395";"360050199004";135;125;119;19;7;405
"396";"360050199005";65;185;27;16;19;312
"397";"360050199006";284;168;167;19;10;648
"398";"360050200001";72;41;253;7;26;399
"399";"360050200002";11;11;227;14;6;269
"400";"360050200003";24;17;233;31;16;321
"401";"360050200004";80;34;117;2;11;244
"402";"360050201001";161;332;348;44;21;906
"403";"360050201002";59;88;111;19;5;282
"404";"360050201003";70;105;143;16;7;341
"405";"360050202001";29;6;109;9;11;164
"406";"360050202002";93;76;175;20;20;384
"407";"360050204001";38;37;79;2;8;164
"408";"360050204002";14;5;146;5;5;175
"409";"360050204003";184;38;206;35;17;480
"410";"360050205011";136;677;117;16;9;955
"411";"360050205012";324;126;242;20;4;716
"412";"360050205013";34;33;125;6;1;199
"413";"360050205014";114;73;335;21;8;551
"414";"360050205021";29;292;88;9;8;426
"415";"360050205022";21;4;98;10;3;136
"416";"360050205023";27;5;106;6;6;150
"417";"360050206011";28;14;116;12;17;187
"418";"360050206012";42;12;336;24;23;437
"419";"360050209001";43;167;67;36;4;317
"420";"360050209002";91;335;54;20;9;509
"421";"360050209003";31;71;32;10;4;148
"422";"360050209004";186;179;78;8;10;461
"423";"360050210011";19;1;39;0;0;59
"424";"360050210012";61;4;7;2;3;77
"425";"360050210013";32;9;8;0;3;52
"426";"360050210014";25;13;60;3;5;106
"427";"360050210015";204;7;32;5;2;250
"428";"360050210016";13;3;21;3;2;42
"429";"360050210021";33;13;45;9;4;104
"430";"360050210022";276;11;21;5;3;316
"431";"360050210023";0;0;1;0;0;1
"432";"360050210024";0;0;4;1;0;5
"433";"360050210025";15;2;10;1;0;28
"434";"360050210026";417;29;13;1;4;464
"435";"360050210027";1;0;1;4;0;6
"436";"360050211001";243;97;198;14;8;560
"437";"360050211002";63;102;222;24;19;430
"438";"360050211003";25;45;106;14;4;194
"439";"360050211004";1;15;5;1;0;22
"440";"360050212001";4;1;3;1;1;10
"441";"360050212002";9;8;2;0;0;19
"442";"360050212004";30;1;13;1;1;46
"443";"360050212005";4;1;0;0;2;7
"444";"360050213011";16;92;13;1;1;123
"445";"360050213012";12;9;65;8;11;105
"446";"360050213021";153;144;122;29;7;455
"447";"360050213022";16;67;228;36;14;361
"448";"360050213023";32;25;39;2;3;101
"449";"360050213024";44;27;143;4;0;218
"450";"360050215011";46;83;69;10;9;217
"451";"360050215012";188;268;162;14;9;641
"452";"360050215013";36;37;158;14;12;257
"453";"360050215021";91;128;438;12;15;684
"454";"360050215022";60;111;66;21;7;265
"455";"360050215023";61;36;230;25;3;355
"456";"360050215024";22;11;228;20;4;285
"457";"360050215025";29;22;58;5;5;119
"458";"360050216011";72;95;150;13;22;352
"459";"360050216012";23;30;151;10;12;226
"460";"360050216013";41;26;43;24;4;138
"461";"360050216014";29;7;143;16;5;200
"462";"360050216021";35;11;64;1;8;119
"463";"360050216022";23;4;12;4;6;49
"464";"360050216023";71;15;73;5;3;167
"465";"360050216024";12;1;14;2;4;33
"466";"360050216025";14;7;46;7;7;81
"467";"360050217001";226;1105;188;106;17;1642
"468";"360050217002";134;55;95;11;16;311
"469";"360050217003";26;86;75;9;16;212
"470";"360050217004";179;184;58;13;6;440
"471";"360050218001";40;151;16;23;14;244
"472";"360050218002";143;95;162;21;10;431
"473";"360050218003";57;20;801;49;18;945
"474";"360050218004";18;12;139;23;10;202
"475";"360050218005";118;114;129;9;26;396
"476";"360050219001";108;250;371;113;42;884
"477";"360050220001";58;120;251;34;23;486
"478";"360050221011";89;6;20;2;0;117
"479";"360050221012";44;202;57;2;6;311
"480";"360050221013";267;250;122;5;11;655
"481";"360050221021";115;356;604;26;28;1129
"482";"360050221022";53;145;167;11;11;387
"483";"360050221023";86;68;51;3;13;221
"484";"360050222001";351;69;119;11;19;569
"485";"360050222002";20;7;81;10;8;126
"486";"360050222003";23;124;122;13;24;306
"487";"360050222004";45;4;39;1;11;100
"488";"360050223001";28;251;35;2;11;327
"489";"360050223002";42;186;23;4;5;260
"490";"360050223003";102;526;40;13;16;697
"491";"360050223004";69;168;10;7;3;257
"492";"360050224011";17;50;13;4;3;87
"493";"360050224012";454;225;100;11;22;812
"494";"360050224031";38;26;77;6;30;177
"495";"360050224032";86;32;63;5;35;221
"496";"360050224041";159;37;50;5;10;261
"497";"360050224042";162;33;38;1;11;245
"498";"360050224043";544;34;65;0;15;658
"499";"360050225001";77;197;52;16;22;364
"500";"360050225002";54;195;118;39;10;416
"501";"360050225003";104;69;103;21;19;316
"502";"360050225004";65;155;49;9;13;291
"503";"360050225005";62;83;19;10;13;187
"504";"360050225006";67;54;30;3;7;161
"505";"360050227011";98;124;196;12;12;442
"506";"360050227012";176;423;141;37;19;796
"507";"360050227013";65;137;245;65;11;523
"508";"360050227021";132;180;72;26;28;438
"509";"360050227031";34;124;49;2;19;228
"510";"360050228001";73;38;186;6;18;321
"511";"360050228002";341;66;90;1;13;511
"512";"360050228003";156;82;39;5;7;289
"513";"360050228004";104;45;20;1;10;180
"514";"360050229011";83;154;60;15;25;337
"515";"360050229012";196;150;24;5;14;389
"516";"360050229013";94;286;69;11;9;469
"517";"360050229014";43;44;113;18;2;220
"518";"360050229015";57;89;108;31;11;296
"519";"360050229021";75;497;63;15;9;659
"520";"360050229022";16;34;64;14;18;146
"521";"360050229023";166;488;27;2;15;698
"522";"360050230001";80;78;300;11;19;488
"523";"360050230002";122;37;347;3;25;534
"524";"360050231001";163;1101;130;33;34;1461
"525";"360050232001";70;23;218;9;17;337
"526";"360050232002";30;264;193;5;5;497
"527";"360050233011";74;61;30;4;13;182
"528";"360050233012";110;348;122;8;26;614
"529";"360050233013";48;105;58;6;4;221
"530";"360050233014";112;41;30;14;3;200
"531";"360050233021";656;627;117;18;32;1450
"532";"360050233022";141;372;107;23;26;669
"533";"360050235011";98;156;75;15;63;407
"534";"360050235012";55;117;8;4;14;198
"535";"360050235013";1187;538;51;1;2;1779
"536";"360050235021";115;368;40;3;8;534
"537";"360050235022";81;83;43;1;7;215
"538";"360050235023";71;112;74;7;14;278
"539";"360050235024";243;308;303;6;35;895
"540";"360050236001";18;107;105;1;10;241
"541";"360050236002";11;26;71;6;14;128
"542";"360050237021";44;142;76;3;60;325
"543";"360050237031";193;260;94;16;49;612
"544";"360050237032";47;61;61;9;18;196
"545";"360050237033";144;121;63;8;10;346
"546";"360050237041";30;131;64;2;6;233
"547";"360050237042";329;255;64;2;14;664
"548";"360050237043";36;112;28;0;21;197
"549";"360050238001";8;101;106;7;16;238
"550";"360050238002";113;63;464;12;55;707
"551";"360050238003";35;39;280;16;15;385
"552";"360050239001";181;415;99;21;45;761
"553";"360050239002";381;619;112;8;52;1172
"554";"360050239003";80;274;161;14;19;548
"555";"360050239004";319;320;86;10;53;788
"556";"360050239005";39;384;36;3;14;476
"557";"360050239006";53;233;80;6;6;378
"558";"360050240001";104;162;537;48;34;885
"559";"360050240002";58;73;125;5;9;270
"560";"360050240003";94;84;548;15;7;748
"561";"360050241001";121;237;101;6;14;479
"562";"360050241002";24;38;70;8;17;157
"563";"360050241003";77;59;46;15;12;209
"564";"360050241004";44;97;28;16;2;187
"565";"360050241005";56;306;57;11;15;445
"566";"360050243001";44;145;168;10;30;397
"567";"360050243002";39;94;227;12;5;377
"568";"360050243003";22;46;53;6;1;128
"569";"360050243004";68;66;217;21;17;389
"570";"360050244001";21;40;157;21;5;244
"571";"360050244002";115;19;293;31;20;478
"572";"360050245011";82;193;118;9;9;411
"573";"360050245012";52;304;222;11;11;600
"574";"360050245013";45;212;46;8;4;315
"575";"360050245014";87;433;79;9;3;611
"576";"360050245021";32;117;95;10;3;257
"577";"360050245022";11;45;11;5;5;77
"578";"360050245023";98;303;312;13;25;751
"579";"360050246001";44;7;574;5;10;640
"580";"360050246002";65;19;358;14;13;469
"581";"360050247001";2;29;10;3;1;45
"582";"360050247002";246;53;33;4;5;341
"583";"360050248001";42;7;89;12;7;157
"584";"360050248002";91;3;566;14;7;681
"585";"360050248003";10;12;375;21;8;426
"586";"360050249001";60;118;306;27;7;518
"587";"360050250001";58;1;135;5;5;204
"588";"360050250002";7;1;130;9;9;156
"589";"360050251001";123;273;76;17;23;512
"590";"360050251002";56;202;64;11;8;341
"591";"360050251003";33;70;129;4;25;261
"592";"360050251004";8;15;66;9;3;101
"593";"360050251005";180;651;100;16;20;967
"594";"360050251006";52;55;78;3;7;195
"595";"360050251007";45;11;35;8;2;101
"596";"360050252001";45;19;368;19;14;465
"597";"360050252002";48;4;256;23;27;358
"598";"360050253001";1192;114;46;10;36;1398
"599";"360050253002";243;83;76;3;12;417
"600";"360050253003";64;60;44;4;13;185
"601";"360050253004";133;45;89;5;17;289
"602";"360050254001";242;15;126;14;22;419
"603";"360050254002";31;7;274;9;13;334
"604";"360050255001";294;293;153;27;16;783
"605";"360050255002";168;283;174;38;18;681
"606";"360050255003";204;78;162;20;22;486
"607";"360050256001";67;37;107;68;16;295
"608";"360050256002";44;32;527;65;20;688
"609";"360050257001";43;811;284;18;1;1157
"610";"360050261001";32;145;134;28;12;351
"611";"360050263001";88;341;30;6;46;511
"612";"360050263002";47;62;19;0;7;135
"613";"360050263003";83;42;99;5;10;239
"614";"360050263004";14;29;48;2;5;98
"615";"360050263005";147;130;64;15;13;369
"616";"360050264001";22;6;177;16;15;236
"617";"360050264002";47;7;194;9;16;273
"618";"360050264003";113;11;319;25;20;488
"619";"360050264004";111;7;248;31;34;431
"620";"360050265001";38;36;837;35;54;1000
"621";"360050265002";245;99;234;38;37;653
"622";"360050265003";202;296;32;4;27;561
"623";"360050265004";113;42;263;27;34;479
"624";"360050266011";41;4;96;13;14;168
"625";"360050266012";50;44;70;6;7;177
"626";"360050266013";54;2;147;24;5;232
"627";"360050266021";59;10;125;8;19;221
"628";"360050266022";69;59;209;18;45;400
"629";"360050266023";45;19;241;6;29;340
"630";"360050266024";59;5;59;8;6;137
"631";"360050266025";104;7;293;10;7;421
"632";"360050267011";649;73;317;3;8;1050
"633";"360050267012";89;153;337;3;7;589
"634";"360050267013";36;97;488;18;31;670
"635";"360050267021";165;74;1449;33;42;1763
"636";"360050267022";8;65;2701;17;9;2800
"637";"360050267023";123;91;2442;8;24;2688
"638";"360050267024";5;6;112;1;4;128
"639";"360050267025";14;10;271;2;4;301
"640";"360050267026";123;43;1007;13;19;1205
"641";"360050269001";1395;301;508;33;28;2265
"642";"360050269002";30;19;211;9;18;287
"643";"360050269003";34;6;133;17;3;193
"644";"360050273001";54;90;59;22;10;235
"645";"360050273002";129;500;1040;19;100;1788
"646";"360050273003";256;69;649;20;8;1002
"647";"360050273004";185;105;224;15;22;551
"648";"360050274011";31;5;45;9;7;97
"649";"360050274012";47;7;97;34;18;203
"650";"360050274013";44;5;76;13;15;153
"651";"360050274014";197;6;332;52;18;605
"652";"360050274020";0;0;3;0;0;3
"653";"360050274021";8;5;63;9;25;110
"654";"360050274022";16;77;41;14;28;176
"655";"360050274023";39;69;193;13;25;339
"656";"360050276000";0;1;0;0;0;1
"657";"360050276001";36;24;141;24;17;242
"658";"360050277001";71;447;104;1;11;634
"659";"360050277002";193;35;22;1;7;258
"660";"360050277003";190;81;370;7;3;651
"661";"360050277004";323;259;118;4;8;712
"662";"360050279001";68;111;214;33;13;439
"663";"360050279002";76;29;438;17;8;568
"664";"360050279003";148;13;221;3;7;392
"665";"360050279004";66;3;195;6;4;274
"666";"360050279005";6;1;68;0;5;80
"667";"360050279006";175;39;337;10;10;571
"668";"360050281001";144;22;111;6;1;284
"669";"360050281002";47;7;93;2;1;150
"670";"360050281003";3;5;75;7;2;92
"671";"360050283001";41;37;78;7;48;211
"672";"360050283002";250;61;109;9;29;458
"673";"360050284001";16;16;121;19;8;180
"674";"360050285001";147;27;118;3;21;316
"675";"360050285002";16;9;52;0;7;84
"676";"360050285003";110;151;133;8;14;416
"677";"360050285004";161;19;156;14;10;360
"678";"360050286001";13;12;139;8;25;197
"679";"360050286002";33;30;149;25;18;255
"680";"360050287001";50;18;162;20;21;271
"681";"360050287002";36;13;6;0;13;68
"682";"360050287003";137;64;34;6;6;247
"683";"360050288001";93;23;97;11;11;235
"684";"360050288002";9;15;57;14;6;101
"685";"360050288003";398;16;79;0;10;503
"686";"360050288004";3;1;90;11;2;107
"687";"360050289001";108;116;381;24;38;667
"688";"360050289002";91;173;8;0;13;285
"689";"360050289003";25;200;177;11;26;439
"690";"360050289004";49;47;116;2;3;217
"691";"360050293011";1;2;12;2;3;20
"692";"360050293012";18;19;80;6;20;143
"693";"360050293021";5;212;32;5;8;262
"694";"360050293022";11;11;70;4;2;98
"695";"360050293023";73;6;145;3;21;248
"696";"360050293024";68;17;260;7;8;360
"697";"360050295001";45;69;213;10;22;359
"698";"360050295002";485;101;296;1;15;898
"699";"360050295003";38;14;76;1;2;131
"700";"360050295004";34;41;48;3;27;153
"701";"360050296001";259;59;580;34;45;977
"702";"360050296002";9;14;43;6;21;93
"703";"360050297001";9;20;204;16;23;272
"704";"360050297002";95;17;82;2;4;200
"705";"360050297003";39;12;95;0;1;147
"706";"360050300001";43;40;122;4;67;276
"707";"360050300002";110;16;373;20;14;533
"708";"360050300003";36;34;182;7;5;264
"709";"360050300004";62;16;96;6;5;185
"710";"360050300005";29;15;56;16;4;120
"711";"360050300006";23;5;208;14;4;254
"712";"360050301001";11;9;18;4;3;45
"713";"360050301002";0;1;33;0;0;34
"714";"360050302001";10;1;14;3;1;29
"715";"360050302002";5;3;12;2;3;25
"716";"360050302003";9;5;200;6;6;226
"717";"360050302004";0;0;7;1;1;9
"718";"360050302005";23;4;86;7;1;121
"719";"360050302006";0;1;4;1;0;6
"720";"360050307011";9;9;122;2;0;142
"721";"360050307012";23;36;33;2;3;97
"722";"360050307013";34;43;33;6;3;119
"723";"360050307014";2;8;20;1;3;34
"724";"360050309001";0;6;15;0;3;24
"725";"360050309002";6;64;23;2;21;116
"726";"360050309003";29;59;145;0;0;233
"727";"360050309004";7;167;257;4;5;440
"728";"360050310001";16;24;101;14;12;167
"729";"360050310002";22;36;236;12;33;339
"730";"360050310003";52;7;111;20;13;203
"731";"360050312001";17;5;113;15;17;167
"732";"360050312002";6;2;42;6;3;59
"733";"360050314001";9;7;70;9;11;106
"734";"360050314002";15;1;44;3;12;75
"735";"360050316001";100;19;128;23;18;288
"736";"360050316002";6;8;55;10;44;123
"737";"360050318001";27;2;99;3;7;138
"738";"360050318002";17;9;108;20;25;179
"739";"360050319001";3;0;4;1;0;8
"740";"360050323001";32;0;33;6;3;74
"741";"360050323002";10;16;43;0;2;71
"742";"360050323003";32;14;29;9;1;85
"743";"360050323004";112;16;235;15;7;385
"744";"360050324001";129;29;18;7;8;191
"745";"360050324002";147;42;110;8;13;320
"746";"360050326001";72;28;114;11;15;240
"747";"360050326002";29;8;121;20;11;189
"748";"360050326003";8;13;49;5;36;111
"749";"360050328001";19;3;48;9;13;92
"750";"360050328002";86;34;12;3;11;146
"751";"360050328003";65;14;59;8;12;158
"752";"360050328004";110;8;107;7;12;244
"753";"360050330001";85;50;72;4;30;241
"754";"360050330002";284;86;244;12;16;642
"755";"360050330003";89;48;35;4;10;186
"756";"360050330004";64;9;40;0;13;126
"757";"360050332011";37;42;103;5;4;191
"758";"360050332012";118;110;426;4;8;666
"759";"360050332013";86;24;201;2;7;320
"760";"360050332021";102;51;45;3;3;204
"761";"360050332022";151;32;22;3;10;218
"762";"360050332023";107;14;46;0;6;173
"763";"360050332024";36;3;11;1;4;55
"764";"360050334001";52;223;174;9;49;507
"765";"360050335001";2;1;29;2;5;39
"766";"360050335002";94;16;510;10;9;639
"767";"360050335003";20;23;153;0;4;200
"768";"360050336001";29;29;146;20;10;234
"769";"360050336002";65;45;17;10;61;198
"770";"360050336003";48;8;41;3;1;101
"771";"360050336004";67;11;36;10;2;126
"772";"360050336005";150;19;5;1;5;180
"773";"360050336006";107;6;40;9;8;170
"774";"360050337001";15;1;164;2;1;183
"775";"360050337002";36;48;143;16;16;259
"776";"360050337003";15;14;179;17;14;239
"777";"360050338001";73;62;57;4;13;209
"778";"360050338002";132;37;41;9;14;233
"779";"360050338003";29;20;254;4;11;318
"780";"360050338004";68;15;143;19;35;280
"781";"360050340001";55;8;118;2;6;189
"782";"360050340002";85;32;132;6;5;260
"783";"360050340003";92;15;65;8;11;191
"784";"360050340004";136;21;54;8;17;236
"785";"360050342001";30;8;120;19;4;181
"786";"360050342002";98;36;143;10;16;303
"787";"360050343001";13;20;92;12;13;150
"788";"360050343002";78;56;145;27;10;316
"789";"360050344001";23;272;41;7;9;352
"790";"360050344002";75;11;128;35;17;266
"791";"360050345001";44;35;210;13;7;309
"792";"360050345002";23;59;352;60;9;503
"793";"360050345003";14;2;380;4;7;407
"794";"360050348001";15;697;190;39;8;949
"795";"360050348002";106;41;11;6;7;171
"796";"360050348003";56;10;248;20;5;339
"797";"360050348004";23;5;72;12;14;126
"798";"360050350001";35;15;135;22;17;224
"799";"360050350002";22;8;195;33;7;265
"800";"360050351001";2;13;86;6;2;109
"801";"360050351002";101;13;107;29;7;257
"802";"360050351003";21;14;82;15;4;136
"803";"360050356001";21;5;82;24;7;139
"804";"360050356002";48;101;164;50;14;377
"805";"360050358001";88;23;173;67;17;368
"806";"360050358002";52;9;126;32;15;234
"807";"360050358003";45;26;143;18;6;238
"808";"360050358004";37;9;112;44;11;213
"809";"360050358005";13;0;55;15;3;86
"810";"360050358006";24;23;37;1;13;98
"811";"360050358007";14;77;46;3;6;146
"812";"360050359001";440;185;214;40;46;925
"813";"360050360001";22;41;113;24;13;213
"814";"360050360002";28;7;183;45;10;273
"815";"360050360003";34;3;58;20;1;116
"816";"360050361001";76;53;79;4;12;224
"817";"360050361002";32;43;289;11;5;380
"818";"360050361003";10;3;28;4;13;58
"819";"360050361004";30;19;9;6;2;66
"820";"360050361005";233;270;37;7;0;547
"821";"360050363001";110;28;38;9;4;189
"822";"360050363002";10;10;10;2;1;33
"823";"360050363003";114;81;69;10;24;298
"824";"360050363004";162;100;125;13;11;411
"825";"360050363005";35;93;45;3;8;184
"826";"360050363006";84;6;52;8;3;153
"827";"360050364001";12;20;69;12;12;125
"828";"360050364002";8;22;93;1;6;130
"829";"360050364003";8;14;146;22;17;207
"830";"360050365011";306;24;48;6;10;394
"831";"360050365012";49;36;38;8;9;140
"832";"360050365013";58;31;36;10;13;148
"833";"360050365021";26;58;54;12;7;157
"834";"360050365022";56;99;76;11;22;264
"835";"360050367001";32;41;94;39;10;216
"836";"360050367002";61;30;19;8;6;124
"837";"360050368001";32;8;77;15;13;145
"838";"360050368002";40;4;103;9;9;165
"839";"360050369011";123;179;66;26;24;418
"840";"360050369012";108;142;101;32;8;391
"841";"360050369021";14;15;8;9;6;52
"842";"360050369022";96;40;25;15;6;182
"843";"360050370001";33;7;108;19;10;177
"844";"360050370002";94;23;101;9;16;243
"845";"360050370003";19;3;66;4;16;108
"846";"360050371001";54;43;149;2;7;255
"847";"360050371002";109;54;84;22;11;280
"848";"360050371003";96;36;66;19;6;223
"849";"360050371004";42;49;52;14;15;172
"850";"360050372001";39;17;77;4;8;145
"851";"360050372002";168;34;118;38;9;367
"852";"360050373001";71;25;100;13;7;216
"853";"360050373002";198;123;97;29;9;456
"854";"360050373003";63;64;46;19;22;214
"855";"360050373004";150;91;41;33;8;323
"856";"360050374001";54;68;54;4;33;213
"857";"360050374002";106;129;161;17;42;455
"858";"360050374003";63;5;72;1;6;147
"859";"360050374004";70;1;8;2;3;84
"860";"360050375041";73;71;74;29;24;271
"861";"360050375042";30;84;16;13;10;153
"862";"360050375043";407;294;105;39;7;852
"863";"360050376001";123;35;52;9;2;221
"864";"360050376002";46;15;128;39;12;240
"865";"360050378001";59;35;158;9;19;280
"866";"360050378002";4;84;17;1;7;113
"867";"360050378003";35;79;139;10;35;298
"868";"360050379001";69;677;79;28;24;877
"869";"360050379002";102;15;27;5;8;157
"870";"360050379003";53;51;17;4;11;136
"871";"360050379004";38;24;85;10;4;161
"872";"360050379005";75;96;105;16;15;307
"873";"360050380001";22;6;53;0;4;85
"874";"360050380002";16;1;256;5;13;291
"875";"360050380003";107;18;101;12;12;250
"876";"360050380004";217;19;86;17;19;358
"877";"360050381001";99;14;27;3;2;145
"878";"360050381002";29;46;98;0;2;175
"879";"360050381003";108;39;93;5;10;255
"880";"360050381004";106;46;61;4;5;222
"881";"360050381005";42;499;271;26;10;848
"882";"360050381006";113;516;57;14;41;741
"883";"360050382001";63;15;165;22;17;282
"884";"360050382002";41;11;96;19;13;180
"885";"360050383011";826;156;155;7;24;1168
"886";"360050383012";45;67;75;22;6;215
"887";"360050383013";79;78;65;5;10;237
"888";"360050383021";741;234;96;17;22;1110
"889";"360050383022";113;161;58;22;9;363
"890";"360050383023";243;57;59;18;28;405
"891";"360050385001";157;365;112;18;21;673
"892";"360050385002";34;54;63;15;23;189
"893";"360050385003";42;319;85;12;17;475
"894";"360050385004";283;126;107;28;25;569
"895";"360050386001";52;27;122;36;16;253
"896";"360050386002";54;9;229;27;7;326
"897";"360050386003";36;119;43;11;6;215
"898";"360050386004";33;17;92;11;7;160
"899";"360050386005";67;15;47;14;9;152
"900";"360050386006";102;23;38;4;27;194
"901";"360050386007";54;6;14;2;4;80
"902";"360050386008";44;5;25;5;4;83
"903";"360050387001";693;39;51;3;21;807
"904";"360050387002";72;113;52;7;8;252
"905";"360050387003";61;24;33;6;4;128
"906";"360050388001";31;6;52;8;6;103
"907";"360050388002";30;10;187;9;8;244
"908";"360050389001";204;33;67;10;18;332
"909";"360050389002";62;60;17;8;8;155
"910";"360050389003";101;306;126;17;36;586
"911";"360050389004";143;34;70;4;5;256
"912";"360050389005";72;77;15;5;12;181
"913";"360050390001";54;7;236;26;33;356
"914";"360050390002";229;28;116;34;12;419
"915";"360050391001";52;27;58;17;27;181
"916";"360050391002";129;278;88;30;13;538
"917";"360050391003";56;41;61;23;4;185
"918";"360050391004";49;722;26;11;24;832
"919";"360050391005";51;69;31;10;7;168
"920";"360050391006";54;44;17;12;12;139
"921";"360050392001";9;5;111;2;14;141
"922";"360050392002";66;10;109;1;31;217
"923";"360050393001";136;47;142;26;9;360
"924";"360050393002";144;79;47;13;13;296
"925";"360050393003";32;19;66;9;4;130
"926";"360050393004";54;49;19;14;15;151
"927";"360050393005";13;6;48;1;7;75
"928";"360050393006";12;30;72;8;21;143
"929";"360050394001";135;48;75;9;12;279
"930";"360050394002";59;15;191;14;22;301
"931";"360050394003";4;12;16;2;2;36
"932";"360050394004";38;22;150;11;15;236
"933";"360050395001";140;206;110;51;18;525
"934";"360050395002";48;40;80;27;12;207
"935";"360050395003";378;306;136;50;27;897
"936";"360050395004";302;172;179;79;51;783
"937";"360050396001";25;12;204;14;6;261
"938";"360050396002";49;22;138;4;8;221
"939";"360050396003";58;14;150;20;29;271
"940";"360050396004";42;67;269;4;11;393
"941";"360050397001";26;24;86;12;28;176
"942";"360050397002";55;224;36;4;40;359
"943";"360050398001";39;13;59;16;14;141
"944";"360050398002";72;5;88;10;14;189
"945";"360050398003";20;2;25;12;6;65
"946";"360050399011";61;65;50;6;21;203
"947";"360050399012";75;76;19;1;8;179
"948";"360050399013";61;55;29;12;8;165
"949";"360050399014";49;28;25;1;23;126
"950";"360050399015";287;310;92;19;13;721
"951";"360050399021";51;38;43;8;31;171
"952";"360050399022";46;127;9;5;8;195
"953";"360050399023";295;384;43;5;12;739
"954";"360050399024";43;40;10;3;2;98
"955";"360050399025";25;98;34;3;6;166
"956";"360050401001";77;55;26;2;7;167
"957";"360050401002";271;208;86;3;141;709
"958";"360050401003";95;38;42;5;27;207
"959";"360050401004";41;26;11;5;6;89
"960";"360050401005";76;305;95;3;16;495
"961";"360050403021";312;139;62;8;77;598
"962";"360050403022";81;34;18;0;2;135
"963";"360050403023";14;50;17;0;1;82
"964";"360050403031";95;92;93;16;14;310
"965";"360050403032";146;103;139;4;13;405
"966";"360050403033";89;150;85;12;8;344
"967";"360050403041";125;285;40;3;26;479
"968";"360050403042";117;16;37;2;19;191
"969";"360050403043";61;50;60;5;684;860
"970";"360050404001";43;38;195;36;14;326
"971";"360050404002";14;3;61;14;1;93
"972";"360050404003";7;1;108;5;8;129
"973";"360050405011";467;1031;150;16;39;1703
"974";"360050405012";20;47;91;10;11;179
"975";"360050405013";71;68;127;10;13;289
"976";"360050405021";29;57;43;14;7;150
"977";"360050405022";47;13;13;3;7;83
"978";"360050405023";126;53;81;11;16;287
"979";"360050405024";53;13;20;5;9;100
"980";"360050405025";98;77;55;22;2;254
"981";"360050405026";38;6;296;15;3;358
"982";"360050406001";35;12;216;9;22;294
"983";"360050406002";48;35;80;32;17;212
"984";"360050406003";44;13;72;27;14;170
"985";"360050407011";130;36;26;10;5;207
"986";"360050407012";47;16;22;7;16;108
"987";"360050407013";41;54;79;18;25;217
"988";"360050407021";42;81;74;2;9;208
"989";"360050407022";183;196;95;9;6;489
"990";"360050407023";261;240;99;16;20;636
"991";"360050407024";444;349;562;13;5;1373
"992";"360050407025";86;20;45;2;4;157
"993";"360050408001";21;6;31;1;1;60
"994";"360050408002";69;41;64;3;9;186
"995";"360050408003";230;129;49;1;9;418
"996";"360050408004";118;32;132;12;9;303
"997";"360050409001";175;405;933;26;55;1594
"998";"360050409002";41;236;81;7;9;374
"999";"360050411001";112;218;45;3;15;393
"1000";"360050411002";132;29;48;1;14;224
"1001";"360050411003";88;23;89;4;16;220
"1002";"360050413001";363;157;584;20;25;1149
"1003";"360050413002";20;4;42;2;5;73
"1004";"360050413003";125;47;71;39;7;289
"1005";"360050413004";142;135;77;9;16;379
"1006";"360050413005";124;55;24;3;9;215
"1007";"360050413006";94;19;70;14;7;204
"1008";"360050413007";149;52;103;9;32;345
"1009";"360050414001";132;46;253;51;10;492
"1010";"360050414002";57;24;148;11;26;266
"1011";"360050414003";47;44;136;32;19;278
"1012";"360050414004";68;27;159;38;11;303
"1013";"360050415001";140;38;59;14;9;260
"1014";"360050415002";62;17;46;3;2;130
"1015";"360050415003";58;6;41;5;2;112
"1016";"360050415004";9;21;116;13;23;182
"1017";"360050415005";162;92;114;18;4;390
"1018";"360050415006";132;76;278;4;16;506
"1019";"360050418001";21;17;169;33;41;281
"1020";"360050418002";92;26;384;57;12;571
"1021";"360050418003";151;13;68;15;6;253
"1022";"360050418004";70;3;109;15;5;202
"1023";"360050419001";56;74;150;14;14;308
"1024";"360050419002";131;139;174;3;6;453
"1025";"360050419003";65;9;125;5;1;205
"1026";"360050419004";145;76;168;13;29;431
"1027";"360050419005";98;50;78;4;13;243
"1028";"360050419006";118;204;138;3;14;477
"1029";"360050419007";66;29;94;2;16;207
"1030";"360050420001";69;35;88;10;13;215
"1031";"360050420002";472;371;217;13;129;1202
"1032";"360050420003";94952;30;702;16;14;95714
"1033";"360050421001";15;9;141;1;5;171
"1034";"360050421002";386;112;62;13;27;600
"1035";"360050421003";83;26;34;32;4;179
"1036";"360050421004";171;101;127;13;12;424
"1037";"360050421005";103;55;48;10;15;231
"1038";"360050422001";156;55;384;13;57;665
"1039";"360050422002";224;28;202;4;247;705
"1040";"360050423001";44;25;81;2;4;156
"1041";"360050423002";83;51;927;11;16;1088
"1042";"360050423003";63;58;650;22;24;817
"1043";"360050424001";32;3;133;17;22;207
"1044";"360050424002";43;6;106;10;8;173
"1045";"360050425001";17;39;79;5;15;155
"1046";"360050425002";36;227;157;18;10;448
"1047";"360050425003";78;69;435;11;24;617
"1048";"360050425004";80;4;77;1;5;167
"1049";"360050425005";53;66;113;20;13;265
"1050";"360050425006";42;21;45;9;21;138
"1051";"360050425007";114;43;144;16;38;355
"1052";"360050426001";15;17;161;55;7;255
"1053";"360050426002";24;65;402;33;27;551
"1054";"360050426003";13;12;104;21;7;157
"1055";"360050426004";21;9;74;29;5;138
"1056";"360050426005";7;3;112;16;3;141
"1057";"360050426006";87;24;78;18;6;213
"1058";"360050428001";21;6;82;29;10;148
"1059";"360050428002";29;3;178;38;15;263
"1060";"360050429011";146;21;296;18;16;497
"1061";"360050429012";193;41;719;13;23;989
"1062";"360050429013";72;33;81;10;12;208
"1063";"360050429021";268;169;326;20;50;833
"1064";"360050429022";14;5;127;4;5;155
"1065";"360050429023";86;6;235;9;6;342
"1066";"360050430001";25;3;108;26;8;170
"1067";"360050430002";7;2;83;31;5;128
"1068";"360050430003";31;12;108;22;3;176
"1069";"360050431001";198;115;10;0;5;328
"1070";"360050431002";131;130;187;2;284;734
"1071";"360050431003";48;64;109;5;5;231
"1072";"360050431004";89;167;80;2;30;368
"1073";"360050431005";333;221;924;13;57;1548
"1074";"360050431006";236;148;100;5;12;501
"1075";"360050431007";171;37;74;2;8;292
"1076";"360050431008";52;29;48;6;8;143
"1077";"360050434001";73;49;182;34;20;358
"1078";"360050434002";27;21;68;18;6;140
"1079";"360050434003";54;756;789;47;19;1665
"1080";"360050434004";149;42;104;7;24;326
"1081";"360050435001";389;1652;716;114;206;3077
"1082";"360050436001";89;18;154;54;8;323
"1083";"360050436002";21;7;362;45;5;440
"1084";"360050442001";33;97;28;4;7;169
"1085";"360050442002";167;4;140;15;10;336
"1086";"360050442003";6;3;102;22;2;135
"1087";"360050442004";25;3;80;54;6;168
"1088";"360050442005";21;4;66;30;6;127
"1089";"360050444001";27;27;176;28;22;280
"1090";"360050444002";27;4;52;20;6;109
"1091";"360050444003";46;4;49;17;10;126
"1092";"360050444004";30;8;86;38;11;173
"1093";"360050448001";21;6;160;25;14;226
"1094";"360050448002";15;1;45;21;2;84
"1095";"360050449011";8;5;120;8;10;151
"1096";"360050449012";37;27;245;13;7;329
"1097";"360050449021";9;35;458;45;15;562
"1098";"360050449022";216;54;389;72;53;784
"1099";"360050451011";62;18;507;5;26;618
"1100";"360050451012";26;101;150;6;6;289
"1101";"360050451021";20;11;195;11;7;244
"1102";"360050451022";34;28;288;25;9;384
"1103";"360050456001";29;7;121;22;7;186
"1104";"360050456002";62;14;206;56;22;360
"1105";"360050456003";15;1;16;17;4;53
"1106";"360050458001";61;12;11;15;7;106
"1107";"360050458002";259;25;20;1;3;308
"1108";"360050458003";6;3;8;0;0;17
"1109";"360050458004";267;69;33;2;19;390
"1110";"360050460001";23;11;133;61;6;234
"1111";"360050460002";2;4;45;9;0;60
"1112";"360050462011";38;71;146;22;17;294
"1113";"360050462012";3;4;8;6;5;26
"1114";"360050462013";27;6;53;3;4;93
"1115";"360050462014";21;2;86;4;5;118
"1116";"360050462015";7;2;24;0;0;33
"1117";"360050462016";5;2;27;3;1;38
"1118";"360050462017";7;3;22;0;1;33
"1119";"360050462018";40;1;109;3;2;155
"1120";"360050462019";2;2;10;2;0;16
"1121";"360050462021";147;32;257;73;10;519
"1122";"360050462022";55;17;201;50;19;342
"1123";"360050462023";129;16;203;75;6;429
"1124";"360050462024";18;3;48;28;6;103
"1125";"360050462025";18;16;72;25;11;142
"1126";"360050462026";34;5;34;19;5;97
"1127";"360050484001";39;7;72;15;2;135
"1128";"360050484002";42;86;337;121;30;616
"1129";"360050484003";3;13;36;7;8;67
"1130";"360050484004";54;10;109;12;7;192
"1131";"360050504000";0;0;2;0;0;2
"1132";"360050504001";5;52;31;2;87;177
"1133";"360050516000";3;0;6;0;0;9
"1134";"360050516001";156;258;329;28;32;803
"1135";"360050516002";32;60;111;17;15;235
"1136";"360050516003";29;18;192;13;17;269
"1137";"360050516004";15;15;125;12;17;184
"1138";"360470001001";146;48;208;1;54;457
"1139";"360470001002";15;9;70;0;19;113
"1140";"360470001003";30;36;74;0;24;164
"1141";"360470001004";8;65;45;3;24;145
"1142";"360470002001";109;154;536;75;135;1009
"1143";"360470003011";106;17;31;0;1;155
"1144";"360470003012";2;8;13;0;14;37
"1145";"360470003013";19;21;46;6;23;115
"1146";"360470003014";9;195;52;1;34;291
"1147";"360470003015";10;27;71;6;9;123
"1148";"360470005011";37;31;186;1;125;380
"1149";"360470005012";4;41;65;3;21;134
"1150";"360470005013";23;21;45;2;30;121
"1151";"360470005021";38;21;68;3;19;149
"1152";"360470005022";9;25;81;0;11;126
"1153";"360470007001";76;96;292;4;82;550
"1154";"360470007002";41;7;84;1;36;169
"1155";"360470007003";32;13;71;5;33;154
"1156";"360470009001";45;269;295;11;59;679
"1157";"360470009002";14;15;173;5;20;227
"1158";"360470011001";27;76;5818;10;258;6189
"1159";"360470013001";98;115;507;11;91;822
"1160";"360470013002";19;2;27;2;1;51
"1161";"360470015001";71;67;1408;10;13;1569
"1162";"360470015002";246;53;29;5;10;343
"1163";"360470015003";113;353;1601;14;183;2264
"1164";"360470018001";24;113;604;70;62;873
"1165";"360470020001";21;41;175;8;38;283
"1166";"360470020002";15;23;210;4;31;283
"1167";"360470021001";41;240;1740;9;38;2068
"1168";"360470021002";74;35;286;9;169;573
"1169";"360470021003";80;193;392;1;38;704
"1170";"360470022001";70;56;324;12;93;555
"1171";"360470022002";45;28;163;15;24;275
"1172";"360470022003";61;31;224;15;31;362
"1173";"360470023001";203;16;16;1;12;248
"1174";"360470023002";1101;25;25;2;7;1160
"1175";"360470023003";2067;20;64;5;18;2174
"1176";"360470029011";66;23;702;0;12;803
"1177";"360470029012";78;45;3033;10;8;3174
"1178";"360470030001";17;21;171;20;13;242
"1179";"360470030002";14;12;45;4;6;81
"1180";"360470031001";23;312;775;12;20;1142
"1181";"360470031002";10;13;70;1;4;98
"1182";"360470031003";2;31;94;1;32;160
"1183";"360470033001";35;202;312;1;29;579
"1184";"360470033002";267;361;399;11;84;1122
"1185";"360470034001";64;162;278;6;48;558
"1186";"360470034002";65;27;531;6;22;651
"1187";"360470034003";19;10;343;7;9;388
"1188";"360470035001";25;130;112;5;82;354
"1189";"360470035002";33;174;73;4;16;300
"1190";"360470036001";41;4;201;8;13;267
"1191";"360470036002";57;29;624;7;26;743
"1192";"360470036003";10;13;203;3;13;242
"1193";"360470037001";236;440;2099;7;189;2971
"1194";"360470038001";35;64;508;36;46;689
"1195";"360470039001";34;35;1079;11;46;1205
"1196";"360470039002";138;359;203;6;36;742
"1197";"360470039003";11;49;293;1;40;394
"1198";"360470041001";35;46;1473;6;82;1642
"1199";"360470041002";10;34;287;4;18;353
"1200";"360470041003";9;5;309;7;14;344
"1201";"360470043001";0;1;3;0;0;4
"1202";"360470043002";7;22;209;3;20;261
"1203";"360470043003";5;20;204;3;41;273
"1204";"360470043004";64;127;268;7;53;519
"1205";"360470044001";29;46;252;27;26;380
"1206";"360470044002";7;7;111;6;7;138
"1207";"360470045001";29;41;148;6;54;278
"1208";"360470045002";8;8;37;3;11;67
"1209";"360470045003";5;4;27;0;17;53
"1210";"360470045004";13;6;116;0;19;154
"1211";"360470046001";32;41;149;8;41;271
"1212";"360470047001";76;52;235;3;23;389
"1213";"360470049001";9;14;73;0;17;113
"1214";"360470049002";0;4;28;5;18;55
"1215";"360470049003";1;4;210;0;15;230
"1216";"360470050001";51;18;67;2;6;144
"1217";"360470050002";9;8;107;1;8;133
"1218";"360470050003";56;11;234;2;5;308
"1219";"360470051001";4;11;114;2;8;139
"1220";"360470051002";10;15;56;2;23;106
"1221";"360470051003";17;10;189;0;17;233
"1222";"360470052011";42;11;143;6;13;215
"1223";"360470052021";42;5;130;0;4;181
"1224";"360470052022";32;14;160;4;4;214
"1225";"360470053001";103;70;946;92;264;1475
"1226";"360470053002";37;60;94;27;26;244
"1227";"360470053003";26;60;89;11;29;215
"1228";"360470053004";13;7;96;12;15;143
"1229";"360470054001";61;10;64;2;10;147
"1230";"360470054002";26;97;62;1;11;197
"1231";"360470054003";88;7;83;4;65;247
"1232";"360470056011";48;33;129;10;31;251
"1233";"360470056012";125;163;323;1;22;634
"1234";"360470056021";192;48;282;8;32;562
"1235";"360470058001";42;17;205;8;13;285
"1236";"360470058002";63;10;256;10;44;383
"1237";"360470058003";11;3;37;0;5;56
"1238";"360470059001";133;203;120;6;31;493
"1239";"360470059002";28;77;507;44;34;690
"1240";"360470060001";21;106;128;2;31;288
"1241";"360470060002";22;8;171;22;23;246
"1242";"360470060003";14;10;182;1;12;219
"1243";"360470062001";39;58;172;3;22;294
"1244";"360470062002";48;96;130;7;22;303
"1245";"360470062003";68;84;92;1;6;251
"1246";"360470063001";16;39;2016;1;6;2078
"1247";"360470063002";8;3;150;4;9;174
"1248";"360470064001";41;19;144;1;59;264
"1249";"360470064002";23;11;89;1;9;133
"1250";"360470064003";8;24;76;1;13;122
"1251";"360470065001";17;10;97;4;10;138
"1252";"360470065002";4;17;40;1;9;71
"1253";"360470065003";6;6;164;0;10;186
"1254";"360470065004";13;3;111;1;3;131
"1255";"360470065005";4;1;116;0;5;126
"1256";"360470065006";29;28;43;3;13;116
"1257";"360470065007";6;11;32;0;29;78
"1258";"360470066001";33;66;384;20;30;533
"1259";"360470066002";34;23;150;6;21;234
"1260";"360470066003";184;94;238;5;30;551
"1261";"360470067001";4;6;49;1;7;67
"1262";"360470067002";6;9;41;0;11;67
"1263";"360470067003";6;5;70;2;7;90
"1264";"360470067004";7;5;51;2;1;66
"1265";"360470067005";7;6;189;0;4;206
"1266";"360470068001";12;25;116;1;28;182
"1267";"360470068002";71;28;170;12;38;319
"1268";"360470068003";9;25;242;5;20;301
"1269";"360470068004";17;28;384;1;29;459
"1270";"360470069001";11;34;86;4;67;202
"1271";"360470069002";49;30;234;1;31;345
"1272";"360470069003";8;31;139;8;23;209
"1273";"360470069004";7;24;106;6;18;161
"1274";"360470070001";25;9;262;19;22;337
"1275";"360470070002";33;5;186;3;34;261
"1276";"360470071001";14;11;47;4;10;86
"1277";"360470071002";55;60;164;12;19;310
"1278";"360470071003";93;35;33;1;4;166
"1279";"360470071004";116;148;20;2;6;292
"1280";"360470072001";37;16;320;11;42;426
"1281";"360470074001";46;36;295;6;41;424
"1282";"360470074002";20;21;57;3;92;193
"1283";"360470074003";40;30;80;0;47;197
"1284";"360470074004";9;16;19;0;9;53
"1285";"360470075001";94;94;197;9;17;411
"1286";"360470075002";19;198;115;3;12;347
"1287";"360470075003";20;37;250;3;10;320
"1288";"360470075004";12;11;73;1;29;126
"1289";"360470075005";18;155;88;1;24;286
"1290";"360470076001";21;20;97;13;63;214
"1291";"360470076002";38;83;71;8;61;261
"1292";"360470076003";93;32;139;1;28;293
"1293";"360470077001";43;17;108;3;10;181
"1294";"360470077002";11;10;306;5;8;340
"1295";"360470077003";25;83;156;13;36;313
"1296";"360470077004";14;38;113;1;60;226
"1297";"360470078001";42;57;76;9;24;208
"1298";"360470078002";60;32;66;1;31;190
"1299";"360470078003";30;9;112;1;22;174
"1300";"360470078004";26;18;54;3;20;121
"1301";"360470080001";34;25;91;0;45;195
"1302";"360470080002";50;917;210;1;63;1241
"1303";"360470080003";37;9;62;5;29;142
"1304";"360470082001";79;74;128;0;29;310
"1305";"360470082002";40;310;207;5;93;655
"1306";"360470082003";51;23;112;3;16;205
"1307";"360470084001";11;14;139;3;30;197
"1308";"360470084002";71;72;55;5;28;231
"1309";"360470084003";6;42;134;8;47;237
"1310";"360470085001";124;71;8;4;12;219
"1311";"360470085002";286;29;7;2;16;340
"1312";"360470085003";203;33;81;12;31;360
"1313";"360470086001";10;108;44;0;51;213
"1314";"360470088001";72;108;222;10;47;459
"1315";"360470088002";35;75;148;4;18;280
"1316";"360470090001";28;133;211;2;22;396
"1317";"360470090002";16;32;160;5;28;241
"1318";"360470092001";317;364;65;4;26;776
"1319";"360470092002";84;517;281;0;32;914
"1320";"360470092003";47;37;93;5;15;197
"1321";"360470094001";38;12;149;7;14;220
"1322";"360470094002";54;18;202;5;28;307
"1323";"360470094003";102;89;69;0;33;293
"1324";"360470096001";43;68;132;13;13;269
"1325";"360470096002";66;13;57;3;43;182
"1326";"360470096003";31;88;123;4;25;271
"1327";"360470096004";81;46;207;2;33;369
"1328";"360470098001";22;44;93;6;25;190
"1329";"360470098002";37;59;211;3;30;340
"1330";"360470098003";18;17;80;4;38;157
"1331";"360470098004";78;99;139;2;27;345
"1332";"360470100001";24;78;752;2;25;881
"1333";"360470100002";39;11;149;0;28;227
"1334";"360470100003";78;17;26;2;24;147
"1335";"360470100004";36;44;56;4;24;164
"1336";"360470101001";22;145;490;15;47;719
"1337";"360470101002";18;19;272;9;47;365
"1338";"360470101003";28;77;419;19;39;582
"1339";"360470102001";28;9;117;0;72;226
"1340";"360470102002";40;30;121;3;36;230
"1341";"360470102003";70;37;80;0;21;208
"1342";"360470104001";17;12;274;2;33;338
"1343";"360470104002";10;12;157;6;28;213
"1344";"360470104003";7;7;167;3;34;218
"1345";"360470106001";48;132;233;4;39;456
"1346";"360470106002";13;27;398;1;58;497
"1347";"360470106003";32;5;141;1;22;201
"1348";"360470108001";47;2;247;0;36;332
"1349";"360470108002";18;15;99;0;14;146
"1350";"360470108003";23;10;320;2;32;387
"1351";"360470110001";18;20;296;18;31;383
"1352";"360470110002";57;25;519;15;31;647
"1353";"360470112001";62;42;224;26;32;386
"1354";"360470112002";11;20;50;2;6;89
"1355";"360470112003";39;7;143;2;12;203
"1356";"360470112004";94;18;171;7;7;297
"1357";"360470114001";36;18;74;4;5;137
"1358";"360470114002";2;6;136;5;4;153
"1359";"360470114003";9;11;137;1;11;169
"1360";"360470116001";12;9;118;3;17;159
"1361";"360470116002";25;12;109;5;40;191
"1362";"360470116003";21;10;113;0;13;157
"1363";"360470117001";30;62;225;25;59;401
"1364";"360470117002";8;32;146;12;26;224
"1365";"360470117003";52;184;125;0;27;388
"1366";"360470118001";10;28;177;14;44;273
"1367";"360470118002";12;17;307;5;36;377
"1368";"360470119001";28;19;409;25;57;538
"1369";"360470119002";7;46;296;24;39;412
"1370";"360470119003";21;41;250;14;58;384
"1371";"360470120001";53;53;290;15;53;464
"1372";"360470121001";45;41;269;15;81;451
"1373";"360470121002";32;27;134;5;43;241
"1374";"360470122001";87;39;120;4;58;308
"1375";"360470122002";112;114;235;2;35;498
"1376";"360470122003";32;35;368;6;62;503
"1377";"360470126001";16;10;249;10;11;296
"1378";"360470126002";27;213;102;7;43;392
"1379";"360470126003";1;2;101;10;2;116
"1380";"360470127001";75;119;128;5;32;359
"1381";"360470127002";128;135;148;29;33;473
"1382";"360470127003";139;22;17;0;10;188
"1383";"360470128011";39;25;160;10;44;278
"1384";"360470129011";49;66;236;2;158;511
"1385";"360470129012";64;99;68;1;38;270
"1386";"360470129013";4;19;153;7;13;196
"1387";"360470129021";26;110;316;2;23;477
"1388";"360470129022";14;159;160;3;19;355
"1389";"360470129023";14;34;60;6;14;128
"1390";"360470130001";61;11;147;2;39;260
"1391";"360470130002";70;17;109;5;18;219
"1392";"360470130003";32;29;331;0;21;413
"1393";"360470130004";61;43;264;12;34;414
"1394";"360470131001";83;51;98;2;13;247
"1395";"360470131002";24;28;50;2;29;133
"1396";"360470131003";27;113;61;3;11;215
"1397";"360470131004";106;50;121;0;26;303
"1398";"360470132001";18;4;67;9;8;106
"1399";"360470132002";31;7;183;15;55;291
"1400";"360470133001";18;41;119;1;12;191
"1401";"360470133002";73;203;145;1;56;478
"1402";"360470133003";21;90;103;3;5;222
"1403";"360470133004";16;4;87;0;13;120
"1404";"360470134001";12;6;276;1;15;310
"1405";"360470134002";105;22;156;9;37;329
"1406";"360470134003";37;11;126;0;24;198
"1407";"360470135001";5;13;168;2;8;196
"1408";"360470135002";15;41;230;4;29;319
"1409";"360470135003";13;29;381;2;13;438
"1410";"360470136001";17;6;216;8;47;294
"1411";"360470136002";16;5;122;1;21;165
"1412";"360470136003";29;20;100;1;14;164
"1413";"360470136004";38;13;206;2;24;283
"1414";"360470137001";13;77;138;10;13;251
"1415";"360470137002";28;50;156;0;8;242
"1416";"360470137003";30;37;344;1;83;495
"1417";"360470138001";60;167;176;3;35;441
"1418";"360470138002";11;33;113;0;12;169
"1419";"360470138003";24;3;36;0;28;91
"1420";"360470139001";5;18;103;0;6;132
"1421";"360470139002";35;21;65;6;27;154
"1422";"360470139003";8;11;26;8;28;81
"1423";"360470139004";6;13;19;2;19;59
"1424";"360470140001";8;4;153;2;8;175
"1425";"360470140002";20;9;358;4;39;430
"1426";"360470141001";20;28;46;3;40;137
"1427";"360470141002";25;13;129;10;58;235
"1428";"360470141003";42;85;128;11;19;285
"1429";"360470142001";38;9;283;7;14;351
"1430";"360470142002";28;34;111;1;93;267
"1431";"360470142003";161;139;160;2;104;566
"1432";"360470143001";217;70;192;5;101;585
"1433";"360470143002";75;76;141;6;68;366
"1434";"360470143003";41;28;130;10;47;256
"1435";"360470145001";49;93;382;12;21;557
"1436";"360470145002";35;18;150;3;20;226
"1437";"360470145003";49;37;217;2;32;337
"1438";"360470145004";10;7;129;1;23;170
"1439";"360470147001";16;8;75;1;5;105
"1440";"360470147002";36;52;184;5;19;296
"1441";"360470148001";0;2;53;2;6;63
"1442";"360470148002";67;9;96;8;20;200
"1443";"360470149001";11;36;56;1;4;108
"1444";"360470149002";56;26;98;1;22;203
"1445";"360470149003";21;22;61;1;10;115
"1446";"360470149004";16;11;79;2;10;118
"1447";"360470149005";24;9;85;5;14;137
"1448";"360470150001";7;7;84;0;9;107
"1449";"360470150002";3;5;102;9;13;132
"1450";"360470151001";21;4;117;1;38;181
"1451";"360470151002";14;9;50;1;9;83
"1452";"360470151003";32;18;110;0;26;186
"1453";"360470151004";14;9;62;5;11;101
"1454";"360470152001";5;1;220;14;4;244
"1455";"360470152002";15;1;134;10;6;166
"1456";"360470152003";11;5;395;13;13;437
"1457";"360470153001";2;3;78;0;4;87
"1458";"360470153002";16;27;140;2;15;200
"1459";"360470153003";9;9;140;2;12;172
"1460";"360470153004";7;10;129;4;3;153
"1461";"360470154001";15;102;89;5;54;265
"1462";"360470155001";9;18;181;2;10;220
"1463";"360470155002";19;9;136;2;20;186
"1464";"360470155003";19;20;148;3;8;198
"1465";"360470155004";8;6;115;2;5;136
"1466";"360470157001";15;30;77;1;9;132
"1467";"360470157002";13;7;52;5;7;84
"1468";"360470157003";11;15;188;4;10;228
"1469";"360470157004";4;12;138;2;7;163
"1470";"360470159001";20;52;218;1;99;390
"1471";"360470159002";7;11;64;4;11;97
"1472";"360470159003";12;4;56;2;18;92
"1473";"360470159004";10;11;65;1;11;98
"1474";"360470159005";11;6;71;0;17;105
"1475";"360470160001";32;5;70;9;12;128
"1476";"360470160002";54;10;102;8;12;186
"1477";"360470160003";46;31;119;8;22;226
"1478";"360470160004";50;126;223;16;99;514
"1479";"360470161001";50;87;1916;6;6;2065
"1480";"360470161002";47;19;350;1;5;422
"1481";"360470161003";49;67;152;7;179;454
"1482";"360470162001";26;8;120;3;9;166
"1483";"360470162002";21;4;223;10;28;286
"1484";"360470163001";39;30;370;12;32;483
"1485";"360470163002";40;23;655;4;12;734
"1486";"360470163003";150;15;1079;1;16;1261
"1487";"360470164001";5;15;30;2;12;64
"1488";"360470165001";40;8;223;2;32;305
"1489";"360470165002";4;15;67;3;12;101
"1490";"360470165003";18;14;88;0;6;126
"1491";"360470165004";7;7;190;1;6;211
"1492";"360470166001";7;13;80;7;8;115
"1493";"360470166002";14;11;85;10;12;132
"1494";"360470167001";7;4;160;3;7;181
"1495";"360470167002";46;22;99;4;15;186
"1496";"360470167003";12;29;92;2;14;149
"1497";"360470167004";16;27;462;3;14;522
"1498";"360470168001";22;1;274;5;15;317
"1499";"360470169001";10;19;26;1;53;109
"1500";"360470169002";16;9;78;2;10;115
"1501";"360470169003";7;57;86;2;15;167
"1502";"360470169004";8;13;63;3;9;96
"1503";"360470169005";7;7;36;1;6;57
"1504";"360470170001";10;5;29;0;3;47
"1505";"360470170002";20;37;317;4;21;399
"1506";"360470170003";21;9;156;10;6;202
"1507";"360470171001";6;3;77;3;8;97
"1508";"360470171002";4;6;54;1;7;72
"1509";"360470171003";3;13;25;1;6;48
"1510";"360470171004";3;5;46;2;2;58
"1511";"360470172001";149;47;120;9;20;345
"1512";"360470172002";22;2;87;5;16;132
"1513";"360470174001";29;2;236;14;11;292
"1514";"360470174002";16;3;127;3;4;153
"1515";"360470175001";0;10;40;2;2;54
"1516";"360470176001";7;2;26;2;4;41
"1517";"360470176002";18;3;239;1;14;275
"1518";"360470177001";56;404;348;25;278;1111
"1519";"360470178001";81;36;58;13;85;273
"1520";"360470178002";128;145;366;30;50;719
"1521";"360470179001";18;2;13;1;1;35
"1522";"360470179002";54;87;351;14;40;546
"1523";"360470179003";3;10;48;5;6;72
"1524";"360470180001";53;13;124;23;18;231
"1525";"360470180002";13;12;279;2;12;318
"1526";"360470181001";17;3;72;0;14;106
"1527";"360470181002";27;18;142;3;4;194
"1528";"360470181003";56;88;128;2;27;301
"1529";"360470181004";8;12;137;1;10;168
"1530";"360470182001";11;5;93;6;16;131
"1531";"360470182002";31;2;197;19;15;264
"1532";"360470183001";29;49;154;1;26;259
"1533";"360470183002";9;31;153;2;12;207
"1534";"360470183003";40;39;65;3;13;160
"1535";"360470184001";1;2;80;3;3;89
"1536";"360470184002";2;2;143;4;6;157
"1537";"360470185011";2;8;23;1;8;42
"1538";"360470185012";56;28;507;6;3;600
"1539";"360470185013";60;84;1058;2;4;1208
"1540";"360470185014";43;8;36;2;7;96
"1541";"360470186001";13;2;125;5;10;155
"1542";"360470186002";34;32;111;6;15;198
"1543";"360470187001";22;67;156;4;23;272
"1544";"360470188001";18;5;164;5;29;221
"1545";"360470188002";19;8;346;15;28;416
"1546";"360470190001";46;12;148;1;38;245
"1547";"360470190002";75;16;110;5;34;240
"1548";"360470190003";14;16;271;7;36;344
"1549";"360470191001";88;89;290;27;52;546
"1550";"360470191002";16;116;82;3;20;237
"1551";"360470191003";34;157;151;7;29;378
"1552";"360470192001";39;6;73;9;7;134
"1553";"360470192002";29;23;260;37;46;395
"1554";"360470193001";56;33;111;5;14;219
"1555";"360470193002";35;44;446;3;7;535
"1556";"360470193003";8;9;72;3;1;93
"1557";"360470193004";20;37;43;2;21;123
"1558";"360470194001";44;100;145;16;43;348
"1559";"360470194002";48;4;312;27;15;406
"1560";"360470194003";42;5;176;10;17;250
"1561";"360470195001";6;8;70;0;4;88
"1562";"360470195002";33;18;85;0;9;145
"1563";"360470195003";27;10;32;0;4;73
"1564";"360470195004";21;19;71;6;25;142
"1565";"360470196001";69;20;227;5;19;340
"1566";"360470196002";15;4;163;2;22;206
"1567";"360470196003";67;24;109;11;16;227
"1568";"360470197001";4;0;52;1;5;62
"1569";"360470197002";22;14;87;2;10;135
"1570";"360470197003";29;19;86;0;15;149
"1571";"360470197004";12;8;55;0;21;96
"1572";"360470198001";9;5;46;2;16;78
"1573";"360470198002";12;8;191;10;21;242
"1574";"360470199001";17;5;48;0;11;81
"1575";"360470199002";68;15;46;3;22;154
"1576";"360470199003";246;105;147;1;76;575
"1577";"360470199004";22;12;28;1;7;70
"1578";"360470200001";26;6;67;0;24;123
"1579";"360470200002";4;4;264;7;17;296
"1580";"360470201001";31;59;34;3;9;136
"1581";"360470201002";35;58;63;7;26;189
"1582";"360470201003";58;82;52;2;33;227
"1583";"360470201004";46;8;75;8;6;143
"1584";"360470202001";16;0;142;2;8;168
"1585";"360470202002";9;1;191;3;45;249
"1586";"360470203001";42;163;318;104;23;650
"1587";"360470203002";15;26;379;13;28;461
"1588";"360470204001";14;3;236;3;22;278
"1589";"360470204002";2;5;163;1;12;183
"1590";"360470205001";34;86;408;38;11;577
"1591";"360470205002";63;201;202;5;11;482
"1592";"360470205003";11;23;586;4;9;633
"1593";"360470206001";35;5;170;1;17;228
"1594";"360470206002";21;6;161;2;15;205
"1595";"360470207001";143;44;214;7;16;424
"1596";"360470207002";38;55;284;8;21;406
"1597";"360470207003";3;1;116;4;4;128
"1598";"360470208001";10;0;256;2;16;284
"1599";"360470208002";23;4;180;2;12;221
"1600";"360470208003";23;1;288;7;23;342
"1601";"360470210001";55;12;218;0;28;313
"1602";"360470210002";5;2;137;4;24;172
"1603";"360470210003";34;6;113;2;16;171
"1604";"360470211001";19;13;33;8;0;73
"1605";"360470211002";44;61;468;17;41;631
"1606";"360470212001";30;13;101;13;21;178
"1607";"360470212002";13;6;77;1;9;106
"1608";"360470212003";6;6;191;4;10;217
"1609";"360470213001";42;162;29;16;29;278
"1610";"360470213002";139;103;201;6;14;463
"1611";"360470213003";73;111;86;64;22;356
"1612";"360470214001";14;15;103;14;18;164
"1613";"360470214002";10;27;61;5;32;135
"1614";"360470215001";93;163;312;1;13;582
"1615";"360470215002";44;63;165;14;11;297
"1616";"360470215003";114;38;24;32;17;225
"1617";"360470215004";79;62;55;11;20;227
"1618";"360470216001";9;1;55;11;2;78
"1619";"360470216002";16;1;49;4;4;74
"1620";"360470216003";4;9;101;1;14;129
"1621";"360470217001";59;91;134;31;17;332
"1622";"360470217002";182;548;220;29;25;1004
"1623";"360470218001";12;16;11;3;15;57
"1624";"360470218002";2;0;17;3;0;22
"1625";"360470218003";4;18;86;14;4;126
"1626";"360470219001";34;55;75;12;11;187
"1627";"360470219002";27;17;92;10;31;177
"1628";"360470219003";121;158;154;19;78;530
"1629";"360470220001";11;4;21;2;4;42
"1630";"360470220002";14;2;36;5;12;69
"1631";"360470220003";8;2;19;0;3;32
"1632";"360470220004";8;9;123;3;24;167
"1633";"360470221001";33;22;98;29;35;217
"1634";"360470221002";160;228;247;19;38;692
"1635";"360470221003";24;25;110;10;15;184
"1636";"360470222001";2;4;29;6;4;45
"1637";"360470222002";11;3;35;1;9;59
"1638";"360470222003";27;60;164;1;29;281
"1639";"360470224001";0;6;32;3;1;42
"1640";"360470224002";6;1;46;2;6;61
"1641";"360470224003";34;11;150;3;6;204
"1642";"360470224004";17;82;408;12;14;533
"1643";"360470226001";11;28;271;37;15;362
"1644";"360470226002";17;15;229;20;15;296
"1645";"360470227001";89;75;73;6;24;267
"1646";"360470227002";39;34;73;8;50;204
"1647";"360470227003";56;39;78;25;34;232
"1648";"360470227004";130;121;105;5;60;421
"1649";"360470228001";14;35;57;6;9;121
"1650";"360470228002";5;8;83;5;2;103
"1651";"360470228003";5;3;88;10;5;111
"1652";"360470229001";43;153;97;12;22;327
"1653";"360470229002";38;36;43;10;16;143
"1654";"360470229003";35;10;52;0;10;107
"1655";"360470229004";33;25;85;18;18;179
"1656";"360470230001";33;10;96;1;4;144
"1657";"360470230002";0;2;17;3;1;23
"1658";"360470230003";16;3;68;12;7;106
"1659";"360470231001";40;124;80;8;34;286
"1660";"360470231002";91;101;374;12;39;617
"1661";"360470231003";83;87;54;7;71;302
"1662";"360470232001";12;5;207;4;4;232
"1663";"360470232002";28;3;27;6;2;66
"1664";"360470232003";0;2;8;7;1;18
"1665";"360470232004";1;3;16;1;2;23
"1666";"360470232005";24;1;48;0;3;76
"1667";"360470233001";201;215;123;6;23;568
"1668";"360470233002";380;125;59;2;8;574
"1669";"360470233003";173;139;298;23;62;695
"1670";"360470234001";6;2;21;3;10;42
"1671";"360470234002";14;11;26;1;1;53
"1672";"360470234003";1;0;22;2;2;27
"1673";"360470235001";156;162;143;10;35;506
"1674";"360470235002";13;26;94;3;18;154
"1675";"360470236001";24;1;20;2;2;49
"1676";"360470236002";12;15;30;3;1;61
"1677";"360470236003";45;3;24;2;1;75
"1678";"360470236004";1;3;28;0;3;35
"1679";"360470238001";1;1;67;2;3;74
"1680";"360470238002";85;15;78;5;2;185
"1681";"360470238003";6;12;119;3;6;146
"1682";"360470240001";23;5;32;2;3;65
"1683";"360470240002";6;4;94;6;18;128
"1684";"360470240003";9;4;36;2;4;55
"1685";"360470241001";78;162;509;26;64;839
"1686";"360470241002";56;69;143;25;43;336
"1687";"360470242001";5;8;323;26;10;372
"1688";"360470242002";0;2;97;3;6;108
"1689";"360470243001";90;32;101;18;77;318
"1690";"360470243002";112;50;51;7;14;234
"1691";"360470243003";58;114;121;10;20;323
"1692";"360470244001";13;8;70;8;8;107
"1693";"360470244002";10;7;91;3;8;119
"1694";"360470244003";3;4;276;9;16;308
"1695";"360470245001";58;18;110;15;32;233
"1696";"360470245002";319;57;85;14;26;501
"1697";"360470245003";196;58;30;5;8;297
"1698";"360470245004";21;43;44;7;32;147
"1699";"360470246001";27;9;111;20;7;174
"1700";"360470246002";24;8;77;9;15;133
"1701";"360470246003";16;16;115;5;10;162
"1702";"360470247001";121;696;36;8;51;912
"1703";"360470247002";202;222;114;11;211;760
"1704";"360470248001";9;7;92;4;39;151
"1705";"360470248002";26;26;338;90;37;517
"1706";"360470249001";126;39;20;33;25;243
"1707";"360470249002";51;14;15;26;15;121
"1708";"360470249003";82;302;37;9;59;489
"1709";"360470249004";79;286;24;0;34;423
"1710";"360470250001";36;42;239;55;39;411
"1711";"360470250002";7;239;94;4;7;351
"1712";"360470251001";37;100;66;31;20;254
"1713";"360470251002";71;95;81;14;18;279
"1714";"360470251003";94;291;70;3;16;474
"1715";"360470252001";3;4;87;2;14;110
"1716";"360470252002";67;15;314;10;14;420
"1717";"360470252003";3;7;381;17;11;419
"1718";"360470252004";45;2;146;42;14;249
"1719";"360470253001";58;27;49;13;43;190
"1720";"360470253002";97;17;28;4;9;155
"1721";"360470253003";106;241;95;41;29;512
"1722";"360470254001";7;0;75;2;10;94
"1723";"360470254002";20;9;91;11;23;154
"1724";"360470254003";26;13;255;5;24;323
"1725";"360470255001";151;41;12;1;11;216
"1726";"360470255002";194;49;10;1;7;261
"1727";"360470256001";9;9;280;0;24;322
"1728";"360470256002";40;11;175;5;16;247
"1729";"360470257001";53;71;258;19;30;431
"1730";"360470257002";25;18;139;5;8;195
"1731";"360470257003";26;43;132;10;19;230
"1732";"360470258001";24;29;224;4;18;299
"1733";"360470258002";31;12;339;5;38;425
"1734";"360470258003";105;8;134;2;15;264
"1735";"360470259011";187;264;262;12;38;763
"1736";"360470259021";179;86;207;6;9;487
"1737";"360470260001";8;4;80;11;21;124
"1738";"360470260002";27;4;62;0;17;110
"1739";"360470260003";14;16;266;9;53;358
"1740";"360470261001";54;42;103;15;17;231
"1741";"360470261002";217;26;51;12;21;327
"1742";"360470261003";103;195;54;15;24;391
"1743";"360470261004";100;75;147;8;30;360
"1744";"360470261005";88;35;153;13;27;316
"1745";"360470262001";34;28;221;10;35;328
"1746";"360470262002";9;47;225;7;36;324
"1747";"360470263001";202;71;128;34;65;500
"1748";"360470264001";19;13;219;5;23;279
"1749";"360470264002";13;4;1078;6;33;1134
"1750";"360470264003";80;16;331;4;57;488
"1751";"360470264004";26;33;71;5;35;170
"1752";"360470265001";194;35;88;17;14;348
"1753";"360470265002";159;316;84;4;14;577
"1754";"360470265003";56;42;186;52;28;364
"1755";"360470265004";58;169;117;42;33;419
"1756";"360470266001";15;4;369;6;24;418
"1757";"360470266002";36;10;73;7;20;146
"1758";"360470266003";13;24;90;3;21;151
"1759";"360470267001";24;51;55;8;10;148
"1760";"360470267002";31;28;56;20;16;151
"1761";"360470267003";85;115;62;7;44;313
"1762";"360470267004";55;166;106;5;14;346
"1763";"360470268001";34;3;24;2;6;69
"1764";"360470268002";10;1;90;13;14;128
"1765";"360470268003";25;0;180;4;12;221
"1766";"360470268004";38;14;41;2;8;103
"1767";"360470269001";26;49;33;3;8;119
"1768";"360470269002";16;30;39;6;53;144
"1769";"360470269003";119;54;50;7;32;262
"1770";"360470270001";36;16;117;2;9;180
"1771";"360470270002";34;3;96;3;10;146
"1772";"360470271001";300;141;377;40;53;911
"1773";"360470271002";30;7;181;5;23;246
"1774";"360470272001";22;1;94;6;3;126
"1775";"360470272002";24;7;60;2;4;97
"1776";"360470272003";314;9;82;2;3;410
"1777";"360470273001";16;10;79;8;3;116
"1778";"360470273002";17;10;34;4;6;71
"1779";"360470273003";70;101;118;13;22;324
"1780";"360470274001";12;1;212;2;9;236
"1781";"360470274002";23;17;280;5;25;350
"1782";"360470275001";62;42;93;17;14;228
"1783";"360470275002";93;35;130;2;11;271
"1784";"360470275003";23;44;191;4;11;273
"1785";"360470275004";23;63;96;7;17;206
"1786";"360470276001";13;15;102;1;4;135
"1787";"360470276002";16;6;103;0;10;135
"1788";"360470276003";45;18;471;25;19;578
"1789";"360470277001";401;40;58;2;13;514
"1790";"360470277002";45;66;40;5;11;167
"1791";"360470277003";55;101;13;2;22;193
"1792";"360470277004";136;131;68;4;10;349
"1793";"360470278001";130;41;716;2;21;910
"1794";"360470278002";117;12;245;4;44;422
"1795";"360470279001";80;30;46;15;22;193
"1796";"360470279002";62;63;88;6;6;225
"1797";"360470279003";34;23;42;14;19;132
"1798";"360470279004";63;20;141;17;14;255
"1799";"360470280001";4;0;91;0;5;100
"1800";"360470280002";20;17;210;9;11;267
"1801";"360470281001";207;23;68;4;8;310
"1802";"360470281002";126;20;84;5;24;259
"1803";"360470281003";117;46;114;13;49;339
"1804";"360470282001";19;2;206;3;9;239
"1805";"360470282002";21;10;224;2;6;263
"1806";"360470282003";14;1;190;1;6;212
"1807";"360470283001";58;56;72;4;26;216
"1808";"360470283002";162;48;154;16;11;391
"1809";"360470283003";37;40;57;11;17;162
"1810";"360470284001";44;1;400;0;3;448
"1811";"360470284002";25;5;285;3;36;354
"1812";"360470284003";17;4;107;3;35;166
"1813";"360470285011";47;39;186;9;54;335
"1814";"360470285021";336;49;43;15;14;457
"1815";"360470286001";92;9;9;3;11;124
"1816";"360470286002";92;6;20;1;0;119
"1817";"360470286003";25;4;2;0;7;38
"1818";"360470286004";17;22;258;0;12;309
"1819";"360470286005";42;3;215;1;8;269
"1820";"360470287001";66;346;78;13;126;629
"1821";"360470287002";25;13;95;8;18;159
"1822";"360470287003";59;16;47;16;8;146
"1823";"360470288001";1;6;467;4;11;489
"1824";"360470288002";29;18;837;10;32;926
"1825";"360470288003";46;23;163;7;39;278
"1826";"360470289001";39;137;70;2;63;311
"1827";"360470289002";60;14;84;6;37;201
"1828";"360470289003";47;21;73;7;40;188
"1829";"360470289004";86;17;57;16;14;190
"1830";"360470290001";79;11;122;2;2;216
"1831";"360470290002";344;15;138;8;7;512
"1832";"360470290003";85;6;172;4;87;354
"1833";"360470291001";95;49;204;8;30;386
"1834";"360470291002";45;11;103;7;6;172
"1835";"360470291003";23;24;126;22;9;204
"1836";"360470292001";22;62;171;9;34;298
"1837";"360470292002";52;12;666;21;17;768
"1838";"360470293001";70;31;17;2;11;131
"1839";"360470293002";749;43;56;1;5;854
"1840";"360470293003";25;6;62;6;21;120
"1841";"360470293004";18;11;52;8;8;97
"1842";"360470294001";39;8;147;2;12;208
"1843";"360470295001";484;313;200;8;12;1017
"1844";"360470295002";61;185;45;18;22;331
"1845";"360470295003";26;11;81;13;9;140
"1846";"360470295004";14;6;132;5;8;165
"1847";"360470296001";43;4;351;1;20;419
"1848";"360470296002";19;11;430;3;46;509
"1849";"360470296003";40;3;236;5;19;303
"1850";"360470296004";11;15;153;7;13;199
"1851";"360470297001";194;41;198;7;13;453
"1852";"360470297002";47;237;457;16;17;774
"1853";"360470297003";16;3;85;4;8;116
"1854";"360470298001";20;2;321;2;17;362
"1855";"360470298002";22;9;204;7;41;283
"1856";"360470298003";9;1;92;3;35;140
"1857";"360470299001";58;11;67;6;23;165
"1858";"360470299002";27;13;19;16;16;91
"1859";"360470300001";22;22;321;6;32;403
"1860";"360470300002";136;34;314;7;28;519
"1861";"360470301001";50;96;122;11;35;314
"1862";"360470301002";22;12;26;6;26;92
"1863";"360470301003";26;12;79;19;40;176
"1864";"360470302001";36;3;442;13;21;515
"1865";"360470302002";37;22;263;11;13;346
"1866";"360470302003";12;5;184;37;10;248
"1867";"360470303001";370;35;293;11;8;717
"1868";"360470303002";56;31;74;3;11;175
"1869";"360470303003";130;50;165;13;22;380
"1870";"360470304001";20;9;349;12;15;405
"1871";"360470304002";41;12;142;7;21;223
"1872";"360470304003";41;7;148;16;9;221
"1873";"360470305001";156;363;966;320;92;1897
"1874";"360470305002";73;53;216;47;18;407
"1875";"360470305003";73;111;130;45;29;388
"1876";"360470305004";181;81;150;55;32;499
"1877";"360470306001";29;19;321;26;22;417
"1878";"360470307001";377;24;5;1;4;411
"1879";"360470307002";110;4;13;0;9;136
"1880";"360470307003";188;62;296;81;41;668
"1881";"360470308001";111;51;416;100;49;727
"1882";"360470309001";156;55;85;15;24;335
"1883";"360470309002";42;41;88;9;9;189
"1884";"360470311001";85;57;119;28;17;306
"1885";"360470311002";75;147;87;3;6;318
"1886";"360470311003";70;131;59;3;33;296
"1887";"360470313001";53;35;184;17;12;301
"1888";"360470313002";83;43;72;8;12;218
"1889";"360470313003";194;13;117;5;7;336
"1890";"360470313004";13;14;238;4;21;290
"1891";"360470314000";0;0;0;0;2;2
"1892";"360470314001";10;2;111;9;6;138
"1893";"360470314002";7;31;89;7;16;150
"1894";"360470314003";9;9;5;0;3;26
"1895";"360470314004";20;12;190;8;22;252
"1896";"360470315001";158;124;118;9;38;447
"1897";"360470315002";180;168;98;7;33;486
"1898";"360470315003";86;54;73;3;21;237
"1899";"360470315004";129;42;52;9;50;282
"1900";"360470317011";51;141;320;11;31;554
"1901";"360470317012";78;139;105;3;22;347
"1902";"360470317013";83;188;34;10;21;336
"1903";"360470317021";36;33;34;5;25;133
"1904";"360470317022";66;32;83;10;11;202
"1905";"360470317023";87;32;107;0;47;273
"1906";"360470319001";176;34;89;29;37;365
"1907";"360470319002";25;51;64;10;22;172
"1908";"360470319003";25;27;255;45;18;370
"1909";"360470321001";52;112;53;12;28;257
"1910";"360470321002";47;37;74;5;31;194
"1911";"360470321003";69;94;60;15;8;246
"1912";"360470321004";104;90;505;187;134;1020
"1913";"360470323001";64;55;171;14;20;324
"1914";"360470323002";44;19;62;13;6;144
"1915";"360470323003";28;39;176;13;10;266
"1916";"360470325001";50;152;72;11;17;302
"1917";"360470325002";86;139;73;10;23;331
"1918";"360470325003";135;34;85;19;22;295
"1919";"360470326001";59;29;184;3;42;317
"1920";"360470326002";181;82;90;1;32;386
"1921";"360470326003";60;42;20;2;11;135
"1922";"360470326004";280;31;15;4;17;347
"1923";"360470326005";42;56;285;65;8;456
"1924";"360470327001";31;43;46;11;9;140
"1925";"360470327002";121;89;115;24;12;361
"1926";"360470327003";98;208;85;9;86;486
"1927";"360470328001";34;16;26;7;16;99
"1928";"360470328002";10;6;22;4;12;54
"1929";"360470328003";216;4;77;2;6;305
"1930";"360470328004";5;7;123;5;11;151
"1931";"360470329001";241;28;114;25;20;428
"1932";"360470329002";149;15;57;12;12;245
"1933";"360470329003";110;602;77;5;36;830
"1934";"360470329004";42;32;37;25;28;164
"1935";"360470330001";172;21;37;7;19;256
"1936";"360470330002";3;0;20;5;1;29
"1937";"360470330003";238;82;29;7;22;378
"1938";"360470331001";69;10;51;49;7;186
"1939";"360470331002";68;53;105;92;7;325
"1940";"360470331003";1;5;25;11;6;48
"1941";"360470333001";50;20;53;24;33;180
"1942";"360470333002";25;23;133;26;11;218
"1943";"360470333003";29;6;34;56;13;138
"1944";"360470335001";16;8;173;3;2;202
"1945";"360470335002";25;4;44;23;14;110
"1946";"360470335003";7;19;111;48;6;191
"1947";"360470336001";0;4;1;0;7;12
"1948";"360470336002";87;5;82;1;14;189
"1949";"360470336003";2;0;4;1;2;9
"1950";"360470336004";5;4;49;2;4;64
"1951";"360470336005";10;18;50;1;16;95
"1952";"360470337001";36;18;37;23;9;123
"1953";"360470337002";18;41;104;20;29;212
"1954";"360470337003";53;41;119;18;11;242
"1955";"360470339001";45;28;216;31;13;333
"1956";"360470339002";41;41;87;5;33;207
"1957";"360470339003";45;129;45;5;109;333
"1958";"360470339004";17;11;82;4;5;119
"1959";"360470340001";81;83;1665;9;21;1859
"1960";"360470340002";30;9;29;1;3;72
"1961";"360470341001";24;32;107;8;27;198
"1962";"360470341002";251;104;71;9;13;448
"1963";"360470341003";81;40;43;10;24;198
"1964";"360470342001";53;42;24;13;21;153
"1965";"360470342002";45;157;11;2;12;227
"1966";"360470342003";127;77;486;4;23;717
"1967";"360470342004";25;15;73;0;1;114
"1968";"360470343001";81;13;50;4;7;155
"1969";"360470343002";40;10;95;15;9;169
"1970";"360470343003";362;159;154;31;10;716
"1971";"360470345001";101;52;86;19;19;277
"1972";"360470345002";58;68;111;52;9;298
"1973";"360470347001";115;13;63;5;73;269
"1974";"360470347002";52;11;168;17;8;256
"1975";"360470347003";153;23;105;5;13;299
"1976";"360470348001";56;25;670;99;72;922
"1977";"360470348002";63;41;255;20;65;444
"1978";"360470349001";152;37;62;5;23;279
"1979";"360470349002";36;8;50;2;13;109
"1980";"360470349003";95;84;179;28;11;397
"1981";"360470349004";56;28;95;9;15;203
"1982";"360470350001";0;3;1;0;0;4
"1983";"360470350002";6;22;146;15;66;255
"1984";"360470351001";85;62;100;31;21;299
"1985";"360470351002";68;76;77;28;115;364
"1986";"360470351003";203;41;109;88;18;459
"1987";"360470352001";67;87;158;7;87;406
"1988";"360470353001";313;305;165;16;25;824
"1989";"360470353002";201;52;44;9;13;319
"1990";"360470353003";153;124;108;60;11;456
"1991";"360470354001";30;8;36;9;7;90
"1992";"360470354002";22;8;243;0;15;288
"1993";"360470354003";8;20;11;1;8;48
"1994";"360470355001";132;26;141;112;14;425
"1995";"360470355002";276;18;74;27;7;402
"1996";"360470355003";75;59;163;100;2;399
"1997";"360470356011";1;4;76;2;4;87
"1998";"360470356021";31;34;34;2;6;107
"1999";"360470356022";13;1;38;1;2;55
"2000";"360470356023";26;11;16;0;5;58
"2001";"360470357001";110;129;121;14;41;415
"2002";"360470359001";117;62;183;13;17;392
"2003";"360470359002";125;13;121;10;8;277
"2004";"360470359003";135;76;69;7;13;300
"2005";"360470359004";120;12;11;2;14;159
"2006";"360470360011";56;80;49;1;23;209
"2007";"360470360012";86;18;38;2;20;164
"2008";"360470360013";31;30;84;3;10;158
"2009";"360470360021";53;29;49;4;55;190
"2010";"360470360022";552;75;16;11;34;688
"2011";"360470361001";57;15;90;10;1;173
"2012";"360470361002";41;24;65;14;13;157
"2013";"360470361003";62;38;18;15;8;141
"2014";"360470362001";101;77;426;7;66;677
"2015";"360470362002";77;21;231;5;33;367
"2016";"360470362003";101;18;105;1;49;274
"2017";"360470363001";28;4;63;22;11;128
"2018";"360470363002";336;50;106;22;19;533
"2019";"360470363003";103;47;84;18;23;275
"2020";"360470363004";68;21;47;15;7;158
"2021";"360470364001";34;20;182;9;64;309
"2022";"360470364002";82;10;247;4;27;370
"2023";"360470365011";42;11;180;0;6;239
"2024";"360470365012";43;7;279;20;16;365
"2025";"360470365021";54;30;168;25;36;313
"2026";"360470366001";55;13;131;10;32;241
"2027";"360470366002";110;26;221;12;24;393
"2028";"360470366003";41;8;72;9;28;158
"2029";"360470367001";99;204;291;42;57;693
"2030";"360470367002";4;1;33;31;18;87
"2031";"360470369001";65;14;82;9;10;180
"2032";"360470369002";66;87;177;36;37;403
"2033";"360470369003";289;118;176;21;33;637
"2034";"360470369004";109;33;252;10;56;460
"2035";"360470370001";40;5;75;4;31;155
"2036";"360470370002";17;4;47;5;5;78
"2037";"360470370003";4;16;262;10;25;317
"2038";"360470370004";3;2;68;2;7;82
"2039";"360470371001";15;37;67;4;18;141
"2040";"360470371002";54;35;52;5;7;153
"2041";"360470371003";41;12;161;3;3;220
"2042";"360470371004";29;19;133;5;14;200
"2043";"360470371005";23;30;31;10;34;128
"2044";"360470373001";50;36;38;8;27;159
"2045";"360470373002";40;41;108;6;13;208
"2046";"360470373003";62;66;71;4;9;212
"2047";"360470373004";97;99;33;1;13;243
"2048";"360470374011";81;6;180;3;8;278
"2049";"360470374012";29;9;180;8;3;229
"2050";"360470374013";148;2;79;18;9;256
"2051";"360470374021";25;8;183;10;11;237
"2052";"360470374022";38;6;56;4;4;108
"2053";"360470374023";20;3;25;0;1;49
"2054";"360470374024";107;25;156;15;10;313
"2055";"360470375001";40;12;145;4;12;213
"2056";"360470375002";157;72;96;16;61;402
"2057";"360470375003";37;29;260;13;24;363
"2058";"360470377001";14;17;89;17;5;142
"2059";"360470377002";92;108;41;6;18;265
"2060";"360470377003";140;42;42;10;11;245
"2061";"360470377004";19;16;40;1;7;83
"2062";"360470379001";76;59;47;4;10;196
"2063";"360470379002";76;70;206;22;13;387
"2064";"360470379003";38;17;74;20;14;163
"2065";"360470381001";127;34;55;36;14;266
"2066";"360470381002";372;53;23;3;12;463
"2067";"360470381003";32;82;69;16;21;220
"2068";"360470381004";64;39;62;2;14;181
"2069";"360470382001";43;7;220;25;6;301
"2070";"360470382002";323;94;50;3;10;480
"2071";"360470382003";95;31;17;3;10;156
"2072";"360470383001";146;24;175;21;24;390
"2073";"360470383002";61;26;88;9;15;199
"2074";"360470383003";17;15;121;11;5;169
"2075";"360470383004";42;36;27;13;8;126
"2076";"360470385001";246;35;95;12;21;409
"2077";"360470385002";51;28;55;2;55;191
"2078";"360470385003";108;45;50;9;22;234
"2079";"360470385004";50;31;140;5;9;235
"2080";"360470386001";35;13;528;83;81;740
"2081";"360470386002";14;12;255;23;28;332
"2082";"360470387001";105;43;86;7;35;276
"2083";"360470387002";25;3;149;17;3;197
"2084";"360470387003";232;46;61;13;18;370
"2085";"360470387004";56;104;83;11;18;272
"2086";"360470388001";316;1;99;3;4;423
"2087";"360470388002";43;9;93;4;6;155
"2088";"360470388003";30;2;138;9;18;197
"2089";"360470388004";7;2;67;15;4;95
"2090";"360470389001";185;143;231;24;38;621
"2091";"360470389002";94;139;115;14;42;404
"2092";"360470389003";152;160;145;12;52;521
"2093";"360470390001";16;3;84;4;13;120
"2094";"360470390002";5;0;60;7;10;82
"2095";"360470391001";215;155;156;25;47;598
"2096";"360470391002";243;139;232;13;43;670
"2097";"360470392001";7;0;303;47;8;365
"2098";"360470392002";44;4;64;15;6;133
"2099";"360470393001";80;82;132;8;28;330
"2100";"360470393002";80;38;263;13;41;435
"2101";"360470393003";111;162;135;11;54;473
"2102";"360470394001";5;15;77;4;14;115
"2103";"360470394002";1;2;45;4;4;56
"2104";"360470394003";8;5;121;12;6;152
"2105";"360470395001";98;179;62;9;23;371
"2106";"360470395002";94;60;225;14;44;437
"2107";"360470395003";200;496;113;4;34;847
"2108";"360470396001";19;7;63;10;10;109
"2109";"360470396002";10;4;100;9;9;132
"2110";"360470397001";173;102;171;9;30;485
"2111";"360470397002";90;364;92;11;26;583
"2112";"360470397003";99;37;73;17;51;277
"2113";"360470398001";40;34;397;62;43;576
"2114";"360470398002";38;33;162;18;13;264
"2115";"360470399001";170;44;148;3;24;389
"2116";"360470399002";69;16;106;12;17;220
"2117";"360470399003";192;90;59;3;16;360
"2118";"360470400001";9;5;205;15;21;255
"2119";"360470400002";9;13;99;1;17;139
"2120";"360470400003";34;72;130;5;22;263
"2121";"360470401001";27;34;106;2;6;175
"2122";"360470401002";277;22;128;15;15;457
"2123";"360470401003";93;38;266;9;34;440
"2124";"360470402001";27;15;227;14;29;312
"2125";"360470402002";28;12;335;17;27;419
"2126";"360470403001";121;289;203;33;27;673
"2127";"360470403002";72;23;195;8;12;310
"2128";"360470403003";47;87;125;13;10;282
"2129";"360470404001";12;18;552;1;17;600
"2130";"360470404002";15;2;330;4;10;361
"2131";"360470405001";159;303;276;165;60;963
"2132";"360470405002";30;24;46;4;18;122
"2133";"360470406001";32;2;157;7;14;212
"2134";"360470406002";25;4;80;10;8;127
"2135";"360470406003";10;2;95;7;3;117
"2136";"360470407001";0;6;9;1;5;21
"2137";"360470408001";17;20;85;9;16;147
"2138";"360470408002";23;21;230;2;13;289
"2139";"360470408003";21;13;284;7;8;333
"2140";"360470409001";107;352;201;57;27;744
"2141";"360470409002";76;88;169;5;34;372
"2142";"360470409003";88;193;167;5;30;483
"2143";"360470410001";53;84;885;68;42;1132
"2144";"360470410002";8;8;581;10;2;609
"2145";"360470411001";59;76;159;20;23;337
"2146";"360470411002";118;30;95;9;17;269
"2147";"360470411003";67;20;76;0;18;181
"2148";"360470412001";60;12;259;9;33;373
"2149";"360470412002";377;13;599;5;19;1013
"2150";"360470413001";146;50;254;26;24;500
"2151";"360470413002";110;42;123;1;25;301
"2152";"360470413003";52;15;91;7;23;188
"2153";"360470414011";5;11;223;7;12;258
"2154";"360470414012";2;9;151;4;97;263
"2155";"360470414021";62;4;36;21;9;132
"2156";"360470414022";22;3;42;16;8;91
"2157";"360470415001";93;85;144;4;34;360
"2158";"360470415002";101;35;146;33;18;333
"2159";"360470415003";16;10;78;4;9;117
"2160";"360470416001";14;7;407;8;10;446
"2161";"360470416002";13;2;203;11;5;234
"2162";"360470417001";99;30;20;1;10;160
"2163";"360470417002";37;4;25;3;5;74
"2164";"360470417003";73;27;86;3;28;217
"2165";"360470417004";85;25;59;3;20;192
"2166";"360470418001";12;38;65;2;14;131
"2167";"360470418002";15;2;21;2;5;45
"2168";"360470419001";77;335;219;10;16;657
"2169";"360470419002";63;13;70;12;18;176
"2170";"360470419003";33;9;29;9;6;86
"2171";"360470420001";9;28;144;7;9;197
"2172";"360470420002";8;14;54;4;10;90
"2173";"360470421001";173;88;99;6;9;375
"2174";"360470421002";138;158;108;3;17;424
"2175";"360470421003";108;104;121;6;33;372
"2176";"360470421004";48;41;210;6;35;340
"2177";"360470422001";82;15;63;6;18;184
"2178";"360470422002";26;4;146;23;15;214
"2179";"360470422003";23;11;84;9;14;141
"2180";"360470423001";110;150;192;14;53;519
"2181";"360470423002";115;141;242;17;45;560
"2182";"360470423003";60;153;53;1;16;283
"2183";"360470424001";42;17;141;6;12;218
"2184";"360470424002";19;4;163;6;8;200
"2185";"360470424003";16;7;127;3;18;171
"2186";"360470425001";62;65;63;4;12;206
"2187";"360470425002";63;71;138;10;30;312
"2188";"360470425003";184;444;94;21;34;777
"2189";"360470426001";24;50;338;6;10;428
"2190";"360470426002";27;33;242;17;28;347
"2191";"360470426003";57;8;136;11;4;216
"2192";"360470427001";77;222;25;1;49;374
"2193";"360470427002";179;44;48;4;33;308
"2194";"360470427003";142;111;115;10;44;422
"2195";"360470427004";40;131;154;6;24;355
"2196";"360470428001";46;57;245;5;18;371
"2197";"360470428002";142;68;380;5;29;624
"2198";"360470428003";15;15;203;2;7;242
"2199";"360470429001";156;149;56;2;84;447
"2200";"360470429002";57;60;42;5;75;239
"2201";"360470429003";52;97;42;6;48;245
"2202";"360470429004";192;126;103;13;48;482
"2203";"360470430001";42;31;241;4;17;335
"2204";"360470430002";34;99;362;7;19;521
"2205";"360470430003";24;60;230;15;55;384
"2206";"360470431001";118;143;486;10;47;804
"2207";"360470431002";202;55;68;4;42;371
"2208";"360470431003";94;82;55;9;28;268
"2209";"360470431004";142;209;44;3;60;458
"2210";"360470432001";12;12;904;5;10;943
"2211";"360470432002";78;11;181;1;15;286
"2212";"360470432003";90;47;456;9;48;650
"2213";"360470433001";55;33;40;10;13;151
"2214";"360470433002";120;300;70;6;41;537
"2215";"360470433003";240;77;79;7;47;450
"2216";"360470434001";23;15;125;7;10;180
"2217";"360470434002";40;14;163;0;8;225
"2218";"360470434003";21;30;248;8;7;314
"2219";"360470435001";97;102;101;6;48;354
"2220";"360470435002";153;94;84;9;32;372
"2221";"360470435003";89;76;206;39;27;437
"2222";"360470436001";23;4;166;7;15;215
"2223";"360470436002";13;20;104;3;8;148
"2224";"360470436003";15;4;183;7;4;213
"2225";"360470437001";98;59;223;3;13;396
"2226";"360470437002";97;211;77;7;46;438
"2227";"360470437003";125;126;80;6;28;365
"2228";"360470437004";51;44;53;7;28;183
"2229";"360470438001";79;13;125;4;13;234
"2230";"360470438002";47;24;224;38;46;379
"2231";"360470439001";87;69;134;4;29;323
"2232";"360470439002";57;25;128;17;25;252
"2233";"360470439003";75;328;399;3;85;890
"2234";"360470440001";32;7;104;0;14;157
"2235";"360470440002";4;8;260;8;9;289
"2236";"360470440003";74;13;371;34;33;525
"2237";"360470441001";143;105;209;12;42;511
"2238";"360470441002";63;86;203;3;50;405
"2239";"360470441003";111;110;107;5;25;358
"2240";"360470442001";16;51;88;19;11;185
"2241";"360470442002";13;5;108;2;5;133
"2242";"360470443001";21;48;74;1;26;170
"2243";"360470443002";129;69;139;7;69;413
"2244";"360470443003";67;35;78;3;52;235
"2245";"360470443004";23;18;186;10;70;307
"2246";"360470444001";3;3;62;8;11;87
"2247";"360470444002";19;17;84;5;9;134
"2248";"360470444003";85;10;91;10;8;204
"2249";"360470445001";55;20;85;7;35;202
"2250";"360470445002";49;153;177;25;74;478
"2251";"360470445003";65;354;208;9;35;671
"2252";"360470446001";8;0;219;5;21;253
"2253";"360470446002";11;30;246;10;7;304
"2254";"360470447001";149;543;246;13;64;1015
"2255";"360470447002";172;356;228;28;99;883
"2256";"360470448001";5;35;111;11;9;171
"2257";"360470448002";13;27;89;4;10;143
"2258";"360470449001";32;42;29;0;12;115
"2259";"360470449002";202;143;23;6;19;393
"2260";"360470449003";19;59;265;38;23;404
"2261";"360470449004";32;334;742;87;136;1331
"2262";"360470450001";8;19;582;18;24;651
"2263";"360470452001";1;3;92;0;3;99
"2264";"360470452002";150;17;59;0;37;263
"2265";"360470453001";54;125;218;44;81;522
"2266";"360470453002";126;223;185;11;41;586
"2267";"360470454001";45;27;87;10;17;186
"2268";"360470454002";12;3;81;16;8;120
"2269";"360470456001";43;20;60;4;21;148
"2270";"360470456002";24;6;149;8;8;195
"2271";"360470458001";85;30;225;10;12;362
"2272";"360470458002";3;1;45;2;1;52
"2273";"360470460001";47;15;477;8;11;558
"2274";"360470460002";38;359;147;8;19;571
"2275";"360470460003";7;36;146;9;34;232
"2276";"360470462011";46;8;377;19;8;458
"2277";"360470462012";17;16;117;3;27;180
"2278";"360470462021";40;4;44;3;6;97
"2279";"360470462022";13;7;135;14;34;203
"2280";"360470464001";4;3;118;9;6;140
"2281";"360470464002";1;1;52;4;3;61
"2282";"360470468001";265;240;222;12;14;753
"2283";"360470470001";2;1;42;6;4;55
"2284";"360470470002";0;5;83;14;2;104
"2285";"360470472001";0;3;50;3;0;56
"2286";"360470472002";5;3;106;8;6;128
"2287";"360470472003";1;3;163;8;3;178
"2288";"360470474001";3;4;83;1;4;95
"2289";"360470474002";0;1;188;2;2;193
"2290";"360470476001";24;16;99;21;12;172
"2291";"360470476002";1;2;33;3;2;41
"2292";"360470476003";0;0;52;6;5;63
"2293";"360470477001";184;53;134;6;55;432
"2294";"360470477002";65;135;155;15;212;582
"2295";"360470478001";26;25;161;23;27;262
"2296";"360470478002";50;18;130;7;25;230
"2297";"360470478003";14;4;198;25;10;251
"2298";"360470480001";52;10;273;5;14;354
"2299";"360470480002";60;36;541;25;37;699
"2300";"360470481001";27;7;57;6;20;117
"2301";"360470481002";23;27;124;1;13;188
"2302";"360470481003";92;53;99;19;41;304
"2303";"360470482001";45;40;152;16;11;264
"2304";"360470482002";15;18;337;12;20;402
"2305";"360470482003";38;7;259;8;50;362
"2306";"360470482004";232;23;738;12;15;1020
"2307";"360470484001";96;45;300;17;23;481
"2308";"360470484002";34;25;314;23;22;418
"2309";"360470484003";13;9;112;8;7;149
"2310";"360470485001";145;214;669;46;89;1163
"2311";"360470485002";109;96;557;20;56;838
"2312";"360470486001";5;94;101;5;33;238
"2313";"360470486002";8;42;112;17;6;185
"2314";"360470486003";9;79;159;11;39;297
"2315";"360470488001";33;23;87;5;13;161
"2316";"360470488002";16;4;289;6;2;317
"2317";"360470488003";14;7;155;0;11;187
"2318";"360470489001";326;23;10;8;18;385
"2319";"360470489002";37;3;10;0;6;56
"2320";"360470489003";87;26;11;2;5;131
"2321";"360470490001";74;30;355;31;31;521
"2322";"360470490002";102;27;662;10;20;821
"2323";"360470490003";11;3;247;30;10;301
"2324";"360470491001";16;15;55;6;16;108
"2325";"360470491002";91;341;41;2;37;512
"2326";"360470491003";138;244;52;0;31;465
"2327";"360470491004";35;39;50;0;12;136
"2328";"360470492001";24;15;105;20;9;173
"2329";"360470492002";46;49;130;67;40;332
"2330";"360470492003";33;24;220;44;19;340
"2331";"360470493001";143;79;35;18;53;328
"2332";"360470493002";71;69;55;7;34;236
"2333";"360470493003";42;212;50;3;116;423
"2334";"360470493004";79;21;10;2;15;127
"2335";"360470493005";70;92;32;6;15;215
"2336";"360470494001";63;26;143;5;11;248
"2337";"360470494002";72;7;201;18;11;309
"2338";"360470494003";29;18;94;8;7;156
"2339";"360470494004";6;4;54;1;7;72
"2340";"360470495001";28;28;89;0;59;204
"2341";"360470495002";91;26;135;6;35;293
"2342";"360470495003";80;91;129;0;41;341
"2343";"360470496001";69;636;181;7;45;938
"2344";"360470496002";15;55;225;2;71;368
"2345";"360470496003";56;21;258;18;13;366
"2346";"360470497001";44;15;210;4;16;289
"2347";"360470497002";99;137;91;2;65;394
"2348";"360470497003";44;45;66;1;33;189
"2349";"360470498001";72;169;143;39;25;448
"2350";"360470498002";15;40;360;17;14;446
"2351";"360470498003";9;2;314;27;10;362
"2352";"360470499001";42;20;450;9;19;540
"2353";"360470499002";116;34;171;12;50;383
"2354";"360470500001";11;26;51;5;7;100
"2355";"360470500002";23;52;123;5;27;230
"2356";"360470500003";34;14;180;18;9;255
"2357";"360470501001";16;16;96;5;22;155
"2358";"360470501002";43;16;55;3;21;138
"2359";"360470501003";33;193;193;14;216;649
"2360";"360470502021";5;8;41;1;12;67
"2361";"360470502022";12;48;84;5;12;161
"2362";"360470503001";47;16;129;1;17;210
"2363";"360470503002";89;81;182;2;31;385
"2364";"360470503003";35;87;108;0;24;254
"2365";"360470504001";8;23;41;3;30;105
"2366";"360470504002";84;26;266;7;24;407
"2367";"360470504003";58;43;171;20;41;333
"2368";"360470505001";37;54;28;0;7;126
"2369";"360470505002";113;207;88;18;34;460
"2370";"360470505003";93;225;78;7;27;430
"2371";"360470506001";91;66;66;2;49;274
"2372";"360470506002";99;4;71;4;17;195
"2373";"360470506003";105;74;85;6;9;279
"2374";"360470506004";39;12;71;36;37;195
"2375";"360470507001";31;193;368;45;99;736
"2376";"360470508011";157;82;25;4;14;282
"2377";"360470508012";221;137;32;3;47;440
"2378";"360470508031";268;338;316;15;79;1016
"2379";"360470508041";171;119;251;22;68;631
"2380";"360470508042";546;104;327;11;30;1018
"2381";"360470508043";141;23;167;9;25;365
"2382";"360470509001";18;38;78;21;18;173
"2383";"360470509002";2;8;40;14;3;67
"2384";"360470510011";212;11;41;30;13;307
"2385";"360470510012";212;350;25;9;57;653
"2386";"360470510021";104;57;143;22;29;355
"2387";"360470510022";77;57;54;4;23;215
"2388";"360470510023";88;37;61;6;9;201
"2389";"360470511001";13;51;41;6;25;136
"2390";"360470511002";227;116;108;11;30;492
"2391";"360470511003";101;325;102;14;27;569
"2392";"360470512001";264;69;116;33;22;504
"2393";"360470512002";122;51;69;9;29;280
"2394";"360470512003";67;25;82;12;13;199
"2395";"360470512004";117;46;172;8;21;364
"2396";"360470513001";68;230;220;7;146;671
"2397";"360470513002";53;38;138;5;8;242
"2398";"360470513003";255;337;387;30;83;1092
"2399";"360470513004";53;63;60;1;14;191
"2400";"360470514001";34;28;153;13;9;237
"2401";"360470514002";77;30;46;5;20;178
"2402";"360470514003";211;75;90;6;15;397
"2403";"360470514004";92;22;74;9;14;211
"2404";"360470515001";67;238;148;9;98;560
"2405";"360470516011";76;8;61;3;15;163
"2406";"360470516012";124;70;54;2;14;264
"2407";"360470516013";167;306;185;34;83;775
"2408";"360470516021";145;217;117;18;21;518
"2409";"360470516022";112;331;104;9;78;634
"2410";"360470517001";80;156;85;3;25;349
"2411";"360470517002";86;143;91;1;30;351
"2412";"360470518001";56;9;129;19;48;261
"2413";"360470518002";36;32;180;12;10;270
"2414";"360470518003";27;11;24;16;5;83
"2415";"360470519001";184;119;154;7;26;490
"2416";"360470519002";138;99;188;8;43;476
"2417";"360470519003";92;230;261;13;68;664
"2418";"360470520001";40;36;177;8;31;292
"2419";"360470520002";18;17;123;13;66;237
"2420";"360470520003";48;7;97;0;6;158
"2421";"360470523001";169;419;135;11;85;819
"2422";"360470523002";89;219;26;1;17;352
"2423";"360470523003";74;36;24;4;14;152
"2424";"360470523004";44;51;62;5;14;176
"2425";"360470523005";89;342;54;5;20;510
"2426";"360470525001";122;146;88;11;116;483
"2427";"360470525002";44;34;16;3;6;103
"2428";"360470526001";55;83;245;21;18;422
"2429";"360470526002";43;35;483;10;48;619
"2430";"360470526003";1;3;79;2;5;90
"2431";"360470527001";103;267;143;3;22;538
"2432";"360470527002";31;45;15;0;8;99
"2433";"360470527003";79;84;71;6;30;270
"2434";"360470527004";136;64;33;2;38;273
"2435";"360470527005";32;69;32;5;14;152
"2436";"360470527006";62;189;52;6;15;324
"2437";"360470527007";7;54;38;4;4;107
"2438";"360470528001";61;16;254;7;13;351
"2439";"360470528002";7;6;105;9;14;141
"2440";"360470529001";1;7;122;2;15;147
"2441";"360470529002";6;2;47;6;12;73
"2442";"360470529003";16;12;54;6;85;173
"2443";"360470530001";65;12;46;2;10;135
"2444";"360470530002";40;30;63;7;2;142
"2445";"360470530003";54;13;98;25;41;231
"2446";"360470531001";20;18;87;12;33;170
"2447";"360470531002";4;4;16;0;8;32
"2448";"360470531003";1;6;13;0;2;22
"2449";"360470531004";4;0;6;2;1;13
"2450";"360470532001";104;47;164;8;28;351
"2451";"360470532002";28;27;182;2;20;259
"2452";"360470533001";1;1;8;0;1;11
"2453";"360470533002";0;2;7;4;3;16
"2454";"360470533003";2;0;15;5;2;24
"2455";"360470533004";3;0;7;4;5;19
"2456";"360470533005";6;6;7;2;4;25
"2457";"360470534001";40;12;169;0;12;233
"2458";"360470534002";15;9;72;0;18;114
"2459";"360470534003";25;7;27;2;3;64
"2460";"360470534004";125;22;47;8;27;229
"2461";"360470535001";5;3;4;5;3;20
"2462";"360470535002";0;1;12;1;3;17
"2463";"360470535003";11;6;11;3;3;34
"2464";"360470535004";63;12;40;8;22;145
"2465";"360470537001";0;3;29;0;4;36
"2466";"360470537002";2;12;50;16;9;89
"2467";"360470538001";38;16;747;6;9;816
"2468";"360470538002";235;14;316;17;18;600
"2469";"360470538003";19;61;205;12;31;328
"2470";"360470539001";0;0;44;22;1;67
"2471";"360470539002";8;5;21;0;2;36
"2472";"360470542001";71;3;329;11;12;426
"2473";"360470542002";24;45;142;17;25;253
"2474";"360470542003";6;0;135;4;1;146
"2475";"360470543001";98;23;126;5;14;266
"2476";"360470543002";34;123;218;24;29;428
"2477";"360470544001";23;7;203;8;6;247
"2478";"360470544002";35;2;256;9;12;314
"2479";"360470544003";8;2;80;12;6;108
"2480";"360470545001";0;4;16;12;4;36
"2481";"360470545002";2;10;18;0;7;37
"2482";"360470545003";24;14;12;15;3;68
"2483";"360470545004";0;1;6;1;0;8
"2484";"360470545005";1124;49;48;0;3;1224
"2485";"360470545006";32;41;25;5;6;109
"2486";"360470546001";27;27;385;2;45;486
"2487";"360470546002";172;19;326;5;33;555
"2488";"360470546003";120;14;113;2;5;254
"2489";"360470547001";62;41;63;1;16;183
"2490";"360470547002";7;21;20;1;1;50
"2491";"360470547003";71;68;120;5;34;298
"2492";"360470548001";25;3;94;9;12;143
"2493";"360470548002";0;2;178;16;6;202
"2494";"360470549001";30;48;114;7;25;224
"2495";"360470549002";175;281;240;10;95;801
"2496";"360470550001";23;6;367;14;14;424
"2497";"360470550002";44;2;152;0;10;208
"2498";"360470550003";19;14;125;6;26;190
"2499";"360470551001";80;332;579;5;64;1060
"2500";"360470551002";71;120;115;6;35;347
"2501";"360470551003";227;217;397;5;115;961
"2502";"360470551004";99;46;45;5;23;218
"2503";"360470552001";193;4;106;0;15;318
"2504";"360470552002";35;21;83;5;20;164
"2505";"360470552003";29;14;178;9;52;282
"2506";"360470553001";138;243;100;2;82;565
"2507";"360470553002";84;88;100;6;55;333
"2508";"360470553003";179;171;157;4;69;580
"2509";"360470554001";63;38;138;6;23;268
"2510";"360470554002";45;9;105;3;15;177
"2511";"360470554003";43;9;128;3;38;221
"2512";"360470555001";429;1275;597;10;155;2466
"2513";"360470556001";78;254;155;12;46;545
"2514";"360470556002";20;7;104;3;4;138
"2515";"360470556003";35;6;106;4;16;167
"2516";"360470557001";63;112;79;2;15;271
"2517";"360470557002";113;936;201;9;38;1297
"2518";"360470558001";9;2;105;8;11;135
"2519";"360470558002";59;447;344;6;31;887
"2520";"360470560001";16;4;139;23;7;189
"2521";"360470560002";44;4;108;18;7;181
"2522";"360470560003";47;5;123;5;3;183
"2523";"360470561001";72;130;189;4;42;437
"2524";"360470561002";5;6;63;1;16;91
"2525";"360470561003";84;238;716;3;275;1316
"2526";"360470561004";36;7;211;13;26;293
"2527";"360470562001";0;2;85;11;2;100
"2528";"360470562002";0;0;108;5;10;123
"2529";"360470563001";122;171;536;13;45;887
"2530";"360470563002";96;183;298;12;27;616
"2531";"360470563003";47;71;444;6;122;690
"2532";"360470563004";40;82;152;2;31;307
"2533";"360470564001";5;4;91;3;4;107
"2534";"360470564002";10;3;50;4;6;73
"2535";"360470564003";3;7;63;11;7;91
"2536";"360470565001";90;383;339;13;50;875
"2537";"360470565002";58;18;129;2;39;246
"2538";"360470565003";51;249;94;2;34;430
"2539";"360470566001";35;6;35;10;6;92
"2540";"360470566002";19;10;31;6;6;72
"2541";"360470568001";23;6;52;3;24;108
"2542";"360470568002";0;1;18;14;1;34
"2543";"360470569001";57;233;124;6;97;517
"2544";"360470569002";48;203;313;16;54;634
"2545";"360470570001";5;2;20;1;5;33
"2546";"360470570002";9;4;56;5;4;78
"2547";"360470570003";8;1;16;4;1;30
"2548";"360470570004";31;7;118;16;13;185
"2549";"360470571001";6;70;216;2;30;324
"2550";"360470571002";16;18;106;1;13;154
"2551";"360470571003";18;34;102;1;36;191
"2552";"360470571004";19;15;127;3;15;179
"2553";"360470572001";879;56;116;32;12;1095
"2554";"360470572002";236;60;124;28;18;466
"2555";"360470573001";57;117;193;11;11;389
"2556";"360470573002";52;5;88;6;12;163
"2557";"360470573003";83;10;184;4;16;297
"2558";"360470574001";20;119;33;8;3;183
"2559";"360470574002";12;3;54;6;9;84
"2560";"360470575001";65;28;327;8;33;461
"2561";"360470575002";31;38;930;30;12;1041
"2562";"360470575003";22;42;123;1;21;209
"2563";"360470575004";50;66;79;2;31;228
"2564";"360470576001";17;14;148;20;15;214
"2565";"360470576002";7;6;115;13;15;156
"2566";"360470578001";22;13;330;12;32;409
"2567";"360470578002";55;28;132;28;22;265
"2568";"360470579001";31;130;270;7;12;450
"2569";"360470579002";55;27;1273;75;54;1484
"2570";"360470580001";140;7;106;29;37;319
"2571";"360470580002";42;14;102;5;27;190
"2572";"360470582001";36;10;164;1;16;227
"2573";"360470582002";9;32;72;17;13;143
"2574";"360470582003";26;10;149;6;11;202
"2575";"360470584001";16;6;197;8;1;228
"2576";"360470584002";45;22;297;17;26;407
"2577";"360470586001";13;11;118;11;18;171
"2578";"360470586002";4;10;308;15;7;344
"2579";"360470588001";51;15;358;34;18;476
"2580";"360470588002";31;4;63;1;19;118
"2581";"360470589001";56;14;887;53;15;1025
"2582";"360470589002";18;38;165;4;7;232
"2583";"360470590001";47;14;295;34;18;408
"2584";"360470591001";45;12;53;3;15;128
"2585";"360470591002";16;12;47;0;17;92
"2586";"360470591003";7;19;82;4;10;122
"2587";"360470591004";15;48;57;0;31;151
"2588";"360470592001";48;4;118;8;7;185
"2589";"360470592002";72;6;123;11;17;229
"2590";"360470592003";26;8;121;16;8;179
"2591";"360470593001";14;15;209;13;29;280
"2592";"360470593002";80;87;226;7;58;458
"2593";"360470594011";10;5;73;19;3;110
"2594";"360470594012";13;2;122;10;10;157
"2595";"360470594013";5;11;342;19;26;403
"2596";"360470594014";41;14;302;15;7;379
"2597";"360470594015";28;2;76;9;9;124
"2598";"360470594016";160;20;150;28;9;367
"2599";"360470594021";14;60;72;11;31;188
"2600";"360470594022";44;7;841;13;17;922
"2601";"360470594023";15;1;181;12;3;212
"2602";"360470594024";11;3;88;11;5;118
"2603";"360470596001";7;9;25;3;3;47
"2604";"360470596002";22;2;11;3;3;41
"2605";"360470596003";15;11;335;7;15;383
"2606";"360470598001";13;10;98;33;16;170
"2607";"360470598002";14;3;107;24;8;156
"2608";"360470600001";26;141;122;12;4;305
"2609";"360470600002";14;11;314;46;14;399
"2610";"360470600003";35;12;966;32;26;1071
"2611";"360470600004";8;7;90;1;18;124
"2612";"360470600005";17;8;82;11;11;129
"2613";"360470606001";30;74;198;12;58;372
"2614";"360470606002";62;8;210;21;58;359
"2615";"360470608001";30;19;123;17;17;206
"2616";"360470608002";89;4;97;3;29;222
"2617";"360470608003";66;314;196;6;49;631
"2618";"360470610021";28;29;103;4;11;175
"2619";"360470610022";133;41;83;0;19;276
"2620";"360470610031";11;3;38;1;27;80
"2621";"360470610032";23;12;236;10;17;298
"2622";"360470610041";49;28;127;2;16;222
"2623";"360470610042";25;6;105;4;7;147
"2624";"360470610043";33;29;83;5;11;161
"2625";"360470610044";56;12;11;0;1;80
"2626";"360470610045";25;22;56;1;17;121
"2627";"360470612001";14;35;529;6;21;605
"2628";"360470616001";12;69;207;18;24;330
"2629";"360470620001";135;26;159;8;7;335
"2630";"360470620002";8;106;157;13;8;292
"2631";"360470622001";64;3;196;14;19;296
"2632";"360470622002";77;11;245;44;16;393
"2633";"360470626001";16;3;70;15;14;118
"2634";"360470626002";32;15;124;37;15;223
"2635";"360470628001";17;13;77;25;21;153
"2636";"360470628002";14;21;161;19;50;265
"2637";"360470628003";6;4;28;14;14;66
"2638";"360470628004";12;6;72;23;21;134
"2639";"360470632001";13;8;32;0;12;65
"2640";"360470632002";38;3;59;12;4;116
"2641";"360470636001";9;4;126;23;11;173
"2642";"360470638001";6;0;90;1;2;99
"2643";"360470638002";2;7;74;6;7;96
"2644";"360470640001";14;9;35;3;5;66
"2645";"360470640002";7;7;36;1;61;112
"2646";"360470642001";66;10;124;25;21;246
"2647";"360470642002";12;5;132;4;5;158
"2648";"360470644001";9;6;208;21;11;255
"2649";"360470644002";20;14;67;28;8;137
"2650";"360470646001";7;1;171;10;12;201
"2651";"360470646002";143;9;218;15;20;405
"2652";"360470648001";23;7;118;25;7;180
"2653";"360470648002";4;1;61;16;1;83
"2654";"360470650001";7;12;73;5;13;110
"2655";"360470650002";17;38;59;49;9;172
"2656";"360470652001";37;43;218;9;21;328
"2657";"360470654001";19;2;74;0;14;109
"2658";"360470654002";34;0;48;0;7;89
"2659";"360470656001";4;11;80;12;22;129
"2660";"360470656002";2;0;16;7;6;31
"2661";"360470658001";13;21;85;3;5;127
"2662";"360470658002";8;15;162;18;10;213
"2663";"360470660001";3;1;132;3;11;150
"2664";"360470660002";35;1;62;8;5;111
"2665";"360470662001";317;18;244;24;41;644
"2666";"360470666001";32;51;133;39;46;301
"2667";"360470670001";8;2;68;23;6;107
"2668";"360470670002";18;11;267;50;33;379
"2669";"360470672001";30;47;211;64;14;366
"2670";"360470674001";17;26;115;35;16;209
"2671";"360470674002";12;6;103;42;13;176
"2672";"360470676001";14;4;56;17;6;97
"2673";"360470676002";10;4;121;60;9;204
"2674";"360470678001";27;1;101;43;7;179
"2675";"360470678002";17;7;119;42;8;193
"2676";"360470680001";14;1;137;31;7;190
"2677";"360470680002";42;14;175;37;12;280
"2678";"360470682001";56;65;203;21;14;359
"2679";"360470682002";53;5;187;28;9;282
"2680";"360470686001";3;3;177;20;7;210
"2681";"360470686002";12;9;134;24;4;183
"2682";"360470688001";29;6;61;5;11;112
"2683";"360470688002";6;4;41;14;8;73
"2684";"360470690001";17;7;141;25;9;199
"2685";"360470690002";21;66;178;10;19;294
"2686";"360470692001";15;11;182;51;22;281
"2687";"360470692002";4;0;142;4;2;152
"2688";"360470696011";35;8;428;28;12;511
"2689";"360470696012";27;14;300;32;12;385
"2690";"360470696021";14;4;144;26;25;213
"2691";"360470696022";55;107;164;37;19;382
"2692";"360470696023";76;12;201;24;35;348
"2693";"360470698001";5;3;14;13;9;44
"2694";"360470698002";19;11;149;31;10;220
"2695";"360470700001";32;2;27;7;13;81
"2696";"360470700002";8;5;124;3;7;147
"2697";"360470702011";10;2;52;12;16;92
"2698";"360470702012";3;2;59;16;7;87
"2699";"360470702013";4;0;44;4;13;65
"2700";"360470702014";18;5;156;12;6;197
"2701";"360470702015";18;13;241;31;15;318
"2702";"360470702021";0;4;4;0;2;10
"2703";"360470702030";0;1;0;0;0;1
"2704";"360470706001";10;3;73;10;16;112
"2705";"360470706002";16;16;76;29;24;161
"2706";"360470720001";18;3;288;122;14;445
"2707";"360470722001";69;16;122;21;10;238
"2708";"360470722002";51;14;216;44;19;344
"2709";"360470724001";21;2;51;21;3;98
"2710";"360470724002";17;37;106;38;19;217
"2711";"360470726001";18;9;140;68;21;256
"2712";"360470728001";187;10;160;16;7;380
"2713";"360470728002";17;183;124;28;10;362
"2714";"360470730001";39;82;270;34;20;445
"2715";"360470730002";14;3;127;27;7;178
"2716";"360470732001";37;3;79;11;7;137
"2717";"360470732002";14;5;43;22;6;90
"2718";"360470734001";6;6;22;5;8;47
"2719";"360470734002";1;2;74;23;12;112
"2720";"360470736001";27;3;14;6;1;51
"2721";"360470736002";19;5;112;39;8;183
"2722";"360470736003";6;6;31;15;11;69
"2723";"360470738001";16;36;178;12;11;253
"2724";"360470738002";25;3;133;0;4;165
"2725";"360470738003";13;4;210;6;11;244
"2726";"360470740001";38;19;192;14;16;279
"2727";"360470740002";45;37;109;19;17;227
"2728";"360470742001";43;29;223;15;9;319
"2729";"360470742002";137;28;127;2;9;303
"2730";"360470744001";7;3;58;5;2;75
"2731";"360470744002";4;5;104;2;4;119
"2732";"360470746001";35;7;142;14;9;207
"2733";"360470746002";15;14;279;4;27;339
"2734";"360470748001";45;7;85;8;11;156
"2735";"360470748002";3;2;50;11;3;69
"2736";"360470750001";13;4;132;6;5;160
"2737";"360470750002";113;6;39;2;14;174
"2738";"360470752001";1;5;104;9;6;125
"2739";"360470754001";2;12;172;13;2;201
"2740";"360470754002";0;11;79;8;2;100
"2741";"360470756001";8;2;138;10;10;168
"2742";"360470756002";3;0;96;9;6;114
"2743";"360470758001";0;6;182;25;6;219
"2744";"360470758002";103;7;133;0;10;253
"2745";"360470760001";2;1;75;2;1;81
"2746";"360470760002";16;3;64;10;5;98
"2747";"360470760003";12;4;82;5;1;104
"2748";"360470762001";40;1;42;4;7;94
"2749";"360470762002";73;9;104;6;6;198
"2750";"360470762003";232;8;47;2;12;301
"2751";"360470764001";50;5;154;14;4;227
"2752";"360470764002";13;9;39;1;7;69
"2753";"360470764003";58;18;109;12;6;203
"2754";"360470766001";129;6;206;20;10;371
"2755";"360470768001";28;34;159;41;24;286
"2756";"360470768002";17;15;166;9;8;215
"2757";"360470768003";43;7;159;9;40;258
"2758";"360470770001";39;50;66;19;12;186
"2759";"360470770002";27;41;700;105;37;910
"2760";"360470772001";71;13;244;53;9;390
"2761";"360470772002";180;8;92;4;12;296
"2762";"360470774001";29;14;101;13;27;184
"2763";"360470774002";202;53;160;12;22;449
"2764";"360470776001";62;32;19;25;7;145
"2765";"360470776002";56;6;41;17;1;121
"2766";"360470776003";25;2;457;9;11;504
"2767";"360470780001";14;6;44;11;5;80
"2768";"360470780002";12;15;81;16;18;142
"2769";"360470782001";35;9;120;13;14;191
"2770";"360470782002";373;26;196;9;14;618
"2771";"360470784001";61;9;295;8;5;378
"2772";"360470784002";50;15;184;22;13;284
"2773";"360470786001";176;40;85;10;17;328
"2774";"360470786002";28;30;61;16;28;163
"2775";"360470786003";117;22;632;27;20;818
"2776";"360470788001";69;28;108;3;8;216
"2777";"360470788002";41;32;87;20;23;203
"2778";"360470788003";59;32;294;21;26;432
"2779";"360470790001";118;109;89;33;27;376
"2780";"360470790002";64;40;102;21;19;246
"2781";"360470790003";45;6;120;30;11;212
"2782";"360470790004";53;17;83;52;13;218
"2783";"360470792001";81;52;192;63;14;402
"2784";"360470792002";58;27;271;7;23;386
"2785";"360470792003";69;137;157;50;44;457
"2786";"360470794001";119;103;230;64;62;578
"2787";"360470794002";54;16;116;23;9;218
"2788";"360470796011";149;104;108;13;26;400
"2789";"360470796012";96;71;257;13;36;473
"2790";"360470796021";122;114;220;17;35;508
"2791";"360470796022";260;216;153;48;83;760
"2792";"360470798011";112;76;95;7;10;300
"2793";"360470798012";23;56;397;6;26;508
"2794";"360470798021";295;44;210;3;15;567
"2795";"360470798022";662;838;47;2;382;1931
"2796";"360470798023";80;157;79;24;167;507
"2797";"360470800001";186;292;56;16;13;563
"2798";"360470800002";47;102;105;35;19;308
"2799";"360470800003";46;50;88;30;9;223
"2800";"360470802001";102;36;135;10;15;298
"2801";"360470802002";80;40;177;5;26;328
"2802";"360470802003";39;13;178;20;17;267
"2803";"360470804001";86;430;86;7;24;633
"2804";"360470804002";37;53;130;5;10;235
"2805";"360470804003";160;312;127;17;46;662
"2806";"360470806001";178;91;511;28;12;820
"2807";"360470806002";88;32;200;76;11;407
"2808";"360470808001";189;22;68;61;52;392
"2809";"360470810001";24;38;361;30;15;468
"2810";"360470810002";22;30;159;27;15;253
"2811";"360470814001";161;61;109;39;19;389
"2812";"360470814002";54;20;224;22;17;337
"2813";"360470816001";37;9;246;7;12;311
"2814";"360470816002";40;167;171;14;35;427
"2815";"360470818001";127;117;319;5;10;578
"2816";"360470818002";75;21;61;8;19;184
"2817";"360470818003";62;35;125;19;22;263
"2818";"360470820001";230;81;280;26;23;640
"2819";"360470820002";115;68;108;7;15;313
"2820";"360470820003";216;56;140;17;67;496
"2821";"360470822001";75;38;69;7;21;210
"2822";"360470822002";389;435;335;24;47;1230
"2823";"360470822003";368;284;354;26;75;1107
"2824";"360470822004";98;44;201;48;34;425
"2825";"360470824001";61;41;580;21;33;736
"2826";"360470824002";50;19;139;27;30;265
"2827";"360470824003";167;23;255;25;25;495
"2828";"360470824004";216;26;170;29;25;466
"2829";"360470826001";36;25;130;20;15;226
"2830";"360470826002";22;35;159;21;16;253
"2831";"360470826003";129;127;101;39;21;417
"2832";"360470826004";31;32;104;39;14;220
"2833";"360470828001";55;37;48;23;10;173
"2834";"360470828002";44;30;102;18;17;211
"2835";"360470828003";80;44;266;19;29;438
"2836";"360470830001";179;42;244;15;10;490
"2837";"360470830002";30;13;218;18;11;290
"2838";"360470830003";103;15;86;6;8;218
"2839";"360470830004";280;53;56;0;48;437
"2840";"360470832001";6;8;67;20;7;108
"2841";"360470832002";102;80;144;18;8;352
"2842";"360470834001";14;5;51;4;20;94
"2843";"360470834002";55;16;54;20;4;149
"2844";"360470836001";6;9;170;49;15;249
"2845";"360470836002";36;22;72;36;4;170
"2846";"360470838001";65;23;48;11;23;170
"2847";"360470838002";39;22;41;15;8;125
"2848";"360470840001";33;18;98;32;8;189
"2849";"360470840002";12;4;114;14;17;161
"2850";"360470846001";24;41;91;23;12;191
"2851";"360470846002";29;16;97;32;15;189
"2852";"360470848001";12;11;99;15;15;152
"2853";"360470848002";71;22;57;15;10;175
"2854";"360470850001";65;20;74;73;21;253
"2855";"360470852001";6;2;7;1;7;23
"2856";"360470854001";46;5;76;17;3;147
"2857";"360470854002";73;5;95;41;22;236
"2858";"360470856001";67;67;70;7;13;224
"2859";"360470856002";29;9;42;16;9;105
"2860";"360470856003";65;32;136;13;25;271
"2861";"360470858001";19;3;40;19;13;94
"2862";"360470858002";48;29;47;23;26;173
"2863";"360470860001";43;16;65;32;42;198
"2864";"360470860002";42;28;142;19;14;245
"2865";"360470860003";39;12;52;13;20;136
"2866";"360470862001";48;17;61;4;4;134
"2867";"360470862002";34;74;112;9;21;250
"2868";"360470862003";20;5;72;14;29;140
"2869";"360470864001";27;12;74;55;11;179
"2870";"360470864002";23;6;79;10;13;131
"2871";"360470866001";33;39;282;27;27;408
"2872";"360470866002";23;16;38;20;10;107
"2873";"360470866003";27;76;61;32;8;204
"2874";"360470868001";58;19;76;19;21;193
"2875";"360470868002";25;29;95;27;11;187
"2876";"360470868003";136;36;75;16;35;298
"2877";"360470870001";47;12;97;22;15;193
"2878";"360470870002";20;15;37;20;21;113
"2879";"360470870003";182;6;28;27;7;250
"2880";"360470872001";23;4;29;12;2;70
"2881";"360470872002";40;5;60;4;4;113
"2882";"360470872003";61;12;36;13;23;145
"2883";"360470874011";87;74;456;76;22;715
"2884";"360470874012";219;252;282;49;65;867
"2885";"360470876001";92;17;214;47;10;380
"2886";"360470876002";13;15;58;33;8;127
"2887";"360470878001";22;64;86;8;17;197
"2888";"360470878002";0;34;11;19;7;71
"2889";"360470878003";91;75;117;16;31;330
"2890";"360470880001";47;62;134;46;36;325
"2891";"360470880002";7;21;11;2;4;45
"2892";"360470880003";89;12;92;20;13;226
"2893";"360470882001";233;27;149;28;40;477
"2894";"360470882002";29;10;160;9;37;245
"2895";"360470882003";79;32;82;16;12;221
"2896";"360470882004";114;47;103;22;15;301
"2897";"360470884001";208;30;136;52;19;445
"2898";"360470884002";24;13;87;22;33;179
"2899";"360470884003";48;13;68;10;6;145
"2900";"360470886001";215;25;115;6;5;366
"2901";"360470886002";238;80;90;18;14;440
"2902";"360470886003";91;11;118;21;12;253
"2903";"360470888001";96;26;191;7;15;335
"2904";"360470888002";29;7;91;34;9;170
"2905";"360470888003";19;29;89;29;8;174
"2906";"360470890001";72;3;45;3;7;130
"2907";"360470890002";66;47;61;22;12;208
"2908";"360470890003";22;3;12;1;9;47
"2909";"360470890004";83;53;88;9;22;255
"2910";"360470890005";17;19;108;8;8;160
"2911";"360470890006";20;8;76;1;28;133
"2912";"360470892001";28;23;35;8;20;114
"2913";"360470892002";79;12;60;14;17;182
"2914";"360470892003";224;31;11;2;12;280
"2915";"360470892004";11;9;17;4;7;48
"2916";"360470894001";21;12;40;17;5;95
"2917";"360470894002";45;30;48;11;8;142
"2918";"360470894003";81;34;66;4;8;193
"2919";"360470894004";77;15;40;20;7;159
"2920";"360470896001";16;77;55;9;6;163
"2921";"360470896002";196;36;261;39;14;546
"2922";"360470896003";121;60;46;18;8;253
"2923";"360470898001";17;18;38;14;6;93
"2924";"360470898002";112;89;124;27;26;378
"2925";"360470900001";26;17;49;7;41;140
"2926";"360470900002";30;11;11;61;21;134
"2927";"360470900003";66;31;94;1;36;228
"2928";"360470900004";48;46;62;16;5;177
"2929";"360470900005";50;63;158;21;8;300
"2930";"360470900006";19;19;22;5;6;71
"2931";"360470900007";15;1;14;3;8;41
"2932";"360470902001";184;36;30;5;8;263
"2933";"360470902002";8;1;4;1;0;14
"2934";"360470902003";11;2;14;4;3;34
"2935";"360470902004";59;64;42;13;4;182
"2936";"360470902005";10;5;65;8;8;96
"2937";"360470906001";122;34;62;10;84;312
"2938";"360470906002";56;28;57;12;49;202
"2939";"360470906003";55;6;18;8;9;96
"2940";"360470908001";120;67;209;33;34;463
"2941";"360470908002";20;8;15;3;24;70
"2942";"360470908003";30;11;48;2;16;107
"2943";"360470910001";54;31;7;0;3;95
"2944";"360470910002";112;20;46;5;2;185
"2945";"360470910003";82;5;27;3;3;120
"2946";"360470910004";54;11;99;10;16;190
"2947";"360470912001";271;7;102;9;2;391
"2948";"360470912002";46;12;26;3;5;92
"2949";"360470912003";493;28;22;5;7;555
"2950";"360470916001";91;30;40;7;19;187
"2951";"360470916002";14;24;93;20;11;162
"2952";"360470916003";25;14;118;12;8;177
"2953";"360470916004";62;44;120;16;16;258
"2954";"360470918001";277;114;68;6;405;870
"2955";"360470918002";22;3;84;45;10;164
"2956";"360470920001";51;17;71;28;3;170
"2957";"360470920002";341;50;53;15;21;480
"2958";"360470920003";55;34;107;7;8;211
"2959";"360470922001";36;21;52;29;9;147
"2960";"360470922002";33;11;32;5;13;94
"2961";"360470924001";78;90;226;14;43;451
"2962";"360470924002";54;77;202;7;20;360
"2963";"360470924003";58;68;42;5;7;180
"2964";"360470928001";15;8;151;19;37;230
"2965";"360470928002";55;13;231;114;24;437
"2966";"360470930001";13;3;82;5;9;112
"2967";"360470930002";23;8;103;45;9;188
"2968";"360470932001";61;60;186;137;40;484
"2969";"360470934001";28;16;72;31;7;154
"2970";"360470934002";8;0;46;38;12;104
"2971";"360470936001";54;7;23;14;9;107
"2972";"360470936002";19;7;63;26;16;131
"2973";"360470938001";14;8;70;24;16;132
"2974";"360470938002";6;2;48;20;6;82
"2975";"360470944011";52;3;29;18;5;107
"2976";"360470944012";6;40;88;65;7;206
"2977";"360470944013";154;20;44;17;12;247
"2978";"360470944014";18;37;35;6;3;99
"2979";"360470944021";109;66;135;2;4;316
"2980";"360470946001";7;2;86;16;6;117
"2981";"360470946002";1;1;25;3;2;32
"2982";"360470946003";13;21;86;53;11;184
"2983";"360470950001";144;161;513;12;31;861
"2984";"360470950002";25;3;55;19;8;110
"2985";"360470954001";22;3;106;19;2;152
"2986";"360470954002";29;6;55;24;12;126
"2987";"360470954003";53;21;121;16;19;230
"2988";"360470956001";15;25;55;16;12;123
"2989";"360470956002";54;36;184;19;15;308
"2990";"360470958001";12;16;107;21;7;163
"2991";"360470958002";62;16;450;37;24;589
"2992";"360470960001";4;15;83;72;12;186
"2993";"360470962001";86;42;210;50;18;406
"2994";"360470964001";31;30;84;30;10;185
"2995";"360470964002";49;129;130;50;22;380
"2996";"360470966001";11;4;85;17;19;136
"2997";"360470966002";34;6;172;23;13;248
"2998";"360470968001";38;8;64;8;19;137
"2999";"360470968002";17;4;105;17;4;147
"3000";"360470970001";20;5;82;10;3;120
"3001";"360470970002";35;21;119;16;15;206
"3002";"360470974001";26;14;68;25;17;150
"3003";"360470974002";31;16;232;11;18;308
"3004";"360470982001";61;40;50;8;23;182
"3005";"360470982002";62;46;66;11;6;191
"3006";"360470984001";19;2;148;9;21;199
"3007";"360470986001";26;10;77;18;11;142
"3008";"360470986002";79;4;53;11;9;156
"3009";"360470988001";50;26;91;18;15;200
"3010";"360470988002";45;2;87;9;7;150
"3011";"360470990001";67;16;176;26;23;308
"3012";"360470992001";37;10;86;18;8;159
"3013";"360470994001";37;12;157;25;21;252
"3014";"360470996001";23;2;162;29;10;226
"3015";"360470996002";72;4;127;21;19;243
"3016";"360470998001";30;2;185;35;43;295
"3017";"360470998002";53;15;193;9;54;324
"3018";"360471004001";39;12;115;11;14;191
"3019";"360471006001";21;48;103;6;4;182
"3020";"360471006002";73;6;127;16;7;229
"3021";"360471008001";22;11;40;17;4;94
"3022";"360471008002";9;3;67;12;5;96
"3023";"360471010001";60;21;48;4;13;146
"3024";"360471010002";49;7;106;28;11;201
"3025";"360471012001";9;3;173;0;6;191
"3026";"360471012002";20;2;82;6;9;119
"3027";"360471014001";10;0;49;16;6;81
"3028";"360471014002";26;4;45;5;5;85
"3029";"360471016001";23;1;101;30;7;162
"3030";"360471018001";57;10;55;13;12;147
"3031";"360471020001";25;5;150;24;17;221
"3032";"360471022001";37;4;184;33;20;278
"3033";"360471024001";41;25;145;23;7;241
"3034";"360471026001";23;7;232;26;46;334
"3035";"360471028001";7;39;79;25;11;161
"3036";"360471028002";48;3;21;4;7;83
"3037";"360471034001";288;43;91;22;15;459
"3038";"360471058011";5;3;7;2;5;22
"3039";"360471058012";56;8;25;23;4;116
"3040";"360471058013";13;4;30;3;2;52
"3041";"360471058041";3;1;11;5;1;21
"3042";"360471058042";4;1;7;3;1;16
"3043";"360471058043";10;2;11;7;3;33
"3044";"360471058044";130;11;31;3;11;186
"3045";"360471070001";325;129;2532;87;43;3116
"3046";"360471078001";107;89;72;18;12;298
"3047";"360471078002";19;20;38;12;5;94
"3048";"360471078003";18;1;59;3;4;85
"3049";"360471078004";150;5;10;2;9;176
"3050";"360471098001";54;33;172;54;21;334
"3051";"360471098002";59;52;184;141;18;454
"3052";"360471104001";43;431;130;33;28;665
"3053";"360471104002";81;19;113;26;18;257
"3054";"360471104003";50;12;60;5;22;149
"3055";"360471104004";20;9;42;10;16;97
"3056";"360471106001";202;9;22;2;6;241
"3057";"360471106002";114;5;9;1;3;132
"3058";"360471110001";80;34;19;7;17;157
"3059";"360471110002";872;50;31;2;8;963
"3060";"360471116001";46;16;94;29;15;200
"3061";"360471116002";29;17;159;68;32;305
"3062";"360471118001";65;25;77;34;11;212
"3063";"360471118002";279;71;176;22;15;563
"3064";"360471120001";62;50;109;23;26;270
"3065";"360471120002";101;93;221;39;32;486
"3066";"360471122001";34;21;285;45;40;425
"3067";"360471122002";105;42;145;13;9;314
"3068";"360471124001";8;19;70;13;16;126
"3069";"360471124002";48;8;51;8;19;134
"3070";"360471124003";34;19;141;48;25;267
"3071";"360471126001";30;12;53;19;10;124
"3072";"360471126002";49;16;45;9;20;139
"3073";"360471126003";38;22;123;8;22;213
"3074";"360471128001";124;115;79;14;26;358
"3075";"360471128002";34;68;75;30;40;247
"3076";"360471128003";79;139;140;22;23;403
"3077";"360471130001";12;16;31;18;5;82
"3078";"360471130002";46;16;36;10;14;122
"3079";"360471130003";151;36;82;21;5;295
"3080";"360471130004";39;18;115;25;17;214
"3081";"360471132001";26;15;176;13;11;241
"3082";"360471132002";65;14;148;27;11;265
"3083";"360471134001";49;49;55;19;16;188
"3084";"360471134002";16;2;16;3;12;49
"3085";"360471134003";25;2;29;4;6;66
"3086";"360471142011";18;15;116;30;2;181
"3087";"360471142012";42;128;228;88;14;500
"3088";"360471142021";189;86;676;12;24;987
"3089";"360471142022";18;29;110;12;3;172
"3090";"360471144001";4;10;112;151;40;317
"3091";"360471144002";28;61;59;23;23;194
"3092";"360471144003";29;213;52;29;11;334
"3093";"360471144004";35;9;26;8;11;89
"3094";"360471146001";91;141;631;27;24;914
"3095";"360471146002";232;423;856;30;47;1588
"3096";"360471150001";37;14;136;37;28;252
"3097";"360471150002";68;13;112;21;17;231
"3098";"360471150003";24;8;164;28;17;241
"3099";"360471152001";72;31;127;51;29;310
"3100";"360471152002";81;11;101;17;15;225
"3101";"360471152003";23;9;50;12;21;115
"3102";"360471156001";35;57;348;1;8;449
"3103";"360471156002";146;32;27;4;22;231
"3104";"360471156003";171;90;19;8;11;299
"3105";"360471156004";85;409;72;15;23;604
"3106";"360471158001";36;31;78;28;6;179
"3107";"360471158002";93;151;109;9;11;373
"3108";"360471158003";56;25;47;4;17;149
"3109";"360471160001";10;22;30;13;1;76
"3110";"360471160002";58;26;28;21;23;156
"3111";"360471160003";34;22;189;22;18;285
"3112";"360471162001";12;5;26;9;11;63
"3113";"360471162002";10;1;44;8;6;69
"3114";"360471162003";7;7;87;15;5;121
"3115";"360471164001";21;46;68;17;15;167
"3116";"360471164002";14;8;158;8;11;199
"3117";"360471164003";36;15;95;19;19;184
"3118";"360471166001";33;8;126;24;10;201
"3119";"360471166002";39;22;163;35;14;273
"3120";"360471166003";71;14;168;40;34;327
"3121";"360471168001";106;38;169;52;41;406
"3122";"360471168002";121;117;222;45;35;540
"3123";"360471170001";21;22;60;21;26;150
"3124";"360471170002";41;29;177;32;37;316
"3125";"360471172011";46;12;273;20;12;363
"3126";"360471172012";43;83;108;17;36;287
"3127";"360471172021";157;50;139;14;20;380
"3128";"360471172022";133;28;395;52;46;654
"3129";"360471174001";116;127;295;43;42;623
"3130";"360471174002";134;225;216;53;78;706
"3131";"360471176011";83;80;957;42;26;1188
"3132";"360471176012";113;162;158;20;38;491
"3133";"360471176021";87;27;305;21;18;458
"3134";"360471176022";350;111;1233;23;70;1787
"3135";"360471178001";55;147;186;49;68;505
"3136";"360471180001";7;53;63;7;50;180
"3137";"360471182011";218;108;325;17;54;722
"3138";"360471182012";220;127;203;28;53;631
"3139";"360471182021";72;66;266;23;34;461
"3140";"360471182022";59;457;277;18;39;850
"3141";"360471184001";56;207;110;15;44;432
"3142";"360471184002";171;97;392;53;45;758
"3143";"360471184003";58;39;144;53;59;353
"3144";"360471186001";44;14;174;43;68;343
"3145";"360471186002";109;20;375;28;17;549
"3146";"360471188001";50;59;102;15;207;433
"3147";"360471188002";248;76;223;17;47;611
"3148";"360471188003";38;12;107;10;31;198
"3149";"360471190001";56;59;250;44;20;429
"3150";"360471190002";22;56;166;12;37;293
"3151";"360471192001";50;23;181;47;16;317
"3152";"360471192002";119;73;170;11;49;422
"3153";"360471192003";25;7;65;30;8;135
"3154";"360471194001";57;52;151;26;21;307
"3155";"360471194002";29;10;243;43;14;339
"3156";"360471194003";49;43;130;14;12;248
"3157";"360471196001";27;95;176;53;20;371
"3158";"360471196002";40;20;119;15;47;241
"3159";"360471196003";38;28;288;11;19;384
"3160";"360471196004";21;33;329;41;26;450
"3161";"360471198001";99;30;177;32;54;392
"3162";"360471198002";28;12;115;20;40;215
"3163";"360471198003";113;240;431;82;319;1185
"3164";"360471200001";5;3;47;15;11;81
"3165";"360471200002";10;12;152;19;13;206
"3166";"360471202001";35;49;77;8;17;186
"3167";"360471202002";98;24;99;6;34;261
"3168";"360471208001";33;16;293;15;23;380
"3169";"360471208002";62;35;680;49;36;862
"3170";"360471208003";36;24;7;2;3;72
"3171";"360471208004";18;0;0;1;8;27
"3172";"360471208005";33;9;151;56;20;269
"3173";"360471210001";68;88;4;0;104;264
"3174";"360471210002";52;7;4;0;4;67
"3175";"360471214001";27;10;16;1;2;56
"3176";"360471214002";22;33;8;0;5;68
"3177";"360471220001";200;58;315;73;35;681
"3178";"360471220002";472;165;320;95;46;1098
"3179";"360471237001";58;28;147;11;19;263
"3180";"360471237002";27;19;135;9;28;218
"3181";"360471237003";26;46;344;18;53;487
"3182";"360471502001";10;5;125;10;11;161
"3183";"360471502002";12;7;50;1;10;80
"3184";"360471502003";12;31;312;16;14;385
"3185";"360471522001";52;33;234;118;32;469
"3186";"360471522002";36;123;776;32;31;998
"3187";"360471522003";38;34;241;22;20;355
"3188";"360593005005";0;0;3;0;0;3
"3189";"360594043002";54;1;3;0;2;60
"3190";"360594043003";3;1;1;0;0;5
"3191";"360594103005";0;0;3;0;1;4
"3192";"360594113011";0;0;1;0;0;1
"3193";"360610001001";0;0;1;0;0;1
"3194";"360610002011";30;48;58;2;7;145
"3195";"360610002012";49;40;92;6;6;193
"3196";"360610002020";0;3;1;0;8;12
"3197";"360610002021";121;103;52;0;10;286
"3198";"360610002022";40;18;47;0;7;112
"3199";"360610002023";232;48;4;3;8;295
"3200";"360610002024";79;70;60;0;7;216
"3201";"360610002025";25;62;188;3;15;293
"3202";"360610005001";0;1;0;0;0;1
"3203";"360610006001";46;38;55;4;93;236
"3204";"360610006002";466;66;72;7;20;631
"3205";"360610006003";79;113;55;1;33;281
"3206";"360610006004";19;30;12;0;18;79
"3207";"360610006005";42;21;117;0;9;189
"3208";"360610006006";15;22;60;4;28;129
"3209";"360610007001";259;255;329;11;722;1576
"3210";"360610008001";47;85;113;0;45;290
"3211";"360610008002";186;53;29;1;16;285
"3212";"360610008003";20;16;39;10;29;114
"3213";"360610008004";8;8;0;0;8;24
"3214";"360610008005";13;68;12;4;22;119
"3215";"360610008006";93;210;246;8;241;798
"3216";"360610009001";67;117;424;3;285;896
"3217";"360610010011";50;4;16;13;34;117
"3218";"360610010021";49;14;9;2;18;92
"3219";"360610010022";3;29;7;2;4;45
"3220";"360610010023";243;13;56;4;9;325
"3221";"360610012001";54;40;243;2;25;364
"3222";"360610012002";1;22;41;15;21;100
"3223";"360610012003";45;14;27;17;3;106
"3224";"360610013001";16;66;234;1;199;516
"3225";"360610013002";77;80;488;4;335;984
"3226";"360610014011";8;44;98;0;25;175
"3227";"360610014012";4;33;43;0;3;83
"3228";"360610014021";156;140;234;2;139;671
"3229";"360610014022";110;173;474;3;53;813
"3230";"360610015010";0;0;1;0;2;3
"3231";"360610015011";85;168;465;2;141;861
"3232";"360610015012";30;47;282;2;34;395
"3233";"360610015013";46;97;144;0;83;370
"3234";"360610015021";130;171;503;2;525;1331
"3235";"360610015022";80;143;208;1;89;521
"3236";"360610016001";22;49;85;2;117;275
"3237";"360610016002";18;21;2;1;26;68
"3238";"360610016003";47;56;53;1;112;269
"3239";"360610016004";120;196;36;1;63;416
"3240";"360610016005";142;444;84;4;88;762
"3241";"360610018001";264;559;155;5;77;1060
"3242";"360610018002";88;523;73;3;370;1057
"3243";"360610018003";71;426;99;0;90;686
"3244";"360610018004";107;139;145;0;56;447
"3245";"360610018005";146;226;84;2;373;831
"3246";"360610018006";22;214;35;1;42;314
"3247";"360610018007";22;235;16;5;55;333
"3248";"360610020001";139;14;8;3;5;169
"3249";"360610020002";102;93;29;2;3;229
"3250";"360610020003";27;25;76;12;16;156
"3251";"360610021001";150;120;359;4;576;1209
"3252";"360610021002";32;73;105;2;213;425
"3253";"360610022011";302;117;87;2;59;567
"3254";"360610022012";163;153;124;3;45;488
"3255";"360610022013";265;44;14;1;27;351
"3256";"360610022014";129;21;32;1;16;199
"3257";"360610022021";250;335;121;5;44;755
"3258";"360610024001";298;230;76;4;25;633
"3259";"360610024002";41;81;13;5;11;151
"3260";"360610025001";102;69;75;0;28;274
"3261";"360610025002";124;24;85;0;18;251
"3262";"360610025003";73;10;16;0;13;112
"3263";"360610026011";236;644;326;6;28;1240
"3264";"360610026012";396;177;84;5;31;693
"3265";"360610026021";175;217;108;1;25;526
"3266";"360610026022";213;136;62;4;39;454
"3267";"360610027001";20;56;126;0;47;249
"3268";"360610028001";39;94;7;2;34;176
"3269";"360610028002";51;77;91;11;12;242
"3270";"360610028003";156;147;45;2;41;391
"3271";"360610028004";541;515;54;7;22;1139
"3272";"360610029001";26;60;126;0;38;250
"3273";"360610029002";37;52;17;2;25;133
"3274";"360610029003";28;257;59;1;36;381
"3275";"360610029004";2;19;149;7;99;276
"3276";"360610030011";77;821;338;3;98;1337
"3277";"360610030012";274;1641;80;1;78;2074
"3278";"360610030013";130;167;551;6;52;906
"3279";"360610030014";53;85;283;2;28;451
"3280";"360610030021";137;135;93;2;64;431
"3281";"360610030022";112;610;96;7;202;1027
"3282";"360610031001";109;200;1261;10;791;2371
"3283";"360610032001";368;679;119;3;88;1257
"3284";"360610032002";125;210;35;1;46;417
"3285";"360610032003";91;92;49;2;78;312
"3286";"360610032004";88;100;28;1;14;231
"3287";"360610032005";39;69;35;3;49;195
"3288";"360610032006";348;131;58;0;90;627
"3289";"360610032007";103;261;77;1;73;515
"3290";"360610033001";141;204;252;3;174;774
"3291";"360610033002";40;65;139;4;40;288
"3292";"360610033003";38;66;320;2;69;495
"3293";"360610034001";125;203;109;4;175;616
"3294";"360610034002";148;581;112;2;60;903
"3295";"360610034003";137;208;235;1;128;709
"3296";"360610034004";237;249;342;1;409;1238
"3297";"360610036011";18;102;79;2;19;220
"3298";"360610036012";41;73;110;6;41;271
"3299";"360610036013";39;133;203;2;43;420
"3300";"360610036021";203;178;63;4;182;630
"3301";"360610036022";43;74;73;5;31;226
"3302";"360610037001";52;106;277;3;62;500
"3303";"360610037002";43;84;111;4;110;352
"3304";"360610037003";17;66;354;2;136;575
"3305";"360610038001";107;290;79;1;134;611
"3306";"360610038002";106;13;21;0;13;153
"3307";"360610038003";118;89;55;0;31;293
"3308";"360610038004";97;109;17;2;15;240
"3309";"360610038005";116;90;31;0;38;275
"3310";"360610038006";46;34;7;1;16;104
"3311";"360610038007";136;151;50;1;35;373
"3312";"360610039001";70;73;167;4;66;380
"3313";"360610039002";10;33;36;0;10;89
"3314";"360610039003";0;5;16;1;9;31
"3315";"360610039004";24;96;229;0;33;382
"3316";"360610040001";164;131;57;2;61;415
"3317";"360610040002";44;11;30;3;11;99
"3318";"360610040003";33;40;36;2;35;146
"3319";"360610040004";139;67;20;0;21;247
"3320";"360610040005";103;40;43;1;40;227
"3321";"360610040006";589;56;116;5;108;874
"3322";"360610041001";45;73;40;0;37;195
"3323";"360610041002";29;36;32;1;32;130
"3324";"360610041003";41;38;35;0;48;162
"3325";"360610041004";123;310;41;0;42;516
"3326";"360610041005";8;53;114;1;22;198
"3327";"360610041006";76;171;39;1;42;329
"3328";"360610042001";112;96;116;0;44;368
"3329";"360610042002";145;142;44;1;46;378
"3330";"360610043001";122;240;133;6;59;560
"3331";"360610043002";30;53;44;2;17;146
"3332";"360610043003";129;460;233;3;127;952
"3333";"360610044000";0;1;0;0;0;1
"3334";"360610044001";13;6;20;0;10;49
"3335";"360610044002";72;5;39;4;1;121
"3336";"360610044003";8;1;29;2;3;43
"3337";"360610044004";14;8;7;0;6;35
"3338";"360610044005";4;19;9;3;8;43
"3339";"360610044006";6;5;8;0;5;24
"3340";"360610044007";45;20;29;5;95;194
"3341";"360610044008";49;5;7;0;25;86
"3342";"360610045001";185;216;96;0;431;928
"3343";"360610047001";48;49;66;3;23;189
"3344";"360610047002";155;413;68;3;106;745
"3345";"360610048001";29;18;42;2;17;108
"3346";"360610048002";19;10;20;0;27;76
"3347";"360610048003";34;17;28;1;23;103
"3348";"360610048004";33;117;43;0;106;299
"3349";"360610048005";108;28;48;0;35;219
"3350";"360610048006";57;6;65;2;7;137
"3351";"360610048007";3;7;8;1;22;41
"3352";"360610049001";108;263;236;1;88;696
"3353";"360610049002";107;142;95;0;69;413
"3354";"360610049003";104;236;134;2;21;497
"3355";"360610050001";10;84;38;0;24;156
"3356";"360610050002";30;50;46;1;42;169
"3357";"360610050003";27;149;78;2;46;302
"3358";"360610050004";7;59;31;0;54;151
"3359";"360610050005";36;24;23;0;15;98
"3360";"360610052001";26;610;72;2;374;1084
"3361";"360610052002";61;299;100;1;85;546
"3362";"360610054001";69;275;144;6;123;617
"3363";"360610054002";24;9;16;0;11;60
"3364";"360610054003";13;15;20;0;13;61
"3365";"360610055011";9;52;62;0;47;170
"3366";"360610055012";7;14;86;0;4;111
"3367";"360610055013";3;15;6;0;6;30
"3368";"360610055021";11;31;35;1;22;100
"3369";"360610055022";74;239;93;3;352;761
"3370";"360610056001";125;115;116;4;173;533
"3371";"360610056002";19;94;34;1;240;388
"3372";"360610056003";14;19;19;0;14;66
"3373";"360610057001";7;67;29;1;144;248
"3374";"360610057002";16;81;94;1;62;254
"3375";"360610058001";67;360;243;12;323;1005
"3376";"360610059001";4;12;23;0;14;53
"3377";"360610059002";13;215;31;0;74;333
"3378";"360610059003";31;68;46;0;56;201
"3379";"360610059004";73;13;17;0;12;115
"3380";"360610059005";7;19;8;0;17;51
"3381";"360610060001";1;6;58;0;7;72
"3382";"360610060002";49;19;12;0;47;127
"3383";"360610060003";11;0;3;0;3;17
"3384";"360610061001";82;154;125;1;50;412
"3385";"360610061002";40;103;67;0;35;245
"3386";"360610061003";40;224;206;0;83;553
"3387";"360610062001";0;25;235;7;69;336
"3388";"360610062002";4;7;54;0;9;74
"3389";"360610063001";66;59;103;3;61;292
"3390";"360610063002";35;21;23;2;42;123
"3391";"360610063003";14;31;53;0;29;127
"3392";"360610063004";47;108;39;1;74;269
"3393";"360610063005";41;344;72;1;164;622
"3394";"360610064001";23;54;44;2;46;169
"3395";"360610064002";209;13;250;0;15;487
"3396";"360610064003";30;13;56;5;8;112
"3397";"360610064004";47;47;70;0;26;190
"3398";"360610064005";14;3;33;0;17;67
"3399";"360610064006";11;13;14;1;89;128
"3400";"360610065001";87;371;107;1;184;750
"3401";"360610065002";104;447;180;3;143;877
"3402";"360610065003";64;280;73;2;42;461
"3403";"360610065004";94;158;27;2;51;332
"3404";"360610065005";57;162;61;1;45;326
"3405";"360610066001";84;123;28;0;68;303
"3406";"360610066002";93;141;13;1;34;282
"3407";"360610066003";378;115;37;0;31;561
"3408";"360610066004";38;21;21;1;11;92
"3409";"360610066005";36;32;30;0;24;122
"3410";"360610066006";4;18;28;1;16;67
"3411";"360610066007";26;8;9;0;15;58
"3412";"360610066008";94;98;70;5;31;298
"3413";"360610066009";25;90;22;0;20;157
"3414";"360610067001";52;225;39;5;80;401
"3415";"360610067002";70;149;54;2;70;345
"3416";"360610067003";69;127;119;0;48;363
"3417";"360610067004";46;81;31;0;56;214
"3418";"360610068001";36;49;73;1;40;199
"3419";"360610068002";12;43;37;0;31;123
"3420";"360610068003";27;88;25;0;18;158
"3421";"360610068004";97;32;14;1;17;161
"3422";"360610068005";23;67;19;0;32;141
"3423";"360610068006";109;91;17;2;35;254
"3424";"360610069001";67;107;106;6;47;333
"3425";"360610070001";41;16;18;4;54;133
"3426";"360610070002";76;44;24;1;62;207
"3427";"360610070003";54;58;63;3;58;236
"3428";"360610070004";5;18;17;0;15;55
"3429";"360610070005";2;1;31;2;14;50
"3430";"360610070006";40;7;87;3;23;160
"3431";"360610071001";22;54;16;1;73;166
"3432";"360610071002";16;7;64;0;26;113
"3433";"360610071003";65;107;82;1;55;310
"3434";"360610071004";80;59;24;0;16;179
"3435";"360610071005";34;205;39;1;561;840
"3436";"360610072001";21;7;7;1;7;43
"3437";"360610072002";51;20;36;0;142;249
"3438";"360610072003";69;121;39;4;28;261
"3439";"360610072004";80;88;32;2;41;243
"3440";"360610072005";16;32;16;1;149;214
"3441";"360610072006";30;15;8;1;33;87
"3442";"360610072007";14;17;13;0;23;67
"3443";"360610073001";61;58;22;1;17;159
"3444";"360610073002";30;34;16;0;12;92
"3445";"360610073003";114;78;30;1;26;249
"3446";"360610073004";89;321;51;0;256;717
"3447";"360610073005";64;13;3;0;8;88
"3448";"360610073006";60;146;32;1;47;286
"3449";"360610074001";19;94;57;3;61;234
"3450";"360610074002";30;43;36;3;32;144
"3451";"360610074003";52;214;267;11;92;636
"3452";"360610075000";0;1;0;0;0;1
"3453";"360610075001";28;32;61;0;28;149
"3454";"360610075002";25;136;27;0;7;195
"3455";"360610075003";93;164;32;2;12;303
"3456";"360610076001";239;119;375;2;84;819
"3457";"360610076002";18;97;202;3;84;404
"3458";"360610077001";163;90;43;0;60;356
"3459";"360610077002";31;91;18;1;14;155
"3460";"360610077003";46;101;52;4;81;284
"3461";"360610077004";34;75;25;0;30;164
"3462";"360610077005";50;11;30;2;13;106
"3463";"360610078001";18;24;186;2;15;245
"3464";"360610078002";42;60;145;1;33;281
"3465";"360610078003";8;7;1;0;9;25
"3466";"360610078004";45;21;14;2;32;114
"3467";"360610078005";16;6;71;0;33;126
"3468";"360610078006";31;121;62;3;10;227
"3469";"360610078007";17;22;89;4;16;148
"3470";"360610079001";23;111;126;5;53;318
"3471";"360610079002";25;10;17;2;11;65
"3472";"360610079003";49;101;42;0;35;227
"3473";"360610079004";29;22;54;1;20;126
"3474";"360610080001";81;33;57;5;85;261
"3475";"360610080002";18;20;63;2;77;180
"3476";"360610080003";9;5;11;1;9;35
"3477";"360610080004";38;18;43;0;23;122
"3478";"360610080005";23;12;7;0;27;69
"3479";"360610081001";37;62;30;1;115;245
"3480";"360610081002";27;24;58;0;29;138
"3481";"360610081003";28;25;34;0;39;126
"3482";"360610081004";17;52;28;3;263;363
"3483";"360610081005";67;87;22;1;19;196
"3484";"360610081006";75;36;47;0;44;202
"3485";"360610082001";28;69;166;2;107;372
"3486";"360610082002";16;27;43;1;65;152
"3487";"360610082003";12;13;9;0;133;167
"3488";"360610083001";82;279;88;2;43;494
"3489";"360610083002";11;35;84;2;282;414
"3490";"360610083003";296;159;142;2;17;616
"3491";"360610084001";0;29;25;0;238;292
"3492";"360610084002";76;126;168;2;147;519
"3493";"360610086010";0;1;1;0;0;2
"3494";"360610086011";5;11;48;2;45;111
"3495";"360610086012";40;16;67;0;63;186
"3496";"360610086021";0;25;28;0;11;64
"3497";"360610086031";11;19;8;2;12;52
"3498";"360610086032";4;8;28;4;18;62
"3499";"360610086033";18;4;12;1;6;41
"3500";"360610086034";45;10;64;0;14;133
"3501";"360610087001";146;110;211;2;44;513
"3502";"360610087002";49;70;70;2;16;207
"3503";"360610087003";27;15;14;3;25;84
"3504";"360610087004";38;66;21;0;27;152
"3505";"360610087005";38;39;15;1;24;117
"3506";"360610088001";25;29;70;3;72;199
"3507";"360610088002";68;8;84;1;157;318
"3508";"360610088003";5;3;61;1;10;80
"3509";"360610088004";20;8;41;10;6;85
"3510";"360610088005";7;34;40;0;12;93
"3511";"360610088006";14;7;28;7;17;73
"3512";"360610088007";1;0;24;0;6;31
"3513";"360610089001";96;175;32;2;72;377
"3514";"360610089002";79;49;40;1;33;202
"3515";"360610089003";149;67;23;5;32;276
"3516";"360610089004";25;24;42;0;14;105
"3517";"360610089005";50;74;11;0;31;166
"3518";"360610090001";35;28;101;0;51;215
"3519";"360610090002";68;4;21;0;8;101
"3520";"360610090003";15;16;29;0;18;78
"3521";"360610090004";45;65;57;0;8;175
"3522";"360610090005";12;53;37;0;26;128
"3523";"360610090006";74;49;13;4;11;151
"3524";"360610091001";45;173;112;8;256;594
"3525";"360610091002";48;56;35;0;57;196
"3526";"360610091003";49;17;11;1;24;102
"3527";"360610091004";27;64;22;1;47;161
"3528";"360610092001";34;101;146;3;869;1153
"3529";"360610093001";19;37;19;0;18;93
"3530";"360610093002";73;44;571;0;650;1338
"3531";"360610093003";3;15;35;0;15;68
"3532";"360610093004";5;10;11;0;4;30
"3533";"360610093005";76;60;15;3;5;159
"3534";"360610093006";114;71;18;3;12;218
"3535";"360610093007";92;14;8;2;12;128
"3536";"360610094001";11;41;119;2;93;266
"3537";"360610095001";78;145;124;2;328;677
"3538";"360610095002";73;40;63;0;55;231
"3539";"360610096001";13;87;235;0;179;514
"3540";"360610097001";13;15;37;0;13;78
"3541";"360610097002";118;46;31;2;38;235
"3542";"360610097003";11;1;4;0;0;16
"3543";"360610097004";691;91;17;0;31;830
"3544";"360610098001";8;105;181;0;20;314
"3545";"360610098002";66;51;276;1;52;446
"3546";"360610098003";33;36;29;1;20;119
"3547";"360610098004";24;21;35;2;19;101
"3548";"360610098005";46;110;25;0;39;220
"3549";"360610098006";63;38;229;1;38;369
"3550";"360610098007";56;16;35;3;12;122
"3551";"360610099001";258;361;1016;24;285;1944
"3552";"360610100001";5;32;598;0;54;689
"3553";"360610100002";24;82;207;8;186;507
"3554";"360610101001";45;182;345;7;584;1163
"3555";"360610102001";5;52;234;6;300;597
"3556";"360610103001";83;55;151;3;165;457
"3557";"360610104001";26;307;577;1;234;1145
"3558";"360610106011";2;3;19;0;7;31
"3559";"360610106012";8;22;30;5;10;75
"3560";"360610106013";18;5;25;0;5;53
"3561";"360610106014";3;4;8;0;3;18
"3562";"360610106015";4;4;9;0;11;28
"3563";"360610106016";0;4;22;0;13;39
"3564";"360610106020";0;0;2;1;22;25
"3565";"360610106021";29;66;9;0;10;114
"3566";"360610106022";10;46;104;2;53;215
"3567";"360610106023";1;1;18;0;10;30
"3568";"360610108001";19;5;26;1;10;61
"3569";"360610108002";18;13;8;0;6;45
"3570";"360610108003";6;57;26;0;12;101
"3571";"360610108004";2;5;9;0;4;20
"3572";"360610108005";40;16;15;1;9;81
"3573";"360610108006";18;22;13;0;40;93
"3574";"360610108007";43;23;47;0;52;165
"3575";"360610109001";27;253;239;0;442;961
"3576";"360610110001";16;18;11;0;54;99
"3577";"360610110002";6;8;50;3;6;73
"3578";"360610110003";52;23;96;1;34;206
"3579";"360610110004";5;15;24;1;17;62
"3580";"360610110005";7;13;41;2;8;71
"3581";"360610110006";36;20;282;6;52;396
"3582";"360610111001";70;151;424;2;265;912
"3583";"360610111002";41;69;67;8;55;240
"3584";"360610111003";67;41;187;2;70;367
"3585";"360610112011";13;66;110;0;113;302
"3586";"360610112021";2;18;128;6;28;182
"3587";"360610112031";11;18;63;0;33;125
"3588";"360610112032";9;5;38;1;19;72
"3589";"360610113001";10;138;405;4;1280;1837
"3590";"360610114011";12;10;112;2;67;203
"3591";"360610114012";5;16;66;0;30;117
"3592";"360610114021";8;23;78;1;146;256
"3593";"360610114022";54;31;63;1;62;211
"3594";"360610115001";55;153;131;3;122;464
"3595";"360610115002";43;105;55;3;312;518
"3596";"360610116001";14;27;220;5;43;309
"3597";"360610116002";23;25;49;0;15;112
"3598";"360610116003";13;13;1;0;10;37
"3599";"360610117001";121;129;125;3;62;440
"3600";"360610118001";21;14;7;0;1;43
"3601";"360610118002";2;3;26;1;12;44
"3602";"360610118003";7;10;28;0;4;49
"3603";"360610118004";46;61;100;0;27;234
"3604";"360610118005";71;6;22;1;21;121
"3605";"360610118006";31;4;69;0;48;152
"3606";"360610118007";9;12;64;0;19;104
"3607";"360610118008";3;6;21;0;41;71
"3608";"360610119001";24;169;162;5;543;903
"3609";"360610119002";80;66;90;3;588;827
"3610";"360610120001";5;19;51;0;20;95
"3611";"360610120002";4;5;30;2;169;210
"3612";"360610120003";18;30;53;3;14;118
"3613";"360610120004";9;21;74;1;82;187
"3614";"360610121001";113;122;39;0;96;370
"3615";"360610121002";23;21;9;0;14;67
"3616";"360610121003";92;60;19;0;43;214
"3617";"360610121004";68;166;78;1;115;428
"3618";"360610121005";44;114;25;2;98;283
"3619";"360610121006";61;109;55;0;89;314
"3620";"360610122001";3;30;44;0;25;102
"3621";"360610122002";4;4;14;2;13;37
"3622";"360610122003";3;7;22;0;8;40
"3623";"360610122004";4;39;41;0;29;113
"3624";"360610124001";223;55;30;1;28;337
"3625";"360610124002";29;13;26;0;15;83
"3626";"360610124003";6;6;19;1;11;43
"3627";"360610124004";58;24;25;0;10;117
"3628";"360610124005";17;20;18;1;3;59
"3629";"360610124006";8;7;16;0;3;34
"3630";"360610124007";4;14;74;0;3;95
"3631";"360610124008";2;4;50;0;3;59
"3632";"360610125001";15;128;280;9;899;1331
"3633";"360610125002";43;250;189;6;321;809
"3634";"360610126001";59;136;225;4;29;453
"3635";"360610126002";7;64;26;1;122;220
"3636";"360610126003";19;5;47;2;4;77
"3637";"360610126004";29;13;66;0;15;123
"3638";"360610126005";9;19;46;0;86;160
"3639";"360610126006";43;30;58;1;23;155
"3640";"360610126007";29;17;38;0;8;92
"3641";"360610126008";26;18;51;4;39;138
"3642";"360610127001";122;266;54;2;68;512
"3643";"360610127002";160;340;96;4;151;751
"3644";"360610127003";208;81;41;1;48;379
"3645";"360610127004";92;318;100;2;53;565
"3646";"360610127005";10;124;111;2;75;322
"3647";"360610128001";8;25;96;2;19;150
"3648";"360610128002";6;12;44;1;22;85
"3649";"360610128003";4;2;31;0;35;72
"3650";"360610128004";5;13;58;2;62;140
"3651";"360610128005";7;12;56;1;16;92
"3652";"360610129001";99;181;504;36;126;946
"3653";"360610129002";313;134;420;26;111;1004
"3654";"360610130001";7;6;60;1;4;78
"3655";"360610130002";7;10;57;5;31;110
"3656";"360610130003";15;12;56;0;13;96
"3657";"360610130004";8;8;66;0;21;103
"3658";"360610131001";21;858;276;1;586;1742
"3659";"360610131002";31;712;212;6;487;1448
"3660";"360610132001";33;8;22;0;11;74
"3661";"360610132002";57;68;33;3;20;181
"3662";"360610132003";27;41;39;0;8;115
"3663";"360610132004";63;67;48;7;38;223
"3664";"360610132005";70;10;35;1;12;128
"3665";"360610132006";11;29;77;0;23;140
"3666";"360610132007";55;11;31;0;8;105
"3667";"360610133001";37;22;10;0;124;193
"3668";"360610133002";152;119;68;2;39;380
"3669";"360610133003";124;203;83;2;61;473
"3670";"360610133004";47;88;34;0;69;238
"3671";"360610133005";28;51;93;2;320;494
"3672";"360610134001";19;11;21;2;9;62
"3673";"360610134002";32;33;18;4;16;103
"3674";"360610134003";15;19;11;2;8;55
"3675";"360610134004";22;77;15;0;13;127
"3676";"360610134005";36;115;26;0;21;198
"3677";"360610134006";14;37;47;0;22;120
"3678";"360610134007";35;119;52;0;22;228
"3679";"360610134008";13;13;50;0;12;88
"3680";"360610134009";98;60;31;0;8;197
"3681";"360610135001";82;119;284;19;85;589
"3682";"360610135002";80;208;404;24;132;848
"3683";"360610136001";61;35;30;0;12;138
"3684";"360610136002";16;11;26;0;6;59
"3685";"360610136003";26;13;69;1;24;133
"3686";"360610136004";18;28;42;3;11;102
"3687";"360610136005";5;17;20;3;73;118
"3688";"360610136006";11;4;16;1;2;34
"3689";"360610136007";44;3;18;1;8;74
"3690";"360610136008";73;25;41;0;10;149
"3691";"360610137001";4;13;47;0;13;77
"3692";"360610137002";9;54;49;0;42;154
"3693";"360610137003";10;78;312;6;432;838
"3694";"360610137004";16;182;1582;3;69;1852
"3695";"360610137005";80;54;127;0;146;407
"3696";"360610137006";58;96;71;0;245;470
"3697";"360610138001";35;16;31;1;14;97
"3698";"360610138002";94;26;14;3;14;151
"3699";"360610138003";21;11;45;11;11;99
"3700";"360610138004";71;114;50;0;28;263
"3701";"360610138005";44;10;34;0;6;94
"3702";"360610138006";36;64;28;0;53;181
"3703";"360610138007";60;4;71;0;6;141
"3704";"360610138008";3;8;27;0;6;44
"3705";"360610138009";23;30;7;0;11;71
"3706";"360610139001";35;45;19;0;28;127
"3707";"360610139002";270;350;28;0;89;737
"3708";"360610139003";95;87;183;14;59;438
"3709";"360610139004";88;54;332;0;110;584
"3710";"360610139005";20;28;109;2;23;182
"3711";"360610139006";19;24;52;0;36;131
"3712";"360610139007";21;86;41;0;59;207
"3713";"360610140001";6;14;29;0;6;55
"3714";"360610140002";34;23;15;3;13;88
"3715";"360610140003";6;11;47;0;21;85
"3716";"360610140004";4;5;185;3;31;228
"3717";"360610140005";61;47;43;1;17;169
"3718";"360610140006";20;4;12;0;9;45
"3719";"360610142001";6;2;58;3;7;76
"3720";"360610142002";4;22;50;0;22;98
"3721";"360610142003";4;2;15;0;1;22
"3722";"360610142004";7;9;32;2;17;67
"3723";"360610142005";6;14;39;1;7;67
"3724";"360610142006";0;10;42;0;8;60
"3725";"360610143001";36;1646;359;15;1177;3233
"3726";"360610144011";27;11;18;0;1;57
"3727";"360610144012";27;7;42;4;14;94
"3728";"360610144013";23;19;11;0;4;57
"3729";"360610144014";22;9;12;7;7;57
"3730";"360610144021";28;6;71;0;22;127
"3731";"360610144022";68;39;13;0;13;133
"3732";"360610144023";42;9;21;2;4;78
"3733";"360610144024";124;33;120;2;34;313
"3734";"360610144025";37;38;28;0;10;113
"3735";"360610145001";17;36;229;3;25;310
"3736";"360610145002";9;4;30;0;22;65
"3737";"360610145003";12;82;219;0;474;787
"3738";"360610145004";5;47;106;2;52;212
"3739";"360610146011";29;117;40;2;259;447
"3740";"360610146012";39;126;17;1;14;197
"3741";"360610146013";27;128;37;1;18;211
"3742";"360610146014";49;205;19;3;22;298
"3743";"360610146021";6;28;30;0;9;73
"3744";"360610146022";15;23;32;0;11;81
"3745";"360610146023";66;82;59;0;9;216
"3746";"360610146024";32;26;26;0;11;95
"3747";"360610146025";19;23;13;0;19;74
"3748";"360610146026";43;74;24;0;81;222
"3749";"360610147001";19;35;105;4;18;181
"3750";"360610148011";10;45;44;0;20;119
"3751";"360610148012";15;25;42;0;106;188
"3752";"360610148021";42;54;33;3;38;170
"3753";"360610148022";65;59;52;0;46;222
"3754";"360610148023";8;11;26;0;11;56
"3755";"360610148024";12;36;30;0;15;93
"3756";"360610148025";1;7;45;0;7;60
"3757";"360610149001";3;58;145;2;251;459
"3758";"360610149002";11;26;114;0;71;222
"3759";"360610149003";27;25;47;1;83;183
"3760";"360610149004";8;16;72;1;114;211
"3761";"360610149005";0;3;18;0;28;49
"3762";"360610150011";20;4;55;1;9;89
"3763";"360610150012";6;15;53;0;23;97
"3764";"360610150021";13;7;63;0;6;89
"3765";"360610150022";2;5;17;0;1;25
"3766";"360610150023";2;5;81;0;5;93
"3767";"360610150024";6;23;48;0;17;94
"3768";"360610151001";40;30;15;0;9;94
"3769";"360610151002";178;24;96;2;7;307
"3770";"360610151003";33;9;169;2;7;220
"3771";"360610151004";147;89;620;18;51;925
"3772";"360610152000";0;0;2;0;0;2
"3773";"360610152001";158;16;17;0;7;198
"3774";"360610152002";139;34;26;0;9;208
"3775";"360610152003";0;12;24;0;6;42
"3776";"360610152004";16;12;16;0;8;52
"3777";"360610152005";6;13;19;0;10;48
"3778";"360610152006";8;34;45;3;10;100
"3779";"360610153001";28;23;24;1;80;156
"3780";"360610153002";23;34;45;4;72;178
"3781";"360610153003";8;24;71;0;143;246
"3782";"360610153004";2;9;46;2;87;146
"3783";"360610153005";68;18;25;1;4;116
"3784";"360610153006";28;5;30;0;26;89
"3785";"360610153007";23;102;172;2;18;317
"3786";"360610154001";46;148;83;3;18;298
"3787";"360610154002";9;26;8;0;6;49
"3788";"360610154003";42;22;35;3;18;120
"3789";"360610154004";8;9;51;3;23;94
"3790";"360610154005";134;19;25;10;104;292
"3791";"360610154006";78;15;19;2;28;142
"3792";"360610154007";4;29;22;0;27;82
"3793";"360610154008";24;10;10;0;10;54
"3794";"360610154009";32;14;12;1;16;75
"3795";"360610155001";5;3;15;1;4;28
"3796";"360610155002";16;19;17;1;6;59
"3797";"360610155003";3;6;4;0;2;15
"3798";"360610155004";1;4;14;0;2;21
"3799";"360610155005";5;4;11;0;6;26
"3800";"360610155006";19;38;43;1;16;117
"3801";"360610156011";16;27;57;5;27;132
"3802";"360610156012";16;27;31;6;50;130
"3803";"360610156013";22;24;21;1;16;84
"3804";"360610156014";111;1241;11;0;148;1511
"3805";"360610156021";68;159;95;6;143;471
"3806";"360610157001";28;29;58;2;14;131
"3807";"360610157002";9;22;110;0;20;161
"3808";"360610157003";8;33;63;0;29;133
"3809";"360610157004";5;46;33;1;14;99
"3810";"360610157005";45;30;57;0;11;143
"3811";"360610157006";32;148;32;4;71;287
"3812";"360610157007";19;52;20;1;73;165
"3813";"360610157008";44;25;39;4;25;137
"3814";"360610158011";12;30;67;0;26;135
"3815";"360610158012";37;30;36;0;42;145
"3816";"360610158013";13;30;43;0;11;97
"3817";"360610158014";6;15;18;0;79;118
"3818";"360610158021";23;20;30;4;32;109
"3819";"360610158022";74;49;48;1;9;181
"3820";"360610159001";15;5;43;0;11;74
"3821";"360610159002";11;5;67;1;6;90
"3822";"360610159003";61;11;73;0;12;157
"3823";"360610159004";19;28;17;0;17;81
"3824";"360610159005";42;132;20;0;71;265
"3825";"360610159006";42;40;16;2;103;203
"3826";"360610159007";23;62;30;0;42;157
"3827";"360610160011";5;10;62;0;7;84
"3828";"360610160012";25;8;25;0;2;60
"3829";"360610160013";4;10;56;0;8;78
"3830";"360610160014";22;7;22;0;4;55
"3831";"360610160021";3;3;18;1;8;33
"3832";"360610160022";7;20;20;0;6;53
"3833";"360610161001";27;44;90;1;18;180
"3834";"360610161002";13;21;112;0;15;161
"3835";"360610161003";31;32;118;0;34;215
"3836";"360610161004";45;8;161;0;10;224
"3837";"360610161005";19;28;41;0;16;104
"3838";"360610161006";76;55;33;2;22;188
"3839";"360610162000";3;1;0;1;0;5
"3840";"360610162001";10;23;12;15;15;75
"3841";"360610162002";5;54;12;0;2;73
"3842";"360610162003";46;15;23;20;6;110
"3843";"360610162004";171;91;25;2;30;319
"3844";"360610162005";83;55;38;4;18;198
"3845";"360610163001";31;16;32;7;3;89
"3846";"360610163002";27;17;77;0;10;131
"3847";"360610163003";12;26;47;0;19;104
"3848";"360610163004";33;43;40;1;42;159
"3849";"360610163005";18;44;51;1;24;138
"3850";"360610164001";58;50;21;0;16;145
"3851";"360610164002";80;103;88;11;19;301
"3852";"360610164003";141;46;28;5;2;222
"3853";"360610164004";57;32;16;3;92;200
"3854";"360610165001";13;36;219;1;35;304
"3855";"360610165002";10;15;49;1;6;81
"3856";"360610165003";35;30;29;0;13;107
"3857";"360610165004";32;22;89;7;13;163
"3858";"360610165005";22;53;117;1;4;197
"3859";"360610166001";74;74;15;1;40;204
"3860";"360610166002";19;109;34;2;9;173
"3861";"360610166003";36;41;46;12;14;149
"3862";"360610166004";85;71;86;3;13;258
"3863";"360610166005";34;68;24;2;18;146
"3864";"360610166006";531;88;66;5;4;694
"3865";"360610167001";20;30;18;0;16;84
"3866";"360610167002";5;4;17;0;3;29
"3867";"360610167003";38;67;49;0;148;302
"3868";"360610167004";37;120;16;0;102;275
"3869";"360610167005";13;63;28;1;51;156
"3870";"360610168001";141;39;32;3;52;267
"3871";"360610168002";106;32;119;5;8;270
"3872";"360610168003";5;156;53;8;28;250
"3873";"360610169001";43;32;74;0;32;181
"3874";"360610169002";32;163;83;0;9;287
"3875";"360610169003";20;120;74;1;41;256
"3876";"360610169004";69;74;294;2;11;450
"3877";"360610169005";87;57;63;0;6;213
"3878";"360610169006";35;8;72;3;10;128
"3879";"360610170001";58;15;71;1;37;182
"3880";"360610170002";100;41;48;7;42;238
"3881";"360610170003";144;103;140;5;31;423
"3882";"360610170004";17;75;39;5;24;160
"3883";"360610170005";49;128;128;2;17;324
"3884";"360610171001";23;46;40;0;26;135
"3885";"360610171002";37;101;27;0;168;333
"3886";"360610171003";34;20;15;0;38;107
"3887";"360610171004";6;14;41;0;2;63
"3888";"360610171005";21;11;23;0;11;66
"3889";"360610171006";11;13;21;0;1;46
"3890";"360610172001";82;121;79;4;102;388
"3891";"360610172002";74;7;32;1;4;118
"3892";"360610172003";293;28;85;11;25;442
"3893";"360610172004";75;104;37;4;39;259
"3894";"360610172005";53;21;64;7;20;165
"3895";"360610173001";32;19;7;1;15;74
"3896";"360610173002";14;11;33;1;4;63
"3897";"360610173003";213;55;80;4;10;362
"3898";"360610173004";33;27;69;0;4;133
"3899";"360610173005";7;4;77;1;4;93
"3900";"360610173006";64;72;85;0;18;239
"3901";"360610173007";30;14;151;1;61;257
"3902";"360610174011";210;60;42;3;14;329
"3903";"360610174012";46;31;20;7;0;104
"3904";"360610174013";93;196;46;4;15;354
"3905";"360610174021";149;66;87;4;29;335
"3906";"360610175001";47;28;79;1;25;180
"3907";"360610175002";11;14;18;2;9;54
"3908";"360610175003";84;18;22;0;7;131
"3909";"360610175004";5;12;48;1;32;98
"3910";"360610175005";1;8;9;3;5;26
"3911";"360610175006";21;70;27;0;9;127
"3912";"360610175007";17;85;21;3;64;190
"3913";"360610177001";7;25;23;4;10;69
"3914";"360610177002";82;43;28;1;19;173
"3915";"360610177003";29;58;105;1;16;209
"3916";"360610177004";320;48;83;3;6;460
"3917";"360610177005";16;51;243;3;29;342
"3918";"360610177006";41;14;189;0;8;252
"3919";"360610177007";56;17;81;6;8;168
"3920";"360610177008";23;39;142;4;5;213
"3921";"360610178001";49;90;73;18;24;254
"3922";"360610178002";199;128;46;9;27;409
"3923";"360610178003";165;364;131;9;55;724
"3924";"360610179001";55;95;58;4;21;233
"3925";"360610179002";2;5;20;1;1;29
"3926";"360610179003";12;8;13;0;5;38
"3927";"360610179004";40;40;15;1;16;112
"3928";"360610179005";15;5;7;0;8;35
"3929";"360610179006";270;295;36;1;59;661
"3930";"360610179007";38;15;63;0;11;127
"3931";"360610180001";404;436;43;15;83;981
"3932";"360610180002";78;110;198;7;32;425
"3933";"360610180003";142;139;120;8;32;441
"3934";"360610180004";38;130;7;25;5;205
"3935";"360610181001";11;58;43;20;10;142
"3936";"360610181002";21;28;34;5;9;97
"3937";"360610181003";25;28;12;1;10;76
"3938";"360610181004";16;14;76;3;16;125
"3939";"360610181005";17;10;23;1;9;60
"3940";"360610181006";9;11;16;5;8;49
"3941";"360610182001";107;150;12;13;34;316
"3942";"360610182002";220;106;86;5;19;436
"3943";"360610182003";179;152;66;3;221;621
"3944";"360610182004";36;25;21;2;8;92
"3945";"360610182005";186;116;13;3;23;341
"3946";"360610183001";48;48;61;5;91;253
"3947";"360610183002";8;5;11;1;1;26
"3948";"360610183003";184;162;11;1;11;369
"3949";"360610183004";4;18;113;0;40;175
"3950";"360610183005";6;21;36;0;155;218
"3951";"360610183006";34;66;33;0;42;175
"3952";"360610183007";38;135;46;1;63;283
"3953";"360610184001";166;202;440;15;85;908
"3954";"360610184002";81;45;49;6;11;192
"3955";"360610184003";74;22;72;4;5;177
"3956";"360610184004";401;10;9;0;9;429
"3957";"360610185001";8;14;15;3;9;49
"3958";"360610185002";42;62;101;0;16;221
"3959";"360610185003";22;43;10;0;3;78
"3960";"360610186001";535;69;21;17;157;799
"3961";"360610186002";108;221;42;1;60;432
"3962";"360610186003";127;124;22;6;20;299
"3963";"360610187001";51;110;39;3;177;380
"3964";"360610187002";26;17;44;0;8;95
"3965";"360610187003";20;17;28;0;9;74
"3966";"360610187004";16;77;18;0;25;136
"3967";"360610187005";44;53;12;4;27;140
"3968";"360610187006";130;51;18;1;13;213
"3969";"360610188001";205;84;98;9;29;425
"3970";"360610188002";224;407;99;5;46;781
"3971";"360610188003";102;102;59;3;26;292
"3972";"360610188004";135;77;44;11;20;287
"3973";"360610189001";78;196;30;6;19;329
"3974";"360610189002";418;109;51;20;58;656
"3975";"360610189003";580;295;93;1;10;979
"3976";"360610189004";70;300;58;2;17;447
"3977";"360610189005";95;100;153;5;38;391
"3978";"360610189006";534;73;36;5;26;674
"3979";"360610190001";315;216;190;26;44;791
"3980";"360610191001";51;24;28;1;8;112
"3981";"360610191002";8;8;72;0;14;102
"3982";"360610191003";6;12;1;0;5;24
"3983";"360610191004";282;10;10;0;8;310
"3984";"360610191005";49;82;61;2;41;235
"3985";"360610191006";50;57;13;1;100;221
"3986";"360610192000";2;0;0;0;1;3
"3987";"360610192001";463;261;190;46;20;980
"3988";"360610192002";40;41;25;1;6;113
"3989";"360610192003";0;2;0;0;0;2
"3990";"360610193001";56;146;22;6;31;261
"3991";"360610193002";84;156;99;4;12;355
"3992";"360610193003";49;112;77;0;5;243
"3993";"360610193004";47;28;107;3;20;205
"3994";"360610193005";113;311;83;2;11;520
"3995";"360610193006";56;185;124;3;6;374
"3996";"360610194001";209;50;27;4;19;309
"3997";"360610194002";44;49;474;17;16;600
"3998";"360610194003";228;1257;212;3;5132;6832
"3999";"360610194004";97;126;32;6;972;1233
"4000";"360610195001";9;27;21;2;113;172
"4001";"360610195002";50;72;58;3;32;215
"4002";"360610195003";332;462;53;2;31;880
"4003";"360610195004";94;97;33;0;6;230
"4004";"360610195005";55;53;84;1;10;203
"4005";"360610196001";93;73;32;4;8;210
"4006";"360610196002";100;47;272;7;65;491
"4007";"360610196003";114;48;81;11;148;402
"4008";"360610197011";21;84;106;6;48;265
"4009";"360610197021";175;272;138;21;109;715
"4010";"360610198001";60;146;267;24;48;545
"4011";"360610198002";7;76;57;2;33;175
"4012";"360610199001";14;15;26;0;28;83
"4013";"360610199002";11;25;79;0;43;158
"4014";"360610199003";38;9;8;1;3;59
"4015";"360610199004";20;2;20;2;5;49
"4016";"360610199005";20;23;78;2;48;171
"4017";"360610199006";17;127;45;0;35;224
"4018";"360610200001";58;97;351;5;10;521
"4019";"360610200002";1408;252;191;21;112;1984
"4020";"360610201011";15;27;50;0;7;99
"4021";"360610201021";45;148;89;1;58;341
"4022";"360610201022";87;293;59;4;20;463
"4023";"360610201023";216;57;14;5;6;298
"4024";"360610201024";24;39;11;0;5;79
"4025";"360610203001";22;2;12;3;1;40
"4026";"360610203002";1;12;32;1;2;48
"4027";"360610205001";28;30;38;3;11;110
"4028";"360610205002";15;8;152;0;92;267
"4029";"360610205003";2;13;139;0;14;168
"4030";"360610206001";123;270;108;21;43;565
"4031";"360610206002";177;78;52;13;23;343
"4032";"360610207011";25;6;10;3;1;45
"4033";"360610207012";12;13;14;0;2;41
"4034";"360610208001";123;90;39;11;27;290
"4035";"360610208002";507;92;68;16;16;699
"4036";"360610208003";75;152;209;18;32;486
"4037";"360610209011";56;80;58;3;35;232
"4038";"360610209012";65;19;16;4;14;118
"4039";"360610210000";0;0;4;0;5;9
"4040";"360610210001";54;60;179;9;15;317
"4041";"360610210002";86;33;26;2;40;187
"4042";"360610210003";52;63;40;2;27;184
"4043";"360610210004";299;63;35;4;29;430
"4044";"360610211001";83;99;36;2;17;237
"4045";"360610211002";18;73;13;0;33;137
"4046";"360610211003";76;59;209;11;24;379
"4047";"360610211004";74;44;14;2;7;141
"4048";"360610211005";85;13;16;2;6;122
"4049";"360610211006";9;30;20;1;3;63
"4050";"360610211007";40;21;24;1;4;90
"4051";"360610212001";69;74;346;5;16;510
"4052";"360610212002";3;9;22;2;16;52
"4053";"360610212003";58;102;3;0;10;173
"4054";"360610212004";29;67;83;6;21;206
"4055";"360610213031";63;35;38;6;19;161
"4056";"360610213032";19;45;59;6;30;159
"4057";"360610213033";237;180;14;3;29;463
"4058";"360610213034";141;400;44;1;23;609
"4059";"360610214001";489;83;147;8;21;748
"4060";"360610214002";91;34;124;9;7;265
"4061";"360610215001";106;214;44;5;19;388
"4062";"360610215002";610;128;190;8;81;1017
"4063";"360610216001";143;239;60;1;39;482
"4064";"360610216002";75;280;94;3;48;500
"4065";"360610216003";70;149;73;6;13;311
"4066";"360610216004";212;589;263;2;63;1129
"4067";"360610216005";149;172;94;11;32;458
"4068";"360610217031";15;60;91;7;19;192
"4069";"360610218001";58;218;272;33;125;706
"4070";"360610218002";197;442;399;14;36;1088
"4071";"360610218003";123;682;532;8;47;1392
"4072";"360610218004";688;464;308;20;114;1594
"4073";"360610219001";112;60;80;16;43;311
"4074";"360610219002";80;88;51;20;15;254
"4075";"360610219003";226;22;69;3;11;331
"4076";"360610219004";37;2;23;2;7;71
"4077";"360610220001";40;117;140;22;25;344
"4078";"360610220002";107;53;172;31;18;381
"4079";"360610220003";18;28;26;1;2;75
"4080";"360610220004";68;192;77;4;22;363
"4081";"360610220005";90;217;108;10;21;446
"4082";"360610221021";221;172;222;1;26;642
"4083";"360610221022";30;84;112;5;65;296
"4084";"360610222001";81;211;176;4;79;551
"4085";"360610222002";86;382;281;12;65;826
"4086";"360610223011";226;237;82;13;45;603
"4087";"360610223012";575;365;321;4;130;1395
"4088";"360610223013";295;423;99;9;47;873
"4089";"360610223014";89;124;12;1;41;267
"4090";"360610223021";110;143;71;6;17;347
"4091";"360610224001";188;204;45;0;21;458
"4092";"360610224002";109;153;69;3;23;357
"4093";"360610224003";2419;150;18;0;15;2602
"4094";"360610224004";800;60;27;4;6;897
"4095";"360610225001";1376;1507;90;20;108;3101
"4096";"360610225002";100;68;69;19;17;273
"4097";"360610225003";522;1606;68;6;48;2250
"4098";"360610225004";66;114;12;0;7;199
"4099";"360610225005";376;398;87;7;20;888
"4100";"360610226001";139;502;642;51;23;1357
"4101";"360610226002";76;126;54;12;38;306
"4102";"360610226003";185;380;120;21;20;726
"4103";"360610227001";98;246;201;7;32;584
"4104";"360610227002";55;102;120;11;21;309
"4105";"360610227003";208;494;234;17;33;986
"4106";"360610228001";180;183;77;8;25;473
"4107";"360610228002";57;78;38;4;141;318
"4108";"360610228003";115;169;118;6;24;432
"4109";"360610228004";38;105;113;13;20;289
"4110";"360610229001";41;51;12;0;9;113
"4111";"360610229002";117;153;89;3;337;699
"4112";"360610229003";360;276;360;9;151;1156
"4113";"360610229004";71;143;59;1;23;297
"4114";"360610229005";112;446;192;10;35;795
"4115";"360610230001";173;50;125;5;24;377
"4116";"360610230002";198;114;146;8;5;471
"4117";"360610230003";74;76;232;5;17;404
"4118";"360610230004";328;1254;124;14;473;2193
"4119";"360610230005";157;89;40;6;10;302
"4120";"360610231001";312;529;71;6;103;1021
"4121";"360610231002";98;337;71;9;45;560
"4122";"360610231003";208;218;94;20;60;600
"4123";"360610232001";86;51;51;16;52;256
"4124";"360610232002";304;136;105;10;17;572
"4125";"360610232003";360;42;18;8;11;439
"4126";"360610232004";127;212;41;16;29;425
"4127";"360610233001";166;372;164;4;62;768
"4128";"360610233002";321;268;118;14;31;752
"4129";"360610233003";271;183;87;6;38;585
"4130";"360610234001";465;231;81;24;16;817
"4131";"360610234002";302;154;144;15;20;635
"4132";"360610235011";72;118;103;7;51;351
"4133";"360610235012";392;368;432;14;39;1245
"4134";"360610235013";55;20;130;13;7;225
"4135";"360610235014";63;50;84;21;16;234
"4136";"360610235021";193;218;49;16;35;511
"4137";"360610236000";0;0;0;0;5;5
"4138";"360610236001";143;101;131;4;33;412
"4139";"360610236002";249;133;74;21;21;498
"4140";"360610236003";4;32;16;3;1;56
"4141";"360610236004";90;57;42;6;24;219
"4142";"360610237001";329;519;119;13;24;1004
"4143";"360610237002";2388;451;95;10;13;2957
"4144";"360610237003";337;319;147;24;16;843
"4145";"360610238010";0;0;1;0;0;1
"4146";"360610238011";47;40;19;0;86;192
"4147";"360610238021";6;24;3;1;6;40
"4148";"360610238022";13;0;8;0;1;22
"4149";"360610239001";90;71;17;2;38;218
"4150";"360610239002";123;351;32;3;21;530
"4151";"360610240001";35;619;10;2;17;683
"4152";"360610241001";45;38;90;5;23;201
"4153";"360610241002";58;166;109;13;42;388
"4154";"360610241003";167;88;31;2;12;300
"4155";"360610241004";390;227;47;5;72;741
"4156";"360610241005";99;113;56;4;15;287
"4157";"360610242000";0;1;0;0;2;3
"4158";"360610242001";87;24;48;7;27;193
"4159";"360610242002";181;36;102;5;79;403
"4160";"360610242003";36;374;89;9;40;548
"4161";"360610243011";43;48;60;6;4;161
"4162";"360610243012";175;206;196;6;37;620
"4163";"360610243013";20;78;11;0;46;155
"4164";"360610243020";0;0;0;0;2;2
"4165";"360610243021";221;148;38;6;16;429
"4166";"360610243022";17;1;0;0;1;19
"4167";"360610243023";386;76;36;0;3;501
"4168";"360610245001";170;455;33;2;46;706
"4169";"360610245002";192;152;97;4;24;469
"4170";"360610245003";143;308;81;10;15;557
"4171";"360610245004";193;321;260;21;55;850
"4172";"360610245005";61;273;395;4;55;788
"4173";"360610245006";200;207;53;4;72;536
"4174";"360610245007";182;102;43;4;22;353
"4175";"360610247001";52;208;107;10;12;389
"4176";"360610247002";73;138;34;12;14;271
"4177";"360610247003";107;127;35;17;11;297
"4178";"360610247004";231;146;21;4;52;454
"4179";"360610247005";24;38;104;14;11;191
"4180";"360610249001";132;818;316;12;13;1291
"4181";"360610251001";50;117;176;14;207;564
"4182";"360610251002";325;1505;339;6;75;2250
"4183";"360610253001";36;84;25;1;29;175
"4184";"360610253002";200;581;28;5;14;828
"4185";"360610253003";110;1125;242;5;45;1527
"4186";"360610253004";107;596;44;8;27;782
"4187";"360610253005";269;241;124;11;47;692
"4188";"360610253006";70;92;85;5;22;274
"4189";"360610255001";10;22;93;9;18;152
"4190";"360610255002";381;322;109;8;58;878
"4191";"360610255003";439;57;590;5;9;1100
"4192";"360610255004";53;11;275;8;15;362
"4193";"360610257001";47;81;668;5;88;889
"4194";"360610257002";73;71;74;10;16;244
"4195";"360610257003";75;50;80;3;54;262
"4196";"360610259001";190;241;243;53;49;776
"4197";"360610259002";86;378;195;10;54;723
"4198";"360610261001";146;300;119;13;33;611
"4199";"360610261002";332;297;20;6;63;718
"4200";"360610261003";149;113;21;10;11;304
"4201";"360610261004";71;233;52;20;33;409
"4202";"360610261005";39;167;85;9;21;321
"4203";"360610261006";26;649;15;12;10;712
"4204";"360610261007";71;317;57;4;21;470
"4205";"360610263001";116;197;261;19;18;611
"4206";"360610263002";605;273;17;12;65;972
"4207";"360610263003";82;440;103;17;19;661
"4208";"360610263004";108;262;106;5;34;515
"4209";"360610263005";63;100;36;4;88;291
"4210";"360610265001";137;159;106;1;10;413
"4211";"360610265002";86;96;203;11;31;427
"4212";"360610265003";36;87;63;3;15;204
"4213";"360610265004";171;267;50;5;35;528
"4214";"360610265005";24;43;60;7;95;229
"4215";"360610267001";110;38;60;21;4;233
"4216";"360610269001";37;138;45;11;7;238
"4217";"360610269002";124;158;18;3;23;326
"4218";"360610269003";78;38;248;3;10;377
"4219";"360610269004";57;283;41;12;23;416
"4220";"360610269005";153;434;56;7;35;685
"4221";"360610269006";121;163;21;18;22;345
"4222";"360610271001";91;1660;130;4;13;1898
"4223";"360610271002";88;2014;75;5;119;2301
"4224";"360610271003";54;140;240;12;39;485
"4225";"360610271004";50;37;63;4;14;168
"4226";"360610271005";17;27;120;5;18;187
"4227";"360610273001";67;132;261;10;26;496
"4228";"360610273002";43;47;187;2;23;302
"4229";"360610273003";35;150;186;6;24;401
"4230";"360610273004";42;66;46;2;123;279
"4231";"360610275000";0;0;0;0;2;2
"4232";"360610275001";13;75;73;7;4;172
"4233";"360610275002";4;0;20;3;5;32
"4234";"360610277001";380;865;369;52;51;1717
"4235";"360610277002";97;189;506;22;12;826
"4236";"360610277003";74;223;834;16;110;1257
"4237";"360610277004";56;194;74;10;7;341
"4238";"360610279001";37;111;95;0;19;262
"4239";"360610279002";384;344;159;15;66;968
"4240";"360610279003";163;230;60;5;48;506
"4241";"360610279004";172;308;79;78;31;668
"4242";"360610279005";42;148;85;8;10;293
"4243";"360610279006";42;131;19;11;9;212
"4244";"360610279007";19;39;46;2;12;118
"4245";"360610281001";22;9;44;3;27;105
"4246";"360610281002";268;213;340;4;54;879
"4247";"360610283001";14;70;12;0;6;102
"4248";"360610283002";752;475;597;20;78;1922
"4249";"360610283003";74;189;233;5;8;509
"4250";"360610283004";63;404;199;4;9;679
"4251";"360610285001";196;568;146;47;85;1042
"4252";"360610285002";84;332;32;7;59;514
"4253";"360610285003";48;176;43;5;6;278
"4254";"360610285004";234;502;44;2;19;801
"4255";"360610287001";351;1201;272;10;47;1881
"4256";"360610287002";97;325;204;7;8;641
"4257";"360610287003";91;698;208;10;55;1062
"4258";"360610291001";100;521;55;3;9;688
"4259";"360610291002";71;158;65;1;20;315
"4260";"360610291003";96;179;31;7;15;328
"4261";"360610291004";50;165;66;3;37;321
"4262";"360610291005";61;303;33;3;38;438
"4263";"360610291006";33;217;48;8;33;339
"4264";"360610291007";237;785;185;7;27;1241
"4265";"360610293001";154;283;120;4;23;584
"4266";"360610293002";252;1131;500;2;21;1906
"4267";"360610293003";217;460;207;1;29;914
"4268";"360610293004";142;231;146;3;82;604
"4269";"360610293005";98;334;243;1;11;687
"4270";"360610295001";90;519;86;16;17;728
"4271";"360610295002";303;729;213;8;56;1309
"4272";"360610295003";276;270;42;9;99;696
"4273";"360610295004";182;221;217;14;23;657
"4274";"360610297000";0;0;1;0;1;2
"4275";"360610297001";12;608;182;25;74;901
"4276";"360610299000";0;1;0;0;0;1
"4277";"360610299001";265;338;38;5;27;673
"4278";"360610299002";54;420;312;28;40;854
"4279";"360610303001";61;206;83;10;28;388
"4280";"360610303002";73;133;213;14;28;461
"4281";"360610303003";70;310;390;9;17;796
"4282";"360610307001";43;145;512;17;15;732
"4283";"360610307002";19;8;122;1;2;152
"4284";"360610307003";54;227;159;16;29;485
"4285";"360610309001";328;530;264;7;54;1183
"4286";"360610309002";49;143;80;7;15;294
"4287";"360610309003";103;263;197;3;17;583
"4288";"360610309004";316;362;779;21;24;1502
"4289";"360610311000";0;2;0;0;1;3
"4290";"360610311001";61;194;63;5;17;340
"4291";"360610317030";0;1;0;0;2;3
"4292";"360610317031";23;23;241;0;13;300
"4293";"360610317032";10;22;79;0;10;121
"4294";"360610317041";13;38;36;0;8;95
"4295";"360610317042";4;12;27;2;7;52
"4296";"360610317043";11;15;39;0;8;73
"4297";"360610317044";15;39;84;1;26;165
"4298";"360610319001";0;5;32;0;128;165
"4299";"360810001001";109;526;3009;37;121;3802
"4300";"360810002001";157;9;434;35;40;675
"4301";"360810002002";89;19;376;25;23;532
"4302";"360810004001";37;69;252;17;40;415
"4303";"360810004002";50;84;217;31;12;394
"4304";"360810004003";50;16;705;30;33;834
"4305";"360810006001";122;9;247;12;26;416
"4306";"360810006002";31;6;157;14;19;227
"4307";"360810006003";178;501;440;33;19;1171
"4308";"360810007001";111;377;302;18;38;846
"4309";"360810007002";53;33;234;8;32;360
"4310";"360810007003";21;116;870;12;25;1044
"4311";"360810007004";41;168;1408;7;178;1802
"4312";"360810008001";372;25;341;16;41;795
"4313";"360810008002";99;32;554;27;25;737
"4314";"360810010001";126;12;555;8;40;741
"4315";"360810010002";149;14;1259;33;41;1496
"4316";"360810012001";52;26;207;15;27;327
"4317";"360810012002";23;8;231;6;27;295
"4318";"360810012003";65;12;213;27;21;338
"4319";"360810014001";70;52;763;62;13;960
"4320";"360810014002";68;24;249;19;16;376
"4321";"360810014003";39;15;259;26;28;367
"4322";"360810016001";65;104;505;22;36;732
"4323";"360810016002";98;17;408;40;40;603
"4324";"360810018001";100;25;127;8;29;289
"4325";"360810018002";61;23;387;15;23;509
"4326";"360810019001";303;247;2359;89;268;3266
"4327";"360810020001";70;12;238;14;32;366
"4328";"360810022001";93;14;310;16;13;446
"4329";"360810022002";86;41;156;29;59;371
"4330";"360810024001";74;24;147;13;14;272
"4331";"360810024002";21;16;217;28;24;306
"4332";"360810025001";104;42;10;5;11;172
"4333";"360810025002";31;68;72;2;5;178
"4334";"360810025003";118;52;5;2;4;181
"4335";"360810025004";103;278;12;3;58;454
"4336";"360810025005";55;1;36;1;2;95
"4337";"360810025006";167;12;23;3;7;212
"4338";"360810026001";26;28;178;10;28;270
"4339";"360810026002";31;29;161;15;45;281
"4340";"360810028001";147;56;633;33;50;919
"4341";"360810028002";99;50;357;26;32;564
"4342";"360810030001";59;50;281;11;25;426
"4343";"360810031001";26;257;93;5;5;386
"4344";"360810031002";61;49;641;21;47;819
"4345";"360810032001";70;48;215;29;29;391
"4346";"360810033001";38;53;478;7;168;744
"4347";"360810033002";37;49;398;67;31;582
"4348";"360810033003";17;5;324;61;19;426
"4349";"360810033004";20;24;346;54;27;471
"4350";"360810034001";29;114;257;45;17;462
"4351";"360810034002";25;23;205;62;28;343
"4352";"360810036001";99;86;370;59;27;641
"4353";"360810036002";81;12;184;18;17;312
"4354";"360810037001";137;25;90;1;51;304
"4355";"360810038001";65;46;354;26;23;514
"4356";"360810038002";36;6;234;15;22;313
"4357";"360810039001";43;19;529;55;22;668
"4358";"360810040011";42;13;203;28;20;306
"4359";"360810040012";19;1;151;29;30;230
"4360";"360810040021";30;22;335;31;35;453
"4361";"360810042001";94;20;378;17;33;542
"4362";"360810042002";54;6;141;13;21;235
"4363";"360810042003";20;2;100;23;18;163
"4364";"360810043001";363;94;125;15;13;610
"4365";"360810043002";2;16;225;33;42;318
"4366";"360810044011";74;44;136;27;35;316
"4367";"360810044012";36;14;178;22;11;261
"4368";"360810045001";65;30;120;19;34;268
"4369";"360810045002";12;16;34;2;7;71
"4370";"360810045003";8;13;55;0;3;79
"4371";"360810047001";15;34;145;3;15;212
"4372";"360810047002";179;56;59;13;11;318
"4373";"360810050001";7;3;39;1;0;50
"4374";"360810051001";34;55;116;16;41;262
"4375";"360810051002";78;13;179;11;12;293
"4376";"360810052001";66;16;273;26;15;396
"4377";"360810052002";33;13;245;2;15;308
"4378";"360810053001";21;14;119;4;21;179
"4379";"360810053002";193;22;180;8;31;434
"4380";"360810053003";57;16;102;2;7;184
"4381";"360810053004";31;18;161;3;21;234
"4382";"360810054001";18;14;91;21;3;147
"4383";"360810054002";57;11;191;20;13;292
"4384";"360810054003";129;69;451;29;42;720
"4385";"360810054004";206;49;424;38;68;785
"4386";"360810055001";55;107;704;131;29;1026
"4387";"360810057001";107;493;187;9;20;816
"4388";"360810057002";26;25;313;42;32;438
"4389";"360810057003";50;154;173;10;25;412
"4390";"360810058001";77;21;225;26;23;372
"4391";"360810058002";44;12;247;28;15;346
"4392";"360810058003";20;19;104;23;24;190
"4393";"360810058004";47;28;341;14;38;468
"4394";"360810059001";44;67;200;3;33;347
"4395";"360810059002";62;43;229;3;17;354
"4396";"360810059003";23;136;145;11;80;395
"4397";"360810061001";77;50;134;1;29;291
"4398";"360810061002";350;140;209;2;29;730
"4399";"360810061003";48;43;69;7;32;199
"4400";"360810061004";21;39;106;4;10;180
"4401";"360810062011";34;5;38;3;6;86
"4402";"360810062012";64;10;595;18;17;704
"4403";"360810062021";2;27;110;22;7;168
"4404";"360810062022";10;7;93;15;8;133
"4405";"360810062023";69;12;100;17;13;211
"4406";"360810062024";38;8;235;13;13;307
"4407";"360810062025";83;16;78;6;32;215
"4408";"360810062026";22;4;73;14;12;125
"4409";"360810062027";69;18;317;19;15;438
"4410";"360810063001";55;34;233;0;40;362
"4411";"360810063002";105;56;127;1;20;309
"4412";"360810063003";80;211;178;1;25;495
"4413";"360810063004";28;335;175;1;27;566
"4414";"360810065011";167;38;169;1;15;390
"4415";"360810065012";35;24;148;9;14;230
"4416";"360810065013";9;6;799;3;2;819
"4417";"360810065021";186;678;186;3;28;1081
"4418";"360810065022";27;11;239;4;3;284
"4419";"360810065023";67;119;255;2;20;463
"4420";"360810069001";37;372;187;21;6;623
"4421";"360810069002";127;36;588;7;32;790
"4422";"360810069003";71;27;169;1;34;302
"4423";"360810071001";34;19;211;1;20;285
"4424";"360810071002";13;7;28;1;10;59
"4425";"360810071003";31;61;127;1;20;240
"4426";"360810071004";105;352;267;6;31;761
"4427";"360810073001";55;35;131;1;19;241
"4428";"360810073002";25;5;181;0;1;212
"4429";"360810073003";48;15;119;1;18;201
"4430";"360810075001";63;5;113;2;11;194
"4431";"360810075002";54;7;91;0;5;157
"4432";"360810075003";10;10;83;2;8;113
"4433";"360810077001";45;55;531;10;32;673
"4434";"360810079001";110;88;480;6;27;711
"4435";"360810079002";31;59;316;12;39;457
"4436";"360810081001";80;54;737;12;51;934
"4437";"360810083001";46;43;469;12;19;589
"4438";"360810083002";77;138;387;31;25;658
"4439";"360810085001";40;22;272;34;2;370
"4440";"360810085002";28;70;212;22;18;350
"4441";"360810086001";43;20;196;27;33;319
"4442";"360810086002";46;11;152;21;32;262
"4443";"360810087001";153;73;34;13;13;286
"4444";"360810087002";111;55;173;9;8;356
"4445";"360810087003";218;135;9;3;8;373
"4446";"360810088001";100;13;383;16;70;582
"4447";"360810088002";67;28;285;15;21;416
"4448";"360810091001";21;6;67;5;25;124
"4449";"360810091002";201;22;289;8;10;530
"4450";"360810094001";76;53;239;46;38;452
"4451";"360810094002";315;163;313;11;33;835
"4452";"360810095001";17;9;140;5;21;192
"4453";"360810095002";32;51;336;18;41;478
"4454";"360810096001";215;190;411;24;92;932
"4455";"360810096002";131;64;269;14;53;531
"4456";"360810097001";10;9;72;15;10;116
"4457";"360810097002";29;17;166;10;10;232
"4458";"360810097003";8;4;93;6;10;121
"4459";"360810097004";19;8;230;10;19;286
"4460";"360810098001";114;169;174;4;48;509
"4461";"360810098002";126;107;304;5;28;570
"4462";"360810099001";6;87;26;0;68;187
"4463";"360810100001";230;14;115;6;25;390
"4464";"360810100002";128;23;233;10;188;582
"4465";"360810101001";23;24;298;17;28;390
"4466";"360810101002";30;35;102;5;21;193
"4467";"360810102001";93;17;166;12;30;318
"4468";"360810102002";516;130;178;16;48;888
"4469";"360810103001";61;235;203;10;21;530
"4470";"360810103002";11;23;109;5;10;158
"4471";"360810103003";49;18;77;1;19;164
"4472";"360810103004";19;5;132;0;13;169
"4473";"360810104001";280;319;187;4;38;828
"4474";"360810104002";115;25;192;36;24;392
"4475";"360810105001";70;43;9;2;3;127
"4476";"360810105002";54;8;18;5;3;88
"4477";"360810105003";49;30;69;9;11;168
"4478";"360810105004";25;9;189;19;7;249
"4479";"360810106001";76;13;221;13;40;363
"4480";"360810106002";170;73;398;34;89;764
"4481";"360810107011";13;41;192;17;0;263
"4482";"360810108001";115;16;303;22;32;488
"4483";"360810108002";91;11;451;7;55;615
"4484";"360810110001";48;58;301;23;56;486
"4485";"360810110002";179;83;414;24;37;737
"4486";"360810111001";58;127;254;8;15;462
"4487";"360810111002";37;25;329;2;9;402
"4488";"360810112001";53;30;249;14;14;360
"4489";"360810112002";32;155;397;10;21;615
"4490";"360810113001";68;10;73;0;22;173
"4491";"360810113002";130;321;252;3;16;722
"4492";"360810113003";25;97;752;12;15;901
"4493";"360810114001";85;20;247;20;21;393
"4494";"360810115001";83;45;331;4;32;495
"4495";"360810115002";19;50;176;4;102;351
"4496";"360810116001";98;31;182;20;24;355
"4497";"360810116002";82;43;310;7;37;479
"4498";"360810117001";8;125;198;2;8;341
"4499";"360810117002";6;34;208;1;18;267
"4500";"360810117003";50;56;307;4;50;467
"4501";"360810117004";29;53;174;2;5;263
"4502";"360810118001";110;26;661;14;38;849
"4503";"360810118002";32;16;221;14;33;316
"4504";"360810119001";19;72;271;1;18;381
"4505";"360810119002";14;12;177;4;11;218
"4506";"360810120001";18;6;109;6;31;170
"4507";"360810120002";86;62;311;16;33;508
"4508";"360810121001";13;43;191;4;14;265
"4509";"360810121002";8;32;98;0;5;143
"4510";"360810122001";73;21;243;14;36;387
"4511";"360810122002";130;14;217;8;31;400
"4512";"360810123011";32;194;656;48;52;982
"4513";"360810123012";5;89;279;56;21;450
"4514";"360810123013";18;28;239;52;18;355
"4515";"360810124001";33;7;128;11;40;219
"4516";"360810124002";98;52;216;24;55;445
"4517";"360810125001";23;28;250;3;55;359
"4518";"360810125002";26;4;47;1;14;92
"4519";"360810126011";53;28;178;29;43;331
"4520";"360810126012";36;41;207;21;23;328
"4521";"360810126021";37;32;169;10;47;295
"4522";"360810126022";53;23;398;16;24;514
"4523";"360810128001";29;9;68;21;26;153
"4524";"360810128002";120;50;339;13;43;565
"4525";"360810130001";14;4;130;8;6;162
"4526";"360810130002";18;22;73;10;48;171
"4527";"360810132001";22;61;103;2;7;195
"4528";"360810132002";95;57;125;13;76;366
"4529";"360810134001";179;21;40;4;9;253
"4530";"360810134002";47;16;103;2;11;179
"4531";"360810134003";59;59;256;24;5;403
"4532";"360810134004";13;2;12;0;1;28
"4533";"360810135001";73;8;86;13;11;191
"4534";"360810136001";12;8;40;12;3;75
"4535";"360810136002";35;30;32;1;14;112
"4536";"360810137001";52;44;724;43;42;905
"4537";"360810138001";103;23;143;9;9;287
"4538";"360810138002";185;53;314;16;28;596
"4539";"360810140001";49;71;241;12;11;384
"4540";"360810140002";194;13;226;9;17;459
"4541";"360810141001";26;111;171;2;14;324
"4542";"360810141002";51;36;293;44;20;444
"4543";"360810142011";55;20;140;10;50;275
"4544";"360810142012";68;46;274;6;41;435
"4545";"360810142021";186;127;303;14;67;697
"4546";"360810142022";37;205;213;56;35;546
"4547";"360810143001";31;11;153;4;11;210
"4548";"360810143002";204;377;633;9;36;1259
"4549";"360810144001";119;69;805;23;64;1080
"4550";"360810145001";10;5;249;28;10;302
"4551";"360810145002";17;16;197;12;4;246
"4552";"360810147001";25;10;289;15;8;347
"4553";"360810147002";58;11;115;3;6;193
"4554";"360810147003";37;365;170;2;19;593
"4555";"360810148001";176;96;282;18;37;609
"4556";"360810149001";59;28;234;8;55;384
"4557";"360810149002";190;79;438;5;33;745
"4558";"360810150001";114;18;159;6;16;313
"4559";"360810150002";128;8;248;34;31;449
"4560";"360810151001";30;26;516;10;7;589
"4561";"360810151002";137;68;385;13;21;624
"4562";"360810152001";18;16;83;10;29;156
"4563";"360810152002";73;41;329;24;32;499
"4564";"360810153001";47;109;304;22;55;537
"4565";"360810153002";98;103;172;1;21;395
"4566";"360810154001";102;15;90;17;24;248
"4567";"360810154002";100;46;299;18;34;497
"4568";"360810155001";148;1047;248;5;28;1476
"4569";"360810155002";15;221;75;2;186;499
"4570";"360810156001";62;30;234;10;34;370
"4571";"360810156002";132;57;321;20;67;597
"4572";"360810157001";73;210;215;3;41;542
"4573";"360810158011";29;5;137;12;35;218
"4574";"360810158012";115;43;157;26;21;362
"4575";"360810158013";174;120;365;29;55;743
"4576";"360810158021";236;105;556;27;95;1019
"4577";"360810158022";470;539;431;9;71;1520
"4578";"360810158023";135;70;139;7;35;386
"4579";"360810159001";28;267;219;1;67;582
"4580";"360810159002";42;58;75;7;14;196
"4581";"360810159003";23;23;44;3;12;105
"4582";"360810159004";41;12;170;5;16;244
"4583";"360810161001";32;14;135;6;24;211
"4584";"360810161002";31;77;210;0;47;365
"4585";"360810163001";26;11;128;3;9;177
"4586";"360810163002";46;168;64;19;11;308
"4587";"360810163003";112;30;130;1;13;286
"4588";"360810164001";172;44;226;11;59;512
"4589";"360810164002";93;38;253;21;41;446
"4590";"360810166001";266;226;529;11;126;1158
"4591";"360810166002";91;87;190;7;50;425
"4592";"360810168001";101;36;165;19;55;376
"4593";"360810168002";111;44;257;21;15;448
"4594";"360810169001";54;109;507;3;12;685
"4595";"360810169002";36;15;39;0;8;98
"4596";"360810169003";117;19;113;10;14;273
"4597";"360810169004";27;25;191;1;13;257
"4598";"360810170001";230;36;235;22;38;561
"4599";"360810170002";121;40;162;15;29;367
"4600";"360810171001";22;56;1297;17;163;1555
"4601";"360810172001";96;55;154;25;34;364
"4602";"360810172002";131;65;96;19;21;332
"4603";"360810174001";75;15;117;22;29;258
"4604";"360810174002";54;19;146;13;39;271
"4605";"360810176001";80;25;194;27;27;353
"4606";"360810176002";68;14;114;23;36;255
"4607";"360810178001";184;59;153;37;26;459
"4608";"360810178002";69;18;209;35;23;354
"4609";"360810179001";38;5;842;14;19;918
"4610";"360810179002";49;68;245;14;36;412
"4611";"360810180001";61;22;239;20;77;419
"4612";"360810181011";26;73;69;0;7;175
"4613";"360810181012";81;15;31;3;5;135
"4614";"360810181013";83;20;32;2;37;174
"4615";"360810181021";44;13;56;0;7;120
"4616";"360810181022";45;21;93;3;28;190
"4617";"360810181023";45;37;130;0;8;220
"4618";"360810182001";45;13;147;57;26;288
"4619";"360810182002";97;11;168;60;12;348
"4620";"360810183001";10;24;73;1;12;120
"4621";"360810183002";243;30;23;5;8;309
"4622";"360810183003";91;35;21;2;50;199
"4623";"360810183004";73;43;101;1;78;296
"4624";"360810183005";49;87;92;22;56;306
"4625";"360810184011";162;21;336;52;54;625
"4626";"360810184021";124;54;123;22;24;347
"4627";"360810184022";87;16;137;30;9;279
"4628";"360810185011";29;12;177;3;19;240
"4629";"360810185012";10;11;88;0;8;117
"4630";"360810185013";108;20;72;0;10;210
"4631";"360810185021";19;9;45;1;3;77
"4632";"360810185022";148;34;219;3;14;418
"4633";"360810185023";99;51;219;4;59;432
"4634";"360810186001";184;65;413;64;35;761
"4635";"360810187001";52;2;160;3;15;232
"4636";"360810187002";33;8;201;2;13;257
"4637";"360810187003";50;15;173;15;15;268
"4638";"360810188001";84;38;264;33;16;435
"4639";"360810189001";69;25;154;4;12;264
"4640";"360810189002";169;11;323;24;18;545
"4641";"360810189003";87;5;147;6;12;257
"4642";"360810190001";131;43;87;18;38;317
"4643";"360810190002";90;26;163;13;19;311
"4644";"360810192001";63;30;178;9;18;298
"4645";"360810192002";83;35;84;7;17;226
"4646";"360810194001";66;10;133;51;14;274
"4647";"360810194002";86;14;226;37;32;395
"4648";"360810196001";77;21;240;29;9;376
"4649";"360810196002";265;134;323;47;26;795
"4650";"360810198001";29;9;99;13;23;173
"4651";"360810198002";38;17;233;24;19;331
"4652";"360810198003";26;14;142;43;13;238
"4653";"360810199001";4;1;296;17;34;352
"4654";"360810199002";20;47;428;120;45;660
"4655";"360810202001";141;56;201;62;33;493
"4656";"360810204001";29;32;130;53;22;266
"4657";"360810204002";123;279;162;19;17;600
"4658";"360810205001";24;96;90;47;7;264
"4659";"360810205002";11;9;220;31;7;278
"4660";"360810206001";75;29;333;28;26;491
"4661";"360810208001";21;11;179;10;181;402
"4662";"360810208002";107;138;633;57;63;998
"4663";"360810212001";55;129;327;5;72;588
"4664";"360810212002";129;86;102;6;21;344
"4665";"360810214001";82;18;234;1;12;347
"4666";"360810214002";59;11;392;12;23;497
"4667";"360810214003";74;67;500;55;77;773
"4668";"360810216001";32;14;71;1;17;135
"4669";"360810216002";39;12;107;8;15;181
"4670";"360810216003";137;64;77;19;136;433
"4671";"360810219001";10;55;192;31;23;311
"4672";"360810220011";15;3;76;11;7;112
"4673";"360810220012";168;12;214;17;6;417
"4674";"360810220013";152;52;93;2;17;316
"4675";"360810220014";4;0;5;2;0;11
"4676";"360810220021";12;2;90;11;10;125
"4677";"360810220022";197;21;97;6;6;327
"4678";"360810220023";54;7;86;11;13;171
"4679";"360810220024";44;32;106;3;17;202
"4680";"360810229001";15;171;37;107;4;334
"4681";"360810230001";6;8;60;14;34;122
"4682";"360810230002";23;8;39;18;10;98
"4683";"360810232001";13;1;20;5;1;40
"4684";"360810232002";24;10;173;0;17;224
"4685";"360810232003";42;14;233;14;19;322
"4686";"360810235001";155;51;68;4;11;289
"4687";"360810235002";61;19;56;4;19;159
"4688";"360810235003";40;24;75;3;10;152
"4689";"360810235004";39;111;63;3;16;232
"4690";"360810236001";17;5;80;9;52;163
"4691";"360810236002";149;102;83;0;31;365
"4692";"360810238001";456;42;50;2;64;614
"4693";"360810238002";13;13;22;3;172;223
"4694";"360810238003";143;30;21;2;13;209
"4695";"360810238004";13;7;221;2;13;256
"4696";"360810240001";35;33;69;2;26;165
"4697";"360810240002";78;107;506;15;104;810
"4698";"360810240003";148;30;36;22;13;249
"4699";"360810243001";20;9;213;35;21;298
"4700";"360810243002";51;19;88;17;15;190
"4701";"360810243003";120;17;220;56;14;427
"4702";"360810243004";61;10;270;33;22;396
"4703";"360810245001";30;4;46;3;0;83
"4704";"360810245002";19;11;178;9;21;238
"4705";"360810245003";5;12;102;1;15;135
"4706";"360810245004";15;20;232;12;15;294
"4707";"360810246001";137;21;61;2;114;335
"4708";"360810247001";34;15;270;2;25;346
"4709";"360810249001";151;18;115;0;50;334
"4710";"360810249002";53;11;64;2;12;142
"4711";"360810249003";53;24;93;2;32;204
"4712";"360810251001";95;57;153;5;33;343
"4713";"360810251002";17;6;61;1;7;92
"4714";"360810251003";32;7;282;13;21;355
"4715";"360810251004";105;143;28;1;13;290
"4716";"360810253011";47;20;151;1;11;230
"4717";"360810253012";111;8;286;1;10;416
"4718";"360810253013";27;30;15;5;59;136
"4719";"360810253014";40;45;66;1;11;163
"4720";"360810253021";22;4;11;2;4;43
"4721";"360810253022";71;31;174;3;32;311
"4722";"360810254001";72;138;166;54;31;461
"4723";"360810254002";66;52;104;12;28;262
"4724";"360810254003";714;20;39;12;45;830
"4725";"360810254004";1180;67;36;9;8;1300
"4726";"360810254005";41;17;316;43;25;442
"4727";"360810254006";177;20;130;25;24;376
"4728";"360810255001";45;21;725;54;81;926
"4729";"360810257001";28;30;517;54;24;653
"4730";"360810258001";32;22;89;67;15;225
"4731";"360810258002";20;18;174;21;26;259
"4732";"360810259001";57;48;690;46;55;896
"4733";"360810259002";37;7;54;2;42;142
"4734";"360810260001";74;24;30;6;13;147
"4735";"360810260002";34;4;113;41;16;208
"4736";"360810261001";12;31;69;38;225;375
"4737";"360810261002";63;20;221;2;32;338
"4738";"360810261003";63;44;92;5;56;260
"4739";"360810261004";119;181;378;2;127;807
"4740";"360810262001";68;45;215;38;41;407
"4741";"360810263001";23;63;164;18;36;304
"4742";"360810263002";108;219;199;2;40;568
"4743";"360810263003";36;17;169;0;20;242
"4744";"360810264001";191;11;31;16;19;268
"4745";"360810264002";46;19;135;43;26;269
"4746";"360810265001";68;252;268;4;86;678
"4747";"360810265002";167;172;340;3;54;736
"4748";"360810266001";758;97;120;30;13;1018
"4749";"360810267001";68;135;167;8;19;397
"4750";"360810267002";30;54;128;3;68;283
"4751";"360810267003";74;56;305;5;175;615
"4752";"360810269011";62;122;94;29;71;378
"4753";"360810269012";28;28;24;1;11;92
"4754";"360810269013";50;2;24;1;4;81
"4755";"360810269014";21;97;65;8;15;206
"4756";"360810269021";212;54;93;1;17;377
"4757";"360810269022";72;15;83;5;16;191
"4758";"360810270001";56;57;255;78;47;493
"4759";"360810271001";124;1374;113;23;26;1660
"4760";"360810271002";61;15;49;2;26;153
"4761";"360810271003";162;14;135;18;8;337
"4762";"360810271004";70;2;47;0;3;122
"4763";"360810271005";25;9;57;0;20;111
"4764";"360810272001";42;10;79;18;8;157
"4765";"360810272002";38;6;134;19;16;213
"4766";"360810273001";29;176;107;8;25;345
"4767";"360810273002";79;20;41;2;3;145
"4768";"360810273003";183;201;53;9;51;497
"4769";"360810273004";45;26;201;5;34;311
"4770";"360810273005";74;138;358;8;41;619
"4771";"360810274001";36;3;177;30;16;262
"4772";"360810275001";21;41;77;2;4;145
"4773";"360810275002";81;47;226;8;60;422
"4774";"360810275003";210;52;1067;9;45;1383
"4775";"360810276001";84;58;143;53;22;360
"4776";"360810277001";8;4;8;0;0;20
"4777";"360810277002";63;20;60;2;24;169
"4778";"360810277003";123;13;32;4;15;187
"4779";"360810277004";50;54;44;3;20;171
"4780";"360810277005";290;68;114;3;31;506
"4781";"360810278001";10;12;33;9;8;72
"4782";"360810278002";63;4;14;4;4;89
"4783";"360810279001";47;31;223;9;13;323
"4784";"360810279002";86;26;151;5;9;277
"4785";"360810279003";74;55;48;0;19;196
"4786";"360810279004";7;2;17;0;1;27
"4787";"360810280001";90;11;108;71;19;299
"4788";"360810281001";164;118;135;9;11;437
"4789";"360810281002";246;28;99;4;11;388
"4790";"360810281003";10;26;52;3;23;114
"4791";"360810281004";33;46;30;4;19;132
"4792";"360810282001";66;32;111;41;13;263
"4793";"360810283001";140;23;43;0;5;211
"4794";"360810283002";71;20;69;3;2;165
"4795";"360810283003";12;127;61;9;102;311
"4796";"360810283004";20;37;62;0;16;135
"4797";"360810283005";96;63;42;1;20;222
"4798";"360810284001";47;8;186;66;19;326
"4799";"360810284002";51;17;96;23;13;200
"4800";"360810285001";2;33;138;5;6;184
"4801";"360810285002";10;27;146;0;18;201
"4802";"360810285003";30;35;78;2;11;156
"4803";"360810285004";64;356;125;2;31;578
"4804";"360810287001";56;290;148;0;45;539
"4805";"360810287002";20;30;58;8;7;123
"4806";"360810287003";63;37;118;6;27;251
"4807";"360810287004";110;105;206;5;16;442
"4808";"360810288001";31;9;75;30;19;164
"4809";"360810288002";94;74;174;44;37;423
"4810";"360810288003";26;10;113;33;9;191
"4811";"360810288004";130;43;237;57;16;483
"4812";"360810289001";28;29;113;2;13;185
"4813";"360810289002";51;3;109;3;12;178
"4814";"360810289003";185;105;174;5;169;638
"4815";"360810291001";11;10;152;1;18;192
"4816";"360810291002";14;20;564;12;25;635
"4817";"360810291003";52;282;182;2;26;544
"4818";"360810291004";53;87;254;2;32;428
"4819";"360810293001";8;27;293;53;26;407
"4820";"360810294001";76;2;57;25;35;195
"4821";"360810294002";94;40;185;22;35;376
"4822";"360810294003";96;7;98;26;19;246
"4823";"360810294004";76;3;130;28;11;248
"4824";"360810294005";61;9;150;31;17;268
"4825";"360810294006";40;38;136;38;12;264
"4826";"360810295001";52;30;155;17;7;261
"4827";"360810295002";132;41;408;37;26;644
"4828";"360810297001";34;70;379;37;47;567
"4829";"360810297002";31;95;397;31;65;619
"4830";"360810299001";1;4;25;16;7;53
"4831";"360810306001";21;32;140;18;19;230
"4832";"360810306002";44;7;195;27;22;295
"4833";"360810306003";63;9;149;28;21;270
"4834";"360810306004";9;15;99;19;22;164
"4835";"360810309021";15;16;73;5;12;121
"4836";"360810309022";51;12;300;13;14;390
"4837";"360810309023";48;2;108;5;12;175
"4838";"360810309024";18;5;111;1;26;161
"4839";"360810309025";321;5;76;3;14;419
"4840";"360810309031";44;189;389;11;26;659
"4841";"360810309032";95;33;254;7;23;412
"4842";"360810309033";37;11;494;10;19;571
"4843";"360810309041";96;23;159;10;35;323
"4844";"360810309042";30;71;206;7;28;342
"4845";"360810317001";46;20;275;23;44;408
"4846";"360810317002";4;4;116;7;7;138
"4847";"360810317003";59;7;342;24;4;436
"4848";"360810317004";13;8;196;21;17;255
"4849";"360810320001";106;28;61;19;20;234
"4850";"360810320002";6;47;311;8;45;417
"4851";"360810320003";75;71;172;30;46;394
"4852";"360810320004";30;12;106;21;7;176
"4853";"360810327001";93;10;772;12;13;900
"4854";"360810327002";35;39;163;3;11;251
"4855";"360810328001";26;5;115;14;8;168
"4856";"360810328002";28;8;65;14;17;132
"4857";"360810329001";22;33;74;17;16;162
"4858";"360810329002";31;10;237;39;9;326
"4859";"360810329003";49;52;209;3;61;374
"4860";"360810330001";51;22;126;32;21;252
"4861";"360810330002";9;4;56;13;7;89
"4862";"360810330003";29;63;64;12;11;179
"4863";"360810330004";41;17;57;55;20;190
"4864";"360810330005";49;7;124;12;11;203
"4865";"360810331001";3;1;10;1;4;19
"4866";"360810334011";28;10;168;18;19;243
"4867";"360810334012";115;24;195;89;16;439
"4868";"360810334021";20;3;7;0;3;33
"4869";"360810334022";20;12;7;1;1;41
"4870";"360810334023";7;3;5;0;1;16
"4871";"360810334024";27;6;17;0;0;50
"4872";"360810334025";37;64;23;0;15;139
"4873";"360810334026";33;6;247;23;26;335
"4874";"360810337001";91;25;322;9;24;471
"4875";"360810337002";69;105;303;7;12;496
"4876";"360810339001";21;14;55;9;19;118
"4877";"360810339002";3;11;7;3;6;30
"4878";"360810339003";24;8;125;4;14;175
"4879";"360810347001";107;13;174;45;37;376
"4880";"360810347002";37;21;355;17;14;444
"4881";"360810351001";172;11;173;6;14;376
"4882";"360810351002";289;18;336;2;8;653
"4883";"360810351003";17;79;105;0;19;220
"4884";"360810352001";158;62;97;52;20;389
"4885";"360810352002";39;132;119;39;16;345
"4886";"360810353001";100;44;169;7;17;337
"4887";"360810353002";103;30;124;9;20;286
"4888";"360810357001";63;15;1239;26;22;1365
"4889";"360810357002";66;24;412;18;72;592
"4890";"360810357003";25;3;255;11;11;305
"4891";"360810358001";46;11;68;27;9;161
"4892";"360810358002";59;5;121;45;11;241
"4893";"360810358003";14;17;26;22;11;90
"4894";"360810358004";15;6;30;11;3;65
"4895";"360810361001";57;36;129;12;19;253
"4896";"360810361002";47;17;146;13;12;235
"4897";"360810363001";107;31;130;12;28;308
"4898";"360810363002";53;124;210;11;31;429
"4899";"360810365001";56;31;203;8;23;321
"4900";"360810365002";54;16;222;15;17;324
"4901";"360810366001";40;60;139;71;25;335
"4902";"360810366002";50;12;88;43;11;204
"4903";"360810367001";21;1;151;13;11;197
"4904";"360810367002";188;30;541;55;33;847
"4905";"360810368001";57;14;43;18;13;145
"4906";"360810368002";24;6;54;4;4;92
"4907";"360810371001";46;72;267;20;11;416
"4908";"360810373001";60;6;276;34;25;401
"4909";"360810373002";214;91;239;20;24;588
"4910";"360810375001";56;28;223;12;33;352
"4911";"360810375002";184;56;277;14;36;567
"4912";"360810376001";28;5;84;7;23;147
"4913";"360810376002";18;7;127;35;21;208
"4914";"360810376003";57;4;73;19;9;162
"4915";"360810376004";26;8;193;36;13;276
"4916";"360810376005";29;24;67;29;8;157
"4917";"360810377001";132;42;493;13;27;707
"4918";"360810377002";74;19;182;6;13;294
"4919";"360810379001";102;24;434;36;16;612
"4920";"360810379002";45;59;672;21;18;815
"4921";"360810379003";52;25;305;43;15;440
"4922";"360810381001";109;31;200;17;9;366
"4923";"360810381002";206;51;437;20;23;737
"4924";"360810381003";149;55;326;16;61;607
"4925";"360810383011";65;432;63;44;11;615
"4926";"360810383021";103;1580;318;41;234;2276
"4927";"360810384001";75;5;293;7;27;407
"4928";"360810384002";18;10;187;16;31;262
"4929";"360810394001";98;95;97;27;25;342
"4930";"360810394002";111;24;56;24;10;225
"4931";"360810394003";44;11;97;22;3;177
"4932";"360810398001";11;5;42;8;10;76
"4933";"360810398002";5;1;37;8;4;55
"4934";"360810399001";34;11;263;24;24;356
"4935";"360810399002";62;56;197;16;19;350
"4936";"360810399003";40;17;203;37;11;308
"4937";"360810400001";7;9;61;22;9;108
"4938";"360810400002";7;3;36;10;5;61
"4939";"360810401001";123;72;822;29;22;1068
"4940";"360810401002";49;121;527;13;28;738
"4941";"360810401003";51;10;216;10;15;302
"4942";"360810402001";17;8;93;30;18;166
"4943";"360810402002";20;4;45;9;12;90
"4944";"360810403001";126;323;448;29;19;945
"4945";"360810403002";25;42;209;21;26;323
"4946";"360810403003";68;15;206;12;24;325
"4947";"360810404001";16;4;72;7;9;108
"4948";"360810404002";36;4;31;5;8;84
"4949";"360810404003";10;1;57;11;15;94
"4950";"360810404004";5;3;174;13;9;204
"4951";"360810405001";29;68;109;10;15;231
"4952";"360810405002";32;65;136;9;87;329
"4953";"360810407001";97;180;301;4;22;604
"4954";"360810407002";37;44;97;7;16;201
"4955";"360810407003";35;3;84;18;7;147
"4956";"360810407004";37;44;378;0;13;472
"4957";"360810407005";59;48;59;3;10;179
"4958";"360810409001";33;37;272;8;11;361
"4959";"360810409002";324;15;160;3;15;517
"4960";"360810409003";10;13;68;1;20;112
"4961";"360810409004";60;42;147;3;69;321
"4962";"360810411001";251;232;172;15;22;692
"4963";"360810411002";36;12;92;4;8;152
"4964";"360810413001";193;52;347;8;46;646
"4965";"360810413002";52;138;334;9;50;583
"4966";"360810414001";52;7;159;52;35;305
"4967";"360810414002";19;15;4;12;3;53
"4968";"360810414003";42;18;145;49;38;292
"4969";"360810415001";143;111;278;14;53;599
"4970";"360810415002";29;13;540;30;9;621
"4971";"360810424001";43;13;126;19;6;207
"4972";"360810424002";24;6;25;21;9;85
"4973";"360810424003";20;9;22;14;5;70
"4974";"360810426001";13;10;13;8;8;52
"4975";"360810427001";78;72;367;12;34;563
"4976";"360810427002";198;150;692;36;24;1100
"4977";"360810432001";46;21;96;48;19;230
"4978";"360810434001";81;22;107;7;23;240
"4979";"360810437011";65;7;233;30;10;345
"4980";"360810437012";87;12;112;30;21;262
"4981";"360810437021";135;34;211;6;7;393
"4982";"360810437022";178;25;232;9;12;456
"4983";"360810437023";82;24;348;13;14;481
"4984";"360810439001";72;66;784;12;15;949
"4985";"360810439002";111;74;338;2;35;560
"4986";"360810440001";27;21;215;94;10;367
"4987";"360810440002";105;16;182;54;32;389
"4988";"360810440003";43;34;140;23;41;281
"4989";"360810443011";72;30;140;9;9;260
"4990";"360810443012";74;27;217;19;30;367
"4991";"360810443021";134;20;531;18;12;715
"4992";"360810443022";139;65;148;7;9;368
"4993";"360810443023";77;296;276;20;47;716
"4994";"360810444001";24;17;133;7;22;203
"4995";"360810444002";63;111;258;22;30;484
"4996";"360810444003";120;23;430;74;52;699
"4997";"360810446011";42;97;65;6;43;253
"4998";"360810446012";192;27;22;3;33;277
"4999";"360810446021";88;114;67;19;41;329
"5000";"360810446022";325;65;53;2;20;465
"5001";"360810448001";33;12;96;6;22;169
"5002";"360810448002";12;5;65;2;7;91
"5003";"360810450001";30;23;57;19;19;148
"5004";"360810450002";18;5;57;10;15;105
"5005";"360810452001";25;19;70;4;39;157
"5006";"360810454001";26;35;123;4;25;213
"5007";"360810454002";76;10;113;1;37;237
"5008";"360810455001";111;7;7;3;8;136
"5009";"360810455002";80;6;8;5;5;104
"5010";"360810455003";94;9;35;10;6;154
"5011";"360810455004";42;0;6;1;6;55
"5012";"360810455005";64;2;13;0;1;80
"5013";"360810455006";0;1;45;1;6;53
"5014";"360810456001";63;19;64;11;9;166
"5015";"360810457001";34;7;531;5;10;587
"5016";"360810457002";25;14;170;2;4;215
"5017";"360810458001";69;18;175;2;18;282
"5018";"360810459001";142;38;638;16;33;867
"5019";"360810459002";25;12;947;14;18;1016
"5020";"360810460001";144;6;62;2;142;356
"5021";"360810460002";303;6;50;2;11;372
"5022";"360810460003";67;22;58;5;23;175
"5023";"360810461001";69;34;370;8;16;497
"5024";"360810462001";61;25;99;0;23;208
"5025";"360810462002";146;97;180;6;45;474
"5026";"360810462003";96;55;254;3;39;447
"5027";"360810463001";28;24;268;12;11;343
"5028";"360810463002";57;119;416;21;25;638
"5029";"360810464001";90;17;74;7;9;197
"5030";"360810465001";111;192;540;7;117;967
"5031";"360810465002";58;5;114;9;18;204
"5032";"360810466001";34;12;114;2;3;165
"5033";"360810466002";34;75;90;0;29;228
"5034";"360810467001";50;10;129;6;14;209
"5035";"360810467002";65;18;358;13;12;466
"5036";"360810467003";42;12;87;2;7;150
"5037";"360810467004";47;32;69;3;10;161
"5038";"360810468001";36;14;130;12;169;361
"5039";"360810468002";183;102;283;21;52;641
"5040";"360810469001";706;141;137;19;25;1028
"5041";"360810469002";62;7;78;1;7;155
"5042";"360810469003";20;2;43;1;9;75
"5043";"360810469004";47;6;12;1;21;87
"5044";"360810469005";50;23;79;8;11;171
"5045";"360810470001";43;13;132;10;54;252
"5046";"360810470002";70;48;245;9;24;396
"5047";"360810471001";113;77;74;11;70;345
"5048";"360810471002";56;43;124;8;69;300
"5049";"360810472001";67;5;37;3;11;123
"5050";"360810472002";26;13;55;6;11;111
"5051";"360810472003";30;16;21;3;6;76
"5052";"360810473001";14;11;676;3;11;715
"5053";"360810473002";28;19;194;3;461;705
"5054";"360810473003";0;0;37;2;2;41
"5055";"360810475001";50;11;228;6;25;320
"5056";"360810475002";43;9;216;6;24;298
"5057";"360810476001";9;1;49;18;9;86
"5058";"360810476002";19;5;14;10;12;60
"5059";"360810478001";87;10;100;11;26;234
"5060";"360810478002";43;6;179;36;33;297
"5061";"360810478003";136;19;114;12;23;304
"5062";"360810479001";271;23;208;11;33;546
"5063";"360810479002";60;5;154;23;23;265
"5064";"360810479003";32;15;392;1;11;451
"5065";"360810480001";70;15;139;20;30;274
"5066";"360810480002";20;6;106;16;15;163
"5067";"360810481001";27;3;136;2;42;210
"5068";"360810481002";47;2;107;1;33;190
"5069";"360810481003";116;41;61;1;4;223
"5070";"360810481004";10;37;60;3;215;325
"5071";"360810482001";58;80;154;26;23;341
"5072";"360810483001";168;20;163;0;37;388
"5073";"360810483002";69;22;397;15;66;569
"5074";"360810484001";54;9;76;17;33;189
"5075";"360810484002";43;21;174;5;13;256
"5076";"360810484003";31;19;102;17;14;183
"5077";"360810484004";94;10;129;18;10;261
"5078";"360810485001";29;103;115;2;11;260
"5079";"360810485002";45;7;52;2;21;127
"5080";"360810485003";83;15;278;4;49;429
"5081";"360810489001";81;18;885;255;32;1271
"5082";"360810489002";15;2;66;18;4;105
"5083";"360810492001";145;9;35;20;6;215
"5084";"360810492002";56;8;17;2;9;92
"5085";"360810492003";36;4;57;4;22;123
"5086";"360810493011";32;2;339;111;12;496
"5087";"360810493012";40;9;203;27;14;293
"5088";"360810493021";29;48;357;8;24;466
"5089";"360810493022";33;8;361;16;18;436
"5090";"360810495001";32;14;616;10;22;694
"5091";"360810496001";62;12;99;8;89;270
"5092";"360810496002";51;14;96;14;27;202
"5093";"360810496003";12;2;82;10;12;118
"5094";"360810497001";67;3;483;12;13;578
"5095";"360810497002";14;24;561;27;15;641
"5096";"360810499001";17;3;94;13;51;178
"5097";"360810499002";37;45;181;10;33;306
"5098";"360810499003";18;5;210;24;21;278
"5099";"360810500001";66;47;174;25;23;335
"5100";"360810500002";243;83;137;25;24;512
"5101";"360810502011";139;28;81;40;16;304
"5102";"360810502021";39;6;66;22;22;155
"5103";"360810504001";23;7;43;11;8;92
"5104";"360810504002";29;7;41;17;13;107
"5105";"360810505001";61;6;559;34;13;673
"5106";"360810506001";6;9;49;18;3;85
"5107";"360810506002";12;1;35;15;7;70
"5108";"360810507001";25;3;381;23;28;460
"5109";"360810507002";60;4;245;8;14;331
"5110";"360810508001";32;74;66;24;14;210
"5111";"360810508002";71;51;48;11;9;190
"5112";"360810510001";46;5;45;18;10;124
"5113";"360810510002";13;8;37;11;7;76
"5114";"360810511001";54;33;666;38;19;810
"5115";"360810511002";27;4;396;13;11;451
"5116";"360810512001";31;6;50;20;9;116
"5117";"360810512002";68;15;48;12;15;158
"5118";"360810512003";21;22;37;20;22;122
"5119";"360810513001";60;27;456;12;20;575
"5120";"360810513002";73;13;611;12;9;718
"5121";"360810515001";36;17;269;0;12;334
"5122";"360810515002";109;32;345;10;9;505
"5123";"360810515003";29;36;366;36;15;482
"5124";"360810516001";10;15;19;6;19;69
"5125";"360810516002";90;8;228;18;13;357
"5126";"360810517001";18;35;271;19;9;352
"5127";"360810517002";31;13;451;25;12;532
"5128";"360810518001";52;22;33;12;16;135
"5129";"360810518002";43;3;58;9;15;128
"5130";"360810520001";35;21;69;9;9;143
"5131";"360810521001";22;10;197;60;13;302
"5132";"360810521002";48;25;422;16;28;539
"5133";"360810522001";59;8;99;4;25;195
"5134";"360810524001";17;9;27;6;12;71
"5135";"360810524002";89;33;101;17;11;251
"5136";"360810525001";30;6;369;30;20;455
"5137";"360810525002";39;30;385;17;27;498
"5138";"360810526001";17;3;27;8;16;71
"5139";"360810526002";42;9;71;5;7;134
"5140";"360810528001";49;8;95;32;22;206
"5141";"360810530001";17;13;41;21;8;100
"5142";"360810530002";38;18;43;22;21;142
"5143";"360810531001";46;19;660;76;17;818
"5144";"360810531002";22;11;368;9;15;425
"5145";"360810531003";8;29;343;45;34;459
"5146";"360810532001";65;5;60;14;17;161
"5147";"360810532002";62;9;81;7;12;171
"5148";"360810534011";19;14;120;12;50;215
"5149";"360810534012";28;3;527;4;20;582
"5150";"360810535001";118;110;292;35;23;578
"5151";"360810536011";8;5;31;4;7;55
"5152";"360810536012";5;4;25;6;5;45
"5153";"360810538001";28;2;29;8;11;78
"5154";"360810538002";14;2;22;11;6;55
"5155";"360810539001";62;52;305;25;18;462
"5156";"360810539002";93;39;268;12;32;444
"5157";"360810539003";75;48;326;29;31;509
"5158";"360810540001";62;21;170;34;29;316
"5159";"360810540002";59;45;132;65;27;328
"5160";"360810540003";43;20;101;13;9;186
"5161";"360810542001";31;13;47;4;17;112
"5162";"360810542002";42;7;73;15;12;149
"5163";"360810542003";108;29;117;17;41;312
"5164";"360810542004";118;77;67;17;17;296
"5165";"360810545001";66;46;758;7;25;902
"5166";"360810545002";56;56;149;2;5;268
"5167";"360810545003";47;21;96;4;6;174
"5168";"360810547001";49;59;128;6;35;277
"5169";"360810547002";52;21;101;9;12;195
"5170";"360810547003";47;15;130;0;21;213
"5171";"360810548001";18;4;76;2;21;121
"5172";"360810548002";44;3;74;7;10;138
"5173";"360810549001";88;20;119;3;25;255
"5174";"360810549002";42;33;93;7;17;192
"5175";"360810549003";114;56;179;23;44;416
"5176";"360810549004";101;102;60;9;25;297
"5177";"360810551001";21;39;150;5;6;221
"5178";"360810551002";65;32;98;2;10;207
"5179";"360810551003";61;54;134;8;9;266
"5180";"360810551004";79;17;224;7;12;339
"5181";"360810552001";129;13;44;5;10;201
"5182";"360810552002";22;7;97;13;34;173
"5183";"360810553001";117;123;686;7;36;969
"5184";"360810553002";178;105;161;8;33;485
"5185";"360810554001";32;6;94;1;21;154
"5186";"360810554002";38;28;114;8;17;205
"5187";"360810555001";19;9;99;15;8;150
"5188";"360810555002";27;97;283;29;47;483
"5189";"360810556001";22;3;79;7;12;123
"5190";"360810556002";22;7;29;4;11;73
"5191";"360810557001";55;30;193;5;11;294
"5192";"360810557002";72;137;411;24;55;699
"5193";"360810557003";37;22;24;1;20;104
"5194";"360810558001";18;11;39;10;8;86
"5195";"360810558002";78;7;61;13;49;208
"5196";"360810559001";97;370;323;56;37;883
"5197";"360810560001";25;0;41;4;7;77
"5198";"360810560002";59;7;39;10;6;121
"5199";"360810561001";16;107;174;20;23;340
"5200";"360810562001";48;5;69;5;26;153
"5201";"360810564001";68;20;96;9;25;218
"5202";"360810565001";91;39;470;68;32;700
"5203";"360810566001";28;5;66;27;14;140
"5204";"360810566002";115;82;66;0;34;297
"5205";"360810567001";49;6;239;8;11;313
"5206";"360810567002";38;9;546;14;30;637
"5207";"360810567003";103;11;646;55;28;843
"5208";"360810567004";36;15;361;7;27;446
"5209";"360810568001";21;17;75;11;19;143
"5210";"360810568002";38;13;97;17;23;188
"5211";"360810568003";20;8;40;2;7;77
"5212";"360810568004";54;84;148;35;23;344
"5213";"360810577001";187;70;98;2;39;396
"5214";"360810577002";36;45;452;31;11;575
"5215";"360810577003";32;9;277;12;12;342
"5216";"360810579001";32;21;89;9;3;154
"5217";"360810579002";16;10;727;10;14;777
"5218";"360810580001";10;1;17;5;4;37
"5219";"360810580002";18;5;51;10;7;91
"5220";"360810580003";26;5;42;10;13;96
"5221";"360810580004";9;1;35;15;6;66
"5222";"360810581001";31;47;880;10;12;980
"5223";"360810581002";26;36;498;3;16;579
"5224";"360810582001";36;24;101;13;12;186
"5225";"360810582002";67;19;136;32;35;289
"5226";"360810582003";19;1;73;16;8;117
"5227";"360810583001";79;38;239;13;18;387
"5228";"360810583002";62;114;524;9;31;740
"5229";"360810583003";24;27;204;12;12;279
"5230";"360810585001";57;51;140;0;19;267
"5231";"360810585002";34;9;224;1;18;286
"5232";"360810585003";56;39;934;7;14;1050
"5233";"360810587001";12;9;328;5;24;378
"5234";"360810587002";3;11;102;2;19;137
"5235";"360810587003";66;17;190;11;14;298
"5236";"360810589001";113;31;294;16;9;463
"5237";"360810589002";58;60;145;14;25;302
"5238";"360810589003";57;158;73;3;21;312
"5239";"360810590001";15;4;50;7;6;82
"5240";"360810591001";47;81;315;14;20;477
"5241";"360810591002";31;52;195;16;16;310
"5242";"360810591003";16;87;476;7;7;593
"5243";"360810591004";56;12;194;7;7;276
"5244";"360810592001";15;3;61;2;12;93
"5245";"360810593001";80;67;198;15;18;378
"5246";"360810593002";66;13;352;15;20;466
"5247";"360810594001";3;0;48;0;4;55
"5248";"360810594002";4;3;34;4;10;55
"5249";"360810595001";78;107;714;39;22;960
"5250";"360810595002";230;106;131;1;13;481
"5251";"360810595003";16;24;236;9;12;297
"5252";"360810595004";73;78;244;9;15;419
"5253";"360810596001";3;0;26;7;0;36
"5254";"360810596002";4;4;20;7;4;39
"5255";"360810598001";2;7;33;6;7;55
"5256";"360810598002";12;11;32;17;8;80
"5257";"360810599001";3;9;432;18;10;472
"5258";"360810599002";12;10;228;6;13;269
"5259";"360810600001";16;6;117;9;9;157
"5260";"360810601001";41;15;591;15;41;703
"5261";"360810601002";21;96;670;47;16;850
"5262";"360810603001";17;29;1164;51;20;1281
"5263";"360810606001";51;5;48;5;7;116
"5264";"360810606002";6;8;21;12;11;58
"5265";"360810607011";3;5;264;10;3;285
"5266";"360810608001";180;29;167;6;38;420
"5267";"360810610001";16;13;172;5;6;212
"5268";"360810612001";5;4;32;4;14;59
"5269";"360810612002";8;7;97;6;7;125
"5270";"360810613011";67;16;464;5;30;582
"5271";"360810613012";50;85;1218;35;49;1437
"5272";"360810613013";32;9;529;16;32;618
"5273";"360810613014";154;186;172;7;12;531
"5274";"360810613021";1;0;15;1;3;20
"5275";"360810614001";26;10;75;4;19;134
"5276";"360810616011";2;1;34;7;10;54
"5277";"360810616012";4;0;12;6;7;29
"5278";"360810616013";3;0;10;10;4;27
"5279";"360810616021";15;5;24;17;4;65
"5280";"360810616022";116;44;39;3;7;209
"5281";"360810618001";5;1;10;2;1;19
"5282";"360810618002";23;25;80;7;13;148
"5283";"360810619001";30;8;394;17;20;469
"5284";"360810619002";40;8;225;12;9;294
"5285";"360810620001";32;14;55;8;4;113
"5286";"360810621001";47;5;409;11;26;498
"5287";"360810621002";36;4;225;26;15;306
"5288";"360810621003";58;11;228;15;16;328
"5289";"360810622001";28;45;62;10;6;151
"5290";"360810622002";47;13;112;8;5;185
"5291";"360810623001";28;11;410;17;10;476
"5292";"360810623002";40;15;380;23;19;477
"5293";"360810624001";0;0;2;0;0;2
"5294";"360810625001";18;26;133;7;22;206
"5295";"360810625002";34;28;570;22;31;685
"5296";"360810626001";16;24;90;12;5;147
"5297";"360810626002";21;18;80;8;7;134
"5298";"360810626003";13;2;11;43;5;74
"5299";"360810627001";37;8;796;4;11;856
"5300";"360810627002";72;32;590;9;8;711
"5301";"360810629001";25;29;572;9;14;649
"5302";"360810629002";27;16;132;7;15;197
"5303";"360810629003";35;48;723;5;8;819
"5304";"360810630001";15;12;79;23;8;137
"5305";"360810630002";40;1;31;6;6;84
"5306";"360810632001";7;6;16;6;7;42
"5307";"360810632002";16;14;133;8;18;189
"5308";"360810633011";57;22;539;45;19;682
"5309";"360810633021";21;12;166;23;6;228
"5310";"360810633022";19;4;267;16;5;311
"5311";"360810635001";23;6;168;14;16;227
"5312";"360810635002";61;13;622;38;30;764
"5313";"360810637001";35;23;152;17;33;260
"5314";"360810637002";13;12;306;13;29;373
"5315";"360810637003";19;16;133;10;20;198
"5316";"360810638001";8;8;61;12;8;97
"5317";"360810638002";9;3;81;16;8;117
"5318";"360810638003";3;2;25;7;5;42
"5319";"360810638004";12;13;29;8;6;68
"5320";"360810638005";71;36;32;5;13;157
"5321";"360810639001";37;8;321;18;13;397
"5322";"360810639002";15;11;336;18;28;408
"5323";"360810641011";21;3;161;9;6;200
"5324";"360810641021";42;212;243;23;47;567
"5325";"360810645001";2;9;48;17;11;87
"5326";"360810645002";7;15;110;13;41;186
"5327";"360810646001";16;1;76;12;12;117
"5328";"360810646002";8;1;74;17;11;111
"5329";"360810650001";11;4;45;15;10;85
"5330";"360810650002";19;10;53;12;26;120
"5331";"360810654001";39;31;85;7;19;181
"5332";"360810654002";35;88;77;11;22;233
"5333";"360810654003";18;23;162;18;16;237
"5334";"360810655011";0;1;57;0;7;65
"5335";"360810656001";16;18;66;20;30;150
"5336";"360810656002";51;0;41;12;10;114
"5337";"360810656003";121;68;207;31;26;453
"5338";"360810657021";40;13;346;12;11;422
"5339";"360810657031";37;42;300;6;23;408
"5340";"360810657032";52;51;189;9;7;308
"5341";"360810657033";22;1;129;5;13;170
"5342";"360810659001";13;15;103;3;8;142
"5343";"360810659002";87;9;320;21;34;471
"5344";"360810660001";46;18;111;12;11;198
"5345";"360810660002";26;4;43;13;11;97
"5346";"360810661001";24;9;263;4;17;317
"5347";"360810663001";13;2;184;5;13;217
"5348";"360810663002";10;3;116;2;32;163
"5349";"360810663003";29;71;182;3;78;363
"5350";"360810664001";14;5;37;3;8;67
"5351";"360810664002";41;7;32;9;12;101
"5352";"360810664003";15;5;95;10;6;131
"5353";"360810664004";56;20;44;6;12;138
"5354";"360810664005";48;3;78;5;11;145
"5355";"360810664006";21;4;25;9;10;69
"5356";"360810664007";94;10;321;12;8;445
"5357";"360810664008";68;2;78;13;6;167
"5358";"360810665011";10;0;139;4;12;165
"5359";"360810665012";10;78;253;11;14;366
"5360";"360810665013";50;8;197;8;14;277
"5361";"360810665014";25;5;167;4;8;209
"5362";"360810667011";83;14;271;27;14;409
"5363";"360810667012";21;4;357;7;19;408
"5364";"360810669001";10;0;370;10;17;407
"5365";"360810669002";11;2;461;2;15;491
"5366";"360810671001";36;9;83;2;15;145
"5367";"360810671002";9;4;306;3;20;342
"5368";"360810677001";7;7;54;7;9;84
"5369";"360810677002";12;1;104;3;7;127
"5370";"360810679001";0;1;219;4;3;227
"5371";"360810679002";168;10;227;12;12;429
"5372";"360810679003";53;30;242;1;9;335
"5373";"360810680001";6;3;57;10;10;86
"5374";"360810680002";19;2;88;35;11;155
"5375";"360810680003";29;20;99;15;14;177
"5376";"360810680004";30;5;141;8;15;199
"5377";"360810682001";1;4;46;6;5;62
"5378";"360810682002";2;2;33;8;3;48
"5379";"360810683001";65;13;65;1;13;157
"5380";"360810683002";38;8;220;1;19;286
"5381";"360810683003";16;11;178;1;82;288
"5382";"360810687001";19;3;35;2;9;68
"5383";"360810687002";46;1;125;3;19;194
"5384";"360810687003";25;20;368;7;27;447
"5385";"360810690001";40;22;137;21;10;230
"5386";"360810690002";20;3;106;32;14;175
"5387";"360810693001";106;30;324;9;100;569
"5388";"360810693002";16;5;130;9;6;166
"5389";"360810694001";85;16;139;27;27;294
"5390";"360810694002";22;18;182;39;11;272
"5391";"360810695001";32;47;94;4;24;201
"5392";"360810695002";137;10;87;13;13;260
"5393";"360810697011";78;25;42;0;6;151
"5394";"360810697012";134;15;217;2;18;386
"5395";"360810697013";87;9;122;1;7;226
"5396";"360810697021";25;6;46;6;7;90
"5397";"360810697022";12;4;25;15;6;62
"5398";"360810697023";19;10;63;4;6;102
"5399";"360810697024";20;10;63;5;14;112
"5400";"360810703001";5;5;51;6;20;87
"5401";"360810703002";11;8;125;11;28;183
"5402";"360810707001";7;5;45;1;5;63
"5403";"360810707002";5;2;37;3;0;47
"5404";"360810707003";5;2;31;2;12;52
"5405";"360810709001";23;16;107;5;2;153
"5406";"360810709002";17;18;86;3;10;134
"5407";"360810711001";28;4;102;0;3;137
"5408";"360810711002";109;61;219;1;920;1310
"5409";"360810711003";99;32;61;0;8;200
"5410";"360810711004";11;123;88;0;715;937
"5411";"360810713031";52;16;128;3;26;225
"5412";"360810713032";42;35;83;0;26;186
"5413";"360810713033";98;10;118;1;8;235
"5414";"360810713041";34;9;46;1;5;95
"5415";"360810713042";3;7;34;2;4;50
"5416";"360810713043";9;2;4;1;1;17
"5417";"360810713044";54;29;116;5;14;218
"5418";"360810713051";21;13;27;2;13;76
"5419";"360810713052";31;13;70;1;242;357
"5420";"360810713053";95;14;93;1;95;298
"5421";"360810713061";39;32;233;1;10;315
"5422";"360810713062";183;22;366;4;502;1077
"5423";"360810713063";75;19;60;1;1061;1216
"5424";"360810713064";78;14;54;1;33;180
"5425";"360810716001";1;2;128;1;11;143
"5426";"360810717011";25;11;74;0;1;111
"5427";"360810717012";30;38;304;2;12;386
"5428";"360810717013";4;6;48;0;6;64
"5429";"360810717014";28;26;194;2;8;258
"5430";"360810717021";7;14;213;4;18;256
"5431";"360810717022";22;17;76;3;1;119
"5432";"360810719001";90;13;212;4;19;338
"5433";"360810719002";44;15;209;7;15;290
"5434";"360810721001";15;4;40;7;9;75
"5435";"360810721002";2;1;30;2;2;37
"5436";"360810721003";1273;11;30;2;12;1328
"5437";"360810721004";10;28;17;1;6;62
"5438";"360810721005";201;16;83;2;8;310
"5439";"360810723001";164;388;22;2;25;601
"5440";"360810723002";1;9;31;5;6;52
"5441";"360810723003";12;6;38;3;7;66
"5442";"360810729001";13;4;33;2;15;67
"5443";"360810729002";24;12;65;3;20;124
"5444";"360810731001";16;69;24;7;15;131
"5445";"360810731002";14;45;52;6;9;126
"5446";"360810737001";41;79;133;3;101;357
"5447";"360810737002";11;19;14;1;33;78
"5448";"360810739001";1;2;27;1;3;34
"5449";"360810739002";18;14;19;3;2;56
"5450";"360810739003";16;23;41;0;11;91
"5451";"360810739004";15;125;65;0;25;230
"5452";"360810739005";28;9;16;2;9;64
"5453";"360810741001";1;0;22;0;1;24
"5454";"360810741002";19;9;75;1;11;115
"5455";"360810741003";7;2;10;0;0;19
"5456";"360810741004";5;6;48;1;5;65
"5457";"360810743001";14;8;31;2;22;77
"5458";"360810743002";24;1;49;4;16;94
"5459";"360810743003";52;16;44;6;5;123
"5460";"360810743004";30;15;15;0;15;75
"5461";"360810745001";261;20;57;4;22;364
"5462";"360810745002";315;58;31;2;23;429
"5463";"360810747001";34;16;180;23;21;274
"5464";"360810747002";20;18;104;5;25;172
"5465";"360810749001";19;3;4;0;2;28
"5466";"360810749002";1;17;23;2;0;43
"5467";"360810757011";55;74;98;2;8;237
"5468";"360810757012";6;8;19;3;8;44
"5469";"360810757013";8;8;107;0;13;136
"5470";"360810757021";29;12;44;0;4;89
"5471";"360810757022";103;16;108;9;22;258
"5472";"360810757023";22;11;13;1;0;47
"5473";"360810769011";13;6;11;0;11;41
"5474";"360810769012";122;68;67;0;99;356
"5475";"360810769021";47;15;142;2;40;246
"5476";"360810773001";44;101;87;2;64;298
"5477";"360810773002";21;3;33;0;9;66
"5478";"360810775001";16;21;38;2;10;87
"5479";"360810775002";23;8;36;6;12;85
"5480";"360810775003";18;24;81;2;12;137
"5481";"360810779021";0;0;18;5;8;31
"5482";"360810779022";5;7;26;5;7;50
"5483";"360810779023";8;6;21;4;6;45
"5484";"360810779024";14;3;28;1;0;46
"5485";"360810779025";32;9;52;6;5;104
"5486";"360810779031";20;8;98;0;1;127
"5487";"360810779032";6;6;55;2;7;76
"5488";"360810779033";6;6;21;0;5;38
"5489";"360810779041";23;0;33;1;6;63
"5490";"360810779042";45;7;75;2;18;147
"5491";"360810779043";30;21;93;2;14;160
"5492";"360810779044";17;9;40;0;4;70
"5493";"360810779051";88;13;67;12;20;200
"5494";"360810779052";3;0;33;2;1;39
"5495";"360810779061";29;17;51;3;10;110
"5496";"360810779062";52;9;114;21;11;207
"5497";"360810779071";128;8;102;15;21;274
"5498";"360810779072";24;3;82;6;20;135
"5499";"360810779081";33;15;29;4;23;104
"5500";"360810779082";70;9;24;7;6;116
"5501";"360810788001";99;33;127;24;18;301
"5502";"360810788002";30;8;59;5;4;106
"5503";"360810790001";48;13;127;30;24;242
"5504";"360810790002";101;53;139;23;25;341
"5505";"360810792001";63;17;132;43;24;279
"5506";"360810792002";70;31;121;15;34;271
"5507";"360810793001";21;0;40;2;3;66
"5508";"360810797011";91;0;16;0;1;108
"5509";"360810797012";190;8;17;0;20;235
"5510";"360810797013";8;1;11;0;4;24
"5511";"360810797014";17;4;38;0;91;150
"5512";"360810797021";25;14;209;1;20;269
"5513";"360810797022";53;8;173;1;20;255
"5514";"360810797023";12;1;21;0;7;41
"5515";"360810799001";20;10;376;17;23;446
"5516";"360810799002";83;12;193;6;28;322
"5517";"360810803011";31;20;125;2;13;191
"5518";"360810803012";107;12;430;7;23;579
"5519";"360810803013";19;10;119;7;32;187
"5520";"360810803021";30;8;148;29;10;225
"5521";"360810803022";68;7;155;16;13;259
"5522";"360810803023";18;6;96;9;9;138
"5523";"360810809001";13;16;20;5;2;56
"5524";"360810809002";15;12;15;0;1;43
"5525";"360810809003";52;3;26;2;9;92
"5526";"360810809004";49;3;56;7;50;165
"5527";"360810809005";6;1;13;1;3;24
"5528";"360810809006";0;4;13;0;1;18
"5529";"360810809007";196;13;159;6;123;497
"5530";"360810814001";66;14;323;41;24;468
"5531";"360810814002";198;72;107;17;66;460
"5532";"360810814003";154;53;92;17;34;350
"5533";"360810818001";85;17;162;25;36;325
"5534";"360810818002";67;18;121;27;17;250
"5535";"360810818003";54;8;116;19;38;235
"5536";"360810837001";70;28;151;15;23;287
"5537";"360810837002";99;20;333;9;21;482
"5538";"360810837003";13;6;115;10;10;154
"5539";"360810837004";40;15;66;6;28;155
"5540";"360810838001";121;29;316;53;26;545
"5541";"360810838002";57;15;105;12;31;220
"5542";"360810838003";21;15;235;12;41;324
"5543";"360810838004";61;11;192;6;27;297
"5544";"360810840001";116;33;299;19;36;503
"5545";"360810840002";108;69;217;30;43;467
"5546";"360810840003";38;32;168;11;33;282
"5547";"360810840004";52;5;181;7;44;289
"5548";"360810840005";63;17;190;6;44;320
"5549";"360810845001";30;0;11;0;8;49
"5550";"360810845002";111;8;71;2;4;196
"5551";"360810845003";12;33;243;0;24;312
"5552";"360810846011";57;7;394;39;31;528
"5553";"360810846012";74;17;136;23;29;279
"5554";"360810846021";46;213;384;109;44;796
"5555";"360810849001";30;3;258;0;13;304
"5556";"360810849002";23;31;131;0;26;211
"5557";"360810849003";31;7;111;0;12;161
"5558";"360810849004";5;63;279;14;35;396
"5559";"360810853001";12;78;47;0;74;211
"5560";"360810853002";16;23;48;0;25;112
"5561";"360810853003";23;6;52;0;39;120
"5562";"360810853004";11;13;4;0;6;34
"5563";"360810855001";50;14;16;0;13;93
"5564";"360810855002";58;6;69;2;6;141
"5565";"360810855003";208;5;111;0;8;332
"5566";"360810855004";67;60;15;0;30;172
"5567";"360810857001";40;3;38;0;10;91
"5568";"360810857002";53;13;120;1;12;199
"5569";"360810857003";80;116;94;0;71;361
"5570";"360810859001";95;18;47;0;5;165
"5571";"360810859002";65;9;82;1;14;171
"5572";"360810859003";26;16;75;0;17;134
"5573";"360810861001";140;3;57;0;5;205
"5574";"360810861002";1;16;98;2;27;144
"5575";"360810863001";27;3;36;0;5;71
"5576";"360810863002";44;6;50;0;4;104
"5577";"360810863003";95;56;22;0;7;180
"5578";"360810863004";35;36;165;1;15;252
"5579";"360810864001";74;67;446;27;39;653
"5580";"360810864002";54;31;220;36;13;354
"5581";"360810865001";32;32;241;3;21;329
"5582";"360810865002";29;26;85;1;12;153
"5583";"360810869001";45;117;221;9;76;468
"5584";"360810869002";56;87;252;73;58;526
"5585";"360810871001";89;94;79;0;85;347
"5586";"360810871002";44;86;211;5;194;540
"5587";"360810884001";37;10;100;17;13;177
"5588";"360810884002";5;17;73;4;13;112
"5589";"360810884003";33;1;39;5;10;88
"5590";"360810884004";22;8;71;7;24;132
"5591";"360810884005";9;30;119;13;13;184
"5592";"360810884006";42;10;139;48;39;278
"5593";"360810884007";4;1;26;5;7;43
"5594";"360810884008";8;80;66;15;49;218
"5595";"360810889011";116;10;396;22;42;586
"5596";"360810889012";10;12;98;1;19;140
"5597";"360810889013";13;21;53;4;13;104
"5598";"360810889014";66;4;61;1;11;143
"5599";"360810889015";12;13;33;1;5;64
"5600";"360810889016";203;134;317;3;58;715
"5601";"360810889017";11;17;67;4;7;106
"5602";"360810892001";15;19;31;0;14;79
"5603";"360810892002";53;24;33;16;23;149
"5604";"360810892003";13;7;74;9;16;119
"5605";"360810892004";10;1;27;2;18;58
"5606";"360810892005";22;14;60;0;32;128
"5607";"360810892006";13;2;16;3;6;40
"5608";"360810892007";8;13;34;0;9;64
"5609";"360810892008";7;40;18;5;12;82
"5610";"360810907001";59;48;597;46;32;782
"5611";"360810916011";1;0;2;1;1;5
"5612";"360810916012";1;0;0;0;0;1
"5613";"360810916013";3;3;0;0;2;8
"5614";"360810916014";2;0;16;0;1;19
"5615";"360810916021";0;0;8;0;0;8
"5616";"360810918001";1;0;6;0;1;8
"5617";"360810919001";26;25;116;16;22;205
"5618";"360810919002";89;41;687;44;26;887
"5619";"360810919003";145;23;438;22;15;643
"5620";"360810922001";9;0;33;0;2;44
"5621";"360810922002";7;5;121;3;4;140
"5622";"360810922003";4;2;161;1;19;187
"5623";"360810925001";21;14;260;26;15;336
"5624";"360810925002";53;18;266;29;28;394
"5625";"360810925003";48;13;300;12;20;393
"5626";"360810928001";161;61;117;2;51;392
"5627";"360810928002";4;4;26;2;4;40
"5628";"360810928003";21;2;59;2;6;90
"5629";"360810929000";0;1;0;0;0;1
"5630";"360810929001";274;383;552;50;60;1319
"5631";"360810929002";109;13;602;54;36;814
"5632";"360810929003";53;2;164;30;23;272
"5633";"360810929004";29;15;65;10;13;132
"5634";"360810934010";9;1;19;0;1;30
"5635";"360810934011";15;22;103;2;9;151
"5636";"360810934012";20;119;263;1;8;411
"5637";"360810934013";7;313;660;0;10;990
"5638";"360810934021";77;19;296;10;28;430
"5639";"360810934022";15;12;115;0;5;147
"5640";"360810934023";59;18;447;0;16;540
"5641";"360810938001";53;9;49;0;23;134
"5642";"360810938002";35;30;162;1;10;238
"5643";"360810938003";303;233;286;1;85;908
"5644";"360810939001";105;54;163;18;31;371
"5645";"360810939002";56;12;199;19;28;314
"5646";"360810939003";79;12;395;28;12;526
"5647";"360810942011";163;132;655;16;50;1016
"5648";"360810942021";90;19;200;13;10;332
"5649";"360810942022";193;222;553;18;27;1013
"5650";"360810942031";57;31;249;13;11;361
"5651";"360810942032";10;55;186;0;7;258
"5652";"360810942033";120;14;70;2;6;212
"5653";"360810942034";8;28;6;0;2;44
"5654";"360810942035";3;1;9;1;3;17
"5655";"360810945000";2;1;2;1;1;7
"5656";"360810945001";115;114;185;29;87;530
"5657";"360810945002";57;125;179;43;49;453
"5658";"360810947001";74;54;309;41;24;502
"5659";"360810947002";72;19;167;16;20;294
"5660";"360810954001";138;23;67;9;12;249
"5661";"360810954002";55;11;40;6;11;123
"5662";"360810954003";47;21;144;18;21;251
"5663";"360810964001";93;30;208;58;24;413
"5664";"360810964002";51;185;117;22;35;410
"5665";"360810972021";501;45;30;8;8;592
"5666";"360810972030";6;0;0;0;0;6
"5667";"360810972031";27;2;24;11;13;77
"5668";"360810972032";60;4;7;2;2;75
"5669";"360810972033";46;3;11;8;8;76
"5670";"360810972034";199;7;8;3;2;219
"5671";"360810972041";30;20;3;0;8;61
"5672";"360810972042";66;68;116;16;31;297
"5673";"360810972043";16;5;7;0;1;29
"5674";"360810973001";40;152;25;4;16;237
"5675";"360810973002";4;2;28;8;7;49
"5676";"360810973003";9;24;53;3;7;96
"5677";"360810981001";31;34;79;10;15;169
"5678";"360810981002";16;68;97;12;18;211
"5679";"360810987001";21;36;63;17;27;164
"5680";"360810987002";36;121;111;10;167;445
"5681";"360810991000";0;2;1;0;0;3
"5682";"360810991001";12;13;85;4;5;119
"5683";"360810991002";16;8;61;1;0;86
"5684";"360810991003";12;34;27;4;9;86
"5685";"360810991004";27;12;20;2;12;73
"5686";"360810991005";20;12;63;6;15;116
"5687";"360810992001";201;30;62;13;19;325
"5688";"360810992002";73;13;60;8;7;161
"5689";"360810997011";63;99;63;3;19;247
"5690";"360810997012";20;35;12;1;11;79
"5691";"360810997013";25;9;50;4;11;99
"5692";"360810997031";59;13;177;7;20;276
"5693";"360810997032";0;0;110;1;6;117
"5694";"360810997033";15;11;60;1;13;100
"5695";"360810997041";159;15;54;2;2;232
"5696";"360810997042";32;6;125;0;2;165
"5697";"360810997043";27;3;219;2;2;253
"5698";"360810997044";31;4;58;3;4;100
"5699";"360810997050";0;1;0;0;0;1
"5700";"360810997051";31;38;224;8;17;318
"5701";"360810998011";21;22;68;13;13;137
"5702";"360810998012";117;3;14;1;4;139
"5703";"360810998013";73;8;124;5;17;227
"5704";"360810998014";54;1;10;2;5;72
"5705";"360810998015";39;6;51;7;9;112
"5706";"360810998021";148;13;67;46;28;302
"5707";"360810998022";94;6;15;1;10;126
"5708";"360810998023";12;7;11;1;4;35
"5709";"360810999001";0;32;7;1;13;53
"5710";"360811008011";53;23;23;22;7;128
"5711";"360811008012";17;11;48;20;13;109
"5712";"360811008021";138;139;459;11;43;790
"5713";"360811008022";70;4;92;7;15;188
"5714";"360811008023";68;10;58;28;12;176
"5715";"360811008024";56;15;38;19;32;160
"5716";"360811010011";279;20;302;7;19;627
"5717";"360811010012";32;17;138;10;25;222
"5718";"360811010013";90;102;136;7;23;358
"5719";"360811010014";82;8;113;2;32;237
"5720";"360811010021";6;11;47;14;6;84
"5721";"360811010022";265;43;157;9;15;489
"5722";"360811017001";10;7;26;9;7;59
"5723";"360811017002";18;6;45;3;3;75
"5724";"360811017003";11;19;77;4;12;123
"5725";"360811017004";7;4;115;0;2;128
"5726";"360811017005";5;7;26;2;8;48
"5727";"360811017006";1;40;110;1;12;164
"5728";"360811017007";4;10;36;3;4;57
"5729";"360811029001";30;47;359;14;22;472
"5730";"360811029002";12;6;147;3;9;177
"5731";"360811032011";67;8;102;23;14;214
"5732";"360811032012";70;10;89;13;19;201
"5733";"360811032013";123;35;53;7;19;237
"5734";"360811032021";30;89;144;13;8;284
"5735";"360811032022";6;1;121;3;3;134
"5736";"360811032023";56;30;147;5;4;242
"5737";"360811032024";76;64;129;6;27;302
"5738";"360811033001";12;12;158;7;18;207
"5739";"360811033002";18;15;144;7;14;198
"5740";"360811033003";15;12;34;4;7;72
"5741";"360811033004";20;9;41;2;13;85
"5742";"360811039001";43;15;250;6;32;346
"5743";"360811039002";41;14;307;12;20;394
"5744";"360811039003";36;50;124;11;25;246
"5745";"360811039004";14;171;228;13;22;448
"5746";"360811047001";36;29;190;12;16;283
"5747";"360811047002";13;16;102;6;37;174
"5748";"360811047003";38;7;135;7;19;206
"5749";"360811047004";25;2;143;6;7;183
"5750";"360811047005";70;13;604;29;31;747
"5751";"360811059001";27;4;25;0;18;74
"5752";"360811059002";26;3;35;2;11;77
"5753";"360811059003";4;9;14;0;5;32
"5754";"360811059004";21;8;27;4;29;89
"5755";"360811072011";48;37;255;15;53;408
"5756";"360811072020";0;1;0;0;0;1
"5757";"360811072021";0;5;0;0;1;6
"5758";"360811085001";9;4;78;0;14;105
"5759";"360811085002";17;6;178;4;2;207
"5760";"360811085003";7;16;796;11;15;845
"5761";"360811093001";11;6;24;1;4;46
"5762";"360811093002";9;12;14;1;17;53
"5763";"360811093003";5;4;4;0;2;15
"5764";"360811097001";10;9;33;0;8;60
"5765";"360811097002";26;28;84;3;9;150
"5766";"360811097003";27;4;16;0;5;52
"5767";"360811099001";26;29;71;4;36;166
"5768";"360811099002";18;11;44;9;16;98
"5769";"360811099003";21;4;141;8;17;191
"5770";"360811113001";17;4;26;0;13;60
"5771";"360811113002";4;2;47;4;13;70
"5772";"360811113003";20;3;20;1;4;48
"5773";"360811123001";42;8;160;0;19;229
"5774";"360811123002";54;919;520;2;44;1539
"5775";"360811129001";8;3;28;0;6;45
"5776";"360811129002";8;3;12;0;13;36
"5777";"360811129003";16;1;74;1;6;98
"5778";"360811133001";9;3;40;2;1;55
"5779";"360811133002";11;5;24;6;15;61
"5780";"360811139001";63;12;172;11;15;273
"5781";"360811139002";45;6;161;9;20;241
"5782";"360811139003";21;27;93;3;7;151
"5783";"360811141001";18;15;155;9;17;214
"5784";"360811141002";12;5;64;7;23;111
"5785";"360811147001";12;4;60;1;5;82
"5786";"360811147002";11;6;24;3;18;62
"5787";"360811151001";20;214;71;3;37;345
"5788";"360811155001";19;16;81;0;23;139
"5789";"360811155002";19;24;34;1;11;89
"5790";"360811157001";22;5;61;0;10;98
"5791";"360811157002";39;17;54;1;14;125
"5792";"360811157003";85;3;81;2;4;175
"5793";"360811159001";1;16;51;0;9;77
"5794";"360811159002";22;3;75;0;6;106
"5795";"360811159003";68;1;107;1;12;189
"5796";"360811161001";48;7;150;1;5;211
"5797";"360811161002";150;16;109;0;11;286
"5798";"360811163001";106;8;20;0;7;141
"5799";"360811163002";65;81;45;6;5;202
"5800";"360811163003";18;31;117;4;3;173
"5801";"360811163004";37;9;79;1;14;140
"5802";"360811163005";51;8;189;2;20;270
"5803";"360811167001";57;37;2309;5;25;2433
"5804";"360811171001";9;17;314;4;15;359
"5805";"360811171002";6;3;48;0;7;64
"5806";"360811171003";24;29;95;5;12;165
"5807";"360811175001";55;19;100;5;13;192
"5808";"360811175002";62;154;270;21;7;514
"5809";"360811175003";26;12;122;9;20;189
"5810";"360811175004";46;29;229;13;23;340
"5811";"360811181001";10;3;122;4;10;149
"5812";"360811181002";40;6;114;4;16;180
"5813";"360811185001";51;14;132;2;9;208
"5814";"360811185002";29;5;71;2;14;121
"5815";"360811187001";15;5;117;4;9;150
"5816";"360811187002";33;4;219;3;8;267
"5817";"360811189001";28;7;168;9;19;231
"5818";"360811189002";5;1;102;0;6;114
"5819";"360811191001";55;8;419;5;14;501
"5820";"360811191002";173;7;198;3;55;436
"5821";"360811193001";14;3;172;3;17;209
"5822";"360811193002";38;4;101;7;5;155
"5823";"360811195001";32;17;163;4;28;244
"5824";"360811199001";27;3;188;2;30;250
"5825";"360811201001";82;8;191;3;13;297
"5826";"360811203001";0;1;51;1;9;62
"5827";"360811203002";15;4;59;0;13;91
"5828";"360811205001";51;9;296;2;23;381
"5829";"360811207001";34;14;75;3;20;146
"5830";"360811207002";34;16;296;14;19;379
"5831";"360811211001";17;30;170;6;19;242
"5832";"360811215001";38;6;339;19;12;414
"5833";"360811215002";33;37;124;8;42;244
"5834";"360811215003";24;3;165;16;25;233
"5835";"360811223001";16;13;146;15;9;199
"5836";"360811223002";22;7;59;27;7;122
"5837";"360811223003";42;7;55;15;21;140
"5838";"360811227011";31;11;210;8;6;266
"5839";"360811227012";7;5;84;5;5;106
"5840";"360811227013";71;485;698;9;76;1339
"5841";"360811227014";33;4;22;1;1;61
"5842";"360811227015";119;8;69;16;21;233
"5843";"360811227016";7;1;7;0;0;15
"5844";"360811227017";26;5;33;1;11;76
"5845";"360811227021";189;23;45;0;5;262
"5846";"360811227022";47;9;41;4;13;114
"5847";"360811227023";387;13;113;2;2;517
"5848";"360811227024";23;3;74;12;7;119
"5849";"360811227025";91;54;45;3;8;201
"5850";"360811241001";30;1;87;16;13;147
"5851";"360811241002";26;4;33;1;12;76
"5852";"360811241003";56;4;94;15;13;182
"5853";"360811247001";6;9;53;11;7;86
"5854";"360811247002";20;4;57;4;24;109
"5855";"360811247003";12;3;142;13;13;183
"5856";"360811257001";56;39;407;6;28;536
"5857";"360811257002";121;690;150;9;147;1117
"5858";"360811257003";837;5825;1904;0;32;8598
"5859";"360811265001";11;3;42;9;8;73
"5860";"360811265002";33;391;115;13;21;573
"5861";"360811267001";8;17;59;6;2;92
"5862";"360811267002";99;978;153;1;39;1270
"5863";"360811267003";48;6;54;10;15;133
"5864";"360811277001";54;11;48;3;9;125
"5865";"360811277002";46;14;33;4;11;108
"5866";"360811277003";7;6;13;2;6;34
"5867";"360811277004";10;32;15;3;14;74
"5868";"360811283001";5;161;188;2;42;398
"5869";"360811291021";10;4;39;1;23;77
"5870";"360811291022";16;0;6;0;6;28
"5871";"360811291023";10;2;7;0;3;22
"5872";"360811291024";21;2;72;3;12;110
"5873";"360811291031";63;6;99;1;4;173
"5874";"360811291032";14;8;83;1;49;155
"5875";"360811291033";7;5;21;4;10;47
"5876";"360811291041";1;11;3;0;1;16
"5877";"360811291042";7;1;73;3;2;86
"5878";"360811291043";6;0;40;1;1;48
"5879";"360811291044";3;0;37;2;5;47
"5880";"360811291045";3;3;225;0;10;241
"5881";"360811301001";8;4;68;9;3;92
"5882";"360811301002";3;7;84;0;5;99
"5883";"360811301003";25;18;181;4;26;254
"5884";"360811301004";15;8;54;7;18;102
"5885";"360811333001";8;5;60;7;13;93
"5886";"360811333002";26;2;50;2;8;88
"5887";"360811333003";33;7;41;3;5;89
"5888";"360811333004";23;12;102;5;19;161
"5889";"360811339001";15;9;83;3;8;118
"5890";"360811341001";19;5;136;6;16;182
"5891";"360811341002";27;6;36;8;13;90
"5892";"360811341003";13;4;67;21;18;123
"5893";"360811347001";20;10;161;12;51;254
"5894";"360811347002";3;7;79;6;2;97
"5895";"360811347003";67;14;129;4;5;219
"5896";"360811347004";66;10;73;0;8;157
"5897";"360811347005";200;31;224;17;44;516
"5898";"360811367001";33;4;171;2;9;219
"5899";"360811367002";15;5;31;10;5;66
"5900";"360811367003";2;4;11;0;1;18
"5901";"360811367004";18;6;42;1;7;74
"5902";"360811367005";7;3;142;2;1;155
"5903";"360811377001";5;4;150;1;20;180
"5904";"360811377002";42;42;120;6;7;217
"5905";"360811377003";15;3;207;6;8;239
"5906";"360811377004";22;0;65;1;5;93
"5907";"360811385011";3;8;67;2;10;90
"5908";"360811385012";62;5;81;3;12;163
"5909";"360811385013";15;4;88;2;6;115
"5910";"360811385014";8;3;38;1;4;54
"5911";"360811385021";5;66;46;6;22;145
"5912";"360811399001";0;0;33;3;2;38
"5913";"360811399002";47;10;84;8;10;159
"5914";"360811403001";72;13;47;0;10;142
"5915";"360811403002";7;8;27;1;13;56
"5916";"360811409011";21;10;19;2;14;66
"5917";"360811409021";14;8;104;3;32;161
"5918";"360811409022";15;160;1334;1;17;1527
"5919";"360811417001";15;11;32;1;10;69
"5920";"360811417002";9;6;37;1;58;111
"5921";"360811417003";18;4;102;4;7;135
"5922";"360811417004";7;7;49;3;12;78
"5923";"360811417005";40;20;120;1;33;214
"5924";"360811429001";8;51;43;4;10;116
"5925";"360811429002";16;11;56;1;16;100
"5926";"360811429003";10;2;18;0;13;43
"5927";"360811429004";47;9;34;8;10;108
"5928";"360811435001";6;1;104;0;16;127
"5929";"360811435002";7;1;45;0;9;62
"5930";"360811441001";7;3;29;1;10;50
"5931";"360811441002";16;1;30;0;1;48
"5932";"360811441003";0;5;38;0;0;43
"5933";"360811441004";0;1;18;0;3;22
"5934";"360811447001";201;6;181;8;20;416
"5935";"360811447002";91;56;206;3;37;393
"5936";"360811451011";86;2;179;3;24;294
"5937";"360811451021";13;1;29;1;17;61
"5938";"360811451022";22;3;105;4;17;151
"5939";"360811459001";11;9;63;0;9;92
"5940";"360811459002";13;11;60;0;11;95
"5941";"360811459003";25;3;36;1;18;83
"5942";"360811463001";19;20;91;1;4;135
"5943";"360811463002";25;13;83;4;17;142
"5944";"360811467001";160;129;286;26;24;625
"5945";"360811467002";30;3;27;0;0;60
"5946";"360811467003";3;5;84;1;7;100
"5947";"360811471001";19;17;182;6;29;253
"5948";"360811471002";6;4;95;2;15;122
"5949";"360811479001";4;11;70;1;5;91
"5950";"360811479002";16;11;184;1;8;220
"5951";"360811479003";22;5;238;2;7;274
"5952";"360811483001";10;4;12;0;13;39
"5953";"360811483002";3;2;34;2;2;43
"5954";"360811483003";7;9;33;2;7;58
"5955";"360811483004";20;9;13;1;14;57
"5956";"360811507011";6;11;30;1;17;65
"5957";"360811507012";8;3;19;2;8;40
"5958";"360811507013";2;2;45;1;2;52
"5959";"360811507021";10;6;32;1;9;58
"5960";"360811507022";0;1;25;1;5;32
"5961";"360811507023";30;3;87;7;8;135
"5962";"360811507024";15;55;107;0;11;188
"5963";"360811529011";16;3;114;7;8;148
"5964";"360811529012";37;44;135;10;15;241
"5965";"360811529013";15;1;113;6;10;145
"5966";"360811529021";0;0;15;0;1;16
"5967";"360811529022";5;5;17;1;11;39
"5968";"360811529023";15;1;53;9;14;92
"5969";"360811529024";0;1;51;1;2;55
"5970";"360811551011";11;0;1;0;0;12
"5971";"360811551021";9;3;50;4;2;68
"5972";"360811551022";12;8;25;4;8;57
"5973";"360811551023";11;30;262;2;13;318
"5974";"360811551024";8;45;45;2;8;108
"5975";"360811551025";3;2;55;0;7;67
"5976";"360811551026";13;0;98;2;2;115
"5977";"360811567001";10;16;180;4;16;226
"5978";"360811571011";3;2;25;3;1;34
"5979";"360811571012";13;18;62;4;6;103
"5980";"360811571013";1;1;18;2;0;22
"5981";"360811571014";16;3;30;6;16;71
"5982";"360811571015";13;0;40;2;15;70
"5983";"360811571016";16;5;55;4;17;97
"5984";"360811571017";5;1;106;0;21;133
"5985";"360811571018";7;4;31;1;12;55
"5986";"360811571021";25;4;42;0;16;87
"5987";"360811571022";3;5;59;4;46;117
"5988";"360811579011";8;2;11;4;6;31
"5989";"360811579012";31;0;25;0;11;67
"5990";"360811579013";11;2;30;1;6;50
"5991";"360811579014";37;2;32;1;6;78
"5992";"360811579015";10;1;25;2;6;44
"5993";"360811579016";12;4;47;1;12;76
"5994";"360811579021";15;8;28;2;14;67
"5995";"360811579022";39;1;16;3;11;70
"5996";"360811579023";30;119;24;0;2;175
"5997";"360811579024";27;10;34;2;17;90
"5998";"360811579025";3;4;58;0;18;83
"5999";"360811579031";13;5;27;5;9;59
"6000";"360811579032";3;7;64;1;19;94
"6001";"360811579033";17;2;75;6;15;115
"6002";"360811579034";7;5;50;4;8;74
"6003";"360811617001";12;5;41;5;34;97
"6004";"360811617002";5;3;15;3;13;39
"6005";"360811617003";9;2;35;3;23;72
"6006";"360811617004";49;11;138;25;33;256
"6007";"360811621001";34;8;98;2;22;164
"6008";"360811621002";47;6;222;15;21;311
"6009";"360811621003";87;4;51;1;19;162
"6010";"360811621004";13;10;73;4;25;125
"6011";"360811621005";21;23;117;17;29;207
"6012";"360850003001";59;4;20;1;85;169
"6013";"360850003002";28;626;24;2;26;706
"6014";"360850006001";12;65;83;13;18;191
"6015";"360850006002";72;7;115;7;17;218
"6016";"360850007001";89;268;185;5;25;572
"6017";"360850007002";51;24;86;4;12;177
"6018";"360850007003";35;36;50;10;6;137
"6019";"360850007004";152;34;150;3;34;373
"6020";"360850008001";34;22;118;29;24;227
"6021";"360850008002";37;18;120;11;8;194
"6022";"360850008003";37;16;126;28;19;226
"6023";"360850009001";105;8;156;13;16;298
"6024";"360850009002";73;41;72;26;11;223
"6025";"360850011001";73;92;67;8;20;260
"6026";"360850011002";64;12;84;14;18;192
"6027";"360850011003";65;59;89;15;9;237
"6028";"360850017001";4;5;35;6;5;55
"6029";"360850017002";37;5;146;9;4;201
"6030";"360850018001";0;0;0;0;1;1
"6031";"360850020011";25;1;65;16;5;112
"6032";"360850020012";8;2;82;12;5;109
"6033";"360850020021";47;6;105;9;20;187
"6034";"360850020022";4;2;23;11;7;47
"6035";"360850021000";0;4;0;0;1;5
"6036";"360850021001";68;77;117;22;25;309
"6037";"360850021002";93;103;117;29;45;387
"6038";"360850021003";31;37;100;31;18;217
"6039";"360850027001";86;41;85;58;27;297
"6040";"360850029001";71;16;155;30;7;279
"6041";"360850029002";229;33;9;6;13;290
"6042";"360850029003";126;17;141;25;27;336
"6043";"360850029004";21;4;38;23;18;104
"6044";"360850033001";20;3;25;6;4;58
"6045";"360850033002";55;37;107;10;27;236
"6046";"360850036001";27;29;93;7;6;162
"6047";"360850036002";22;2;40;0;11;75
"6048";"360850039001";8;0;17;0;1;26
"6049";"360850039002";121;10;91;1;9;232
"6050";"360850040001";14;3;83;19;14;133
"6051";"360850040002";253;59;74;15;18;419
"6052";"360850040003";316;6;60;5;10;397
"6053";"360850040004";145;9;39;1;14;208
"6054";"360850040005";12;3;8;0;15;38
"6055";"360850040006";57;6;43;6;32;144
"6056";"360850040007";38;6;35;3;17;99
"6057";"360850047001";36;34;182;6;26;284
"6058";"360850047002";37;44;31;16;4;132
"6059";"360850050001";19;8;145;2;10;184
"6060";"360850050002";15;11;166;4;13;209
"6061";"360850050003";4;23;15;1;11;54
"6062";"360850059001";90;48;39;3;13;193
"6063";"360850059002";52;9;82;2;6;151
"6064";"360850064001";8;3;24;1;15;51
"6065";"360850064002";20;7;20;7;9;63
"6066";"360850064003";75;34;174;7;10;300
"6067";"360850067001";3;4;16;2;7;32
"6068";"360850067002";36;87;54;9;19;205
"6069";"360850067003";14;2;26;7;5;54
"6070";"360850070001";111;51;213;23;35;433
"6071";"360850070002";64;3;139;9;30;245
"6072";"360850070003";59;8;60;15;17;159
"6073";"360850070004";18;11;137;14;22;202
"6074";"360850074001";55;20;82;12;11;180
"6075";"360850074002";109;22;199;7;48;385
"6076";"360850075001";49;3;119;13;6;190
"6077";"360850075002";20;10;72;13;8;123
"6078";"360850075003";65;19;78;17;10;189
"6079";"360850077001";124;46;43;24;11;248
"6080";"360850081001";55;146;93;22;32;348
"6081";"360850081002";62;2;28;9;6;107
"6082";"360850081003";119;17;83;11;31;261
"6083";"360850096011";8;4;49;13;8;82
"6084";"360850096012";26;13;103;6;20;168
"6085";"360850096021";60;6;86;2;16;170
"6086";"360850096022";34;10;55;3;24;126
"6087";"360850096023";50;7;49;4;5;115
"6088";"360850097001";55;12;66;11;8;152
"6089";"360850097002";14;1;28;13;9;65
"6090";"360850097003";9;25;36;1;8;79
"6091";"360850105001";11;1;41;15;11;79
"6092";"360850105002";27;9;22;1;10;69
"6093";"360850105003";52;12;72;5;13;154
"6094";"360850105004";39;7;223;8;26;303
"6095";"360850105005";62;19;70;42;20;213
"6096";"360850112011";24;36;170;12;35;277
"6097";"360850112012";70;25;90;11;77;273
"6098";"360850112021";39;12;77;6;19;153
"6099";"360850112022";62;13;92;11;47;225
"6100";"360850112023";13;15;68;3;31;130
"6101";"360850112024";0;4;0;0;1;5
"6102";"360850114011";11;3;50;1;12;77
"6103";"360850114012";341;5;73;5;13;437
"6104";"360850114021";13;3;27;3;6;52
"6105";"360850114022";108;4;91;0;8;211
"6106";"360850114023";15;1;29;5;9;59
"6107";"360850121001";14;1;31;3;7;56
"6108";"360850121002";10;0;23;2;3;38
"6109";"360850121003";8;37;40;0;11;96
"6110";"360850122001";7;0;14;1;7;29
"6111";"360850122002";36;20;32;5;32;125
"6112";"360850122003";14;9;32;5;17;77
"6113";"360850122004";41;53;43;4;14;155
"6114";"360850125001";78;1;100;17;28;224
"6115";"360850125002";40;6;35;3;6;90
"6116";"360850125003";10;0;34;8;15;67
"6117";"360850128041";165;81;140;11;69;466
"6118";"360850128042";174;131;341;9;62;717
"6119";"360850128051";21;7;75;5;35;143
"6120";"360850128061";15;2;12;5;12;46
"6121";"360850128062";3;2;11;4;1;21
"6122";"360850128063";131;17;25;5;37;215
"6123";"360850128064";53;21;60;6;18;158
"6124";"360850132011";10;3;20;2;5;40
"6125";"360850132012";16;0;15;0;11;42
"6126";"360850132031";13;2;42;1;17;75
"6127";"360850132032";7;1;114;3;15;140
"6128";"360850132033";24;27;49;0;40;140
"6129";"360850132041";20;6;55;2;14;97
"6130";"360850132042";17;1;62;5;14;99
"6131";"360850132043";14;3;15;3;13;48
"6132";"360850133011";203;10;14;6;3;236
"6133";"360850133021";10;16;59;27;9;121
"6134";"360850133022";58;17;63;13;24;175
"6135";"360850133023";94;14;120;25;32;285
"6136";"360850134001";34;10;84;4;19;151
"6137";"360850134002";3;11;45;6;18;83
"6138";"360850134003";37;3;56;8;15;119
"6139";"360850138001";10;1;22;1;14;48
"6140";"360850138002";22;5;15;4;17;63
"6141";"360850138003";9;1;69;3;32;114
"6142";"360850138004";10;2;39;1;5;57
"6143";"360850138005";58;10;62;6;10;146
"6144";"360850141001";48;13;69;9;23;162
"6145";"360850141002";49;19;71;14;7;160
"6146";"360850146041";7;0;18;1;14;40
"6147";"360850146042";142;68;43;8;66;327
"6148";"360850146043";11;3;39;4;10;67
"6149";"360850146044";6;28;62;7;33;136
"6150";"360850146051";14;11;48;4;14;91
"6151";"360850146052";10;16;33;1;27;87
"6152";"360850146061";19;7;141;1;29;197
"6153";"360850146062";8;6;59;2;20;95
"6154";"360850146063";18;10;84;1;15;128
"6155";"360850146064";4;0;189;3;15;211
"6156";"360850146071";86;91;112;5;39;333
"6157";"360850146072";15;6;39;1;18;79
"6158";"360850146081";18;12;106;5;17;158
"6159";"360850146082";12;28;86;5;27;158
"6160";"360850147001";5;4;11;4;10;34
"6161";"360850147002";21;25;99;1;43;189
"6162";"360850147003";11;1;75;7;20;114
"6163";"360850151001";24;10;152;22;26;234
"6164";"360850151002";4;0;15;0;5;24
"6165";"360850151003";6;2;4;0;2;14
"6166";"360850151004";21;1;13;2;6;43
"6167";"360850151005";11;9;108;6;11;145
"6168";"360850154001";0;1;2;0;3;6
"6169";"360850156011";20;12;24;6;17;79
"6170";"360850156012";4;1;9;1;3;18
"6171";"360850156013";19;4;32;2;5;62
"6172";"360850156014";11;4;27;0;19;61
"6173";"360850156015";22;4;17;0;10;53
"6174";"360850156016";40;21;23;1;8;93
"6175";"360850156021";5;3;4;0;3;15
"6176";"360850156022";8;2;10;1;3;24
"6177";"360850156023";2;2;15;0;10;29
"6178";"360850156024";5;0;4;0;2;11
"6179";"360850156031";2;2;52;1;7;64
"6180";"360850156032";110;69;63;5;13;260
"6181";"360850156033";31;48;28;11;14;132
"6182";"360850169011";22;6;51;8;23;110
"6183";"360850169012";24;14;81;7;12;138
"6184";"360850170051";11;2;89;0;91;193
"6185";"360850170052";16;12;55;8;27;118
"6186";"360850170071";45;9;96;1;22;173
"6187";"360850170072";44;24;51;3;6;128
"6188";"360850170081";27;5;67;2;85;186
"6189";"360850170082";24;22;265;4;76;391
"6190";"360850170083";25;13;150;8;27;223
"6191";"360850170091";7;1;12;0;12;32
"6192";"360850170092";6;1;12;1;82;102
"6193";"360850170093";15;2;21;1;12;51
"6194";"360850170101";16;2;153;0;74;245
"6195";"360850170102";49;9;363;9;65;495
"6196";"360850170103";28;5;292;5;26;356
"6197";"360850170104";12;5;53;3;18;91
"6198";"360850170111";24;14;37;6;31;112
"6199";"360850170112";40;15;44;4;24;127
"6200";"360850170121";67;128;222;4;46;467
"6201";"360850170122";27;4;49;5;7;92
"6202";"360850170123";18;2;65;0;7;92
"6203";"360850173001";3;3;29;3;8;46
"6204";"360850173002";184;12;17;2;5;220
"6205";"360850176001";27;5;136;3;17;188
"6206";"360850176002";4;5;10;1;6;26
"6207";"360850176003";34;2;60;4;38;138
"6208";"360850176004";16;2;27;2;17;64
"6209";"360850177001";13;3;11;1;11;39
"6210";"360850177002";20;6;31;1;9;67
"6211";"360850177003";15;5;23;3;18;64
"6212";"360850177004";46;46;26;0;6;124
"6213";"360850177005";11;4;115;3;8;141
"6214";"360850177006";0;1;11;0;2;14
"6215";"360850181001";6;0;47;0;2;55
"6216";"360850181002";19;8;26;0;30;83
"6217";"360850181003";7;14;34;0;3;58
"6218";"360850187011";242;3;38;2;35;320
"6219";"360850187012";17;2;43;3;9;74
"6220";"360850187021";35;13;94;3;11;156
"6221";"360850187022";58;8;60;10;9;145
"6222";"360850187023";6;13;92;4;6;121
"6223";"360850187024";44;12;101;5;16;178
"6224";"360850189011";89;20;126;10;48;293
"6225";"360850189012";182;12;111;15;25;345
"6226";"360850189021";6;3;37;2;5;53
"6227";"360850189022";26;17;35;3;7;88
"6228";"360850189023";48;18;83;6;10;165
"6229";"360850197001";7;6;11;3;5;32
"6230";"360850197002";46;1;36;1;7;91
"6231";"360850198001";3;1;2;0;4;10
"6232";"360850198002";78;13;85;4;29;209
"6233";"360850198003";13;2;72;2;38;127
"6234";"360850198004";30;32;74;4;43;183
"6235";"360850201001";46;10;145;15;18;234
"6236";"360850201002";22;44;49;1;13;129
"6237";"360850201003";21;24;15;7;21;88
"6238";"360850207001";151;24;357;54;61;647
"6239";"360850207002";57;14;122;11;27;231
"6240";"360850207003";43;24;60;6;44;177
"6241";"360850207004";160;29;72;28;43;332
"6242";"360850208011";35;16;71;10;18;150
"6243";"360850208012";63;8;66;4;11;152
"6244";"360850208013";12;11;114;2;26;165
"6245";"360850208014";73;68;134;2;44;321
"6246";"360850208031";43;4;312;6;23;388
"6247";"360850208032";32;23;166;8;29;258
"6248";"360850208033";25;9;30;0;29;93
"6249";"360850208041";39;3;189;3;71;305
"6250";"360850208042";22;4;63;2;58;149
"6251";"360850208043";9;2;41;2;184;238
"6252";"360850213001";36;26;101;8;20;191
"6253";"360850213002";19;20;30;2;7;78
"6254";"360850213003";53;46;77;7;30;213
"6255";"360850213004";22;7;41;10;15;95
"6256";"360850213005";31;12;104;8;13;168
"6257";"360850223001";87;13;79;22;21;222
"6258";"360850223002";30;12;101;29;15;187
"6259";"360850226001";17;22;57;44;249;389
"6260";"360850226002";23;8;111;8;39;189
"6261";"360850226003";29;3;101;9;49;191
"6262";"360850226004";34;25;117;12;164;352
"6263";"360850228001";8;30;77;2;376;493
"6264";"360850231001";134;27;81;8;33;283
"6265";"360850231002";37;8;64;10;12;131
"6266";"360850239001";70;42;119;27;19;277
"6267";"360850239002";35;19;104;6;6;170
"6268";"360850244011";45;11;39;3;17;115
"6269";"360850244012";49;23;66;4;37;179
"6270";"360850244013";37;59;121;7;36;260
"6271";"360850244021";68;5;69;1;33;176
"6272";"360850244022";25;18;73;1;20;137
"6273";"360850247001";24;2;89;3;22;140
"6274";"360850247002";54;19;36;5;18;132
"6275";"360850248001";52;11;97;8;19;187
"6276";"360850248002";38;1;46;1;11;97
"6277";"360850248003";45;282;78;0;73;478
"6278";"360850251001";27;28;40;4;57;156
"6279";"360850251002";7;61;25;0;5;98
"6280";"360850251003";19;8;54;4;24;109
"6281";"360850273011";13;4;40;1;10;68
"6282";"360850273012";44;14;88;12;32;190
"6283";"360850273021";45;4;248;6;29;332
"6284";"360850273022";21;2;17;1;10;51
"6285";"360850277021";44;2;91;18;11;166
"6286";"360850277022";33;22;200;3;83;341
"6287";"360850277023";22;13;112;6;18;171
"6288";"360850277041";83;5;125;4;15;232
"6289";"360850277042";15;2;68;7;16;108
"6290";"360850277051";48;15;112;6;15;196
"6291";"360850277052";38;5;67;1;28;139
"6292";"360850277053";29;15;79;10;28;161
"6293";"360850277061";19;33;49;7;25;133
"6294";"360850277062";26;7;15;0;21;69
"6295";"360850277063";3;3;31;2;52;91
"6296";"360850279001";13;8;15;0;40;76
"6297";"360850279002";6;1;3;0;19;29
"6298";"360850291021";25;50;152;4;15;246
"6299";"360850291022";57;40;247;8;152;504
"6300";"360850291031";27;46;131;17;46;267
"6301";"360850291032";4;4;14;0;4;26
"6302";"360850291033";31;32;46;4;6;119
"6303";"360850291034";21;1;31;1;15;69
"6304";"360850291035";28;2;34;2;12;78
"6305";"360850291041";24;5;82;16;9;136
"6306";"360850291042";33;15;138;6;23;215
"6307";"360850291043";15;2;23;7;13;60
"6308";"360850291044";32;32;102;1;27;194
"6309";"360850303011";103;10;174;13;20;320
"6310";"360850303012";25;2;86;10;34;157
"6311";"360850303021";88;6;60;8;13;175
"6312";"360850303022";75;8;192;6;11;292
"6313";"360850303023";32;10;43;7;9;101
"6314";"360850303024";17;4;109;3;14;147
"6315";"360850319011";58;24;8;3;5;98
"6316";"360850319012";23;8;52;6;13;102
"6317";"360850319021";18;1;16;5;6;46
"6318";"360850319022";89;17;66;22;12;206
"6319";"360850319023";82;7;70;19;11;189
"6320";"360850323001";113;42;77;14;8;254
"6321";"361190002031";2;0;19;1;0;22
"6322";"361190015031";0;1;2;0;1;4
"6323";"361190015043";0;5;0;1;0;6
"6324";"361190026001";0;0;4;0;0;4
"6325";"361190026002";3;4;11;10;1;29
"6326";"361190026003";3;1;4;0;0;8
"6327";"361190029002";0;0;1;1;0;2
"6328";"361190030002";0;1;6;2;0;9
"6329";"361190035002";0;0;2;3;0;5
