"";"Data";"0";"1";"3";"4";"5";"sum"
"1";"360050001001";0;0;2;0;4;6
"2";"360050002001";80;40;142;32;48;342
"3";"360050002002";121;20;127;81;57;406
"4";"360050002003";44;6;37;35;32;154
"5";"360050004001";17;4;74;16;46;157
"6";"360050004002";77;16;245;42;34;414
"7";"360050004003";20;30;56;23;21;150
"8";"360050004004";18;3;14;14;3;52
"9";"360050016001";45;18;6;0;8;77
"10";"360050016002";15;3;88;21;11;138
"11";"360050016003";19;1;4;0;5;29
"12";"360050016004";40;15;61;46;35;197
"13";"360050019001";82;46;95;14;60;297
"14";"360050019002";2;2;17;47;11;79
"15";"360050019003";6;20;178;22;85;311
"16";"360050019004";68;7;15;5;9;104
"17";"360050019005";0;1;0;0;0;1
"18";"360050020001";61;15;115;20;31;242
"19";"360050020002";129;17;98;14;25;283
"20";"360050020003";76;9;4;7;9;105
"21";"360050020004";27;4;0;1;1;33
"22";"360050020005";128;1;7;2;3;141
"23";"360050020006";36;7;51;10;30;134
"24";"360050023001";300;21;4;2;11;338
"25";"360050023002";6;2;2;0;1;11
"26";"360050023003";79;4;2;1;6;92
"27";"360050024000";3;1;1;0;0;5
"28";"360050024001";2;27;1;1;9;40
"29";"360050025001";155;45;2;0;18;220
"30";"360050025002";131;12;0;0;5;148
"31";"360050025003";16;7;7;0;13;43
"32";"360050025004";106;11;5;0;5;127
"33";"360050025005";32;22;5;2;17;78
"34";"360050027011";61;6;26;0;9;102
"35";"360050027012";103;10;28;1;6;148
"36";"360050027021";32;11;34;20;18;115
"37";"360050027022";18;5;26;0;7;56
"38";"360050027023";36;22;21;0;18;97
"39";"360050027024";48;12;9;3;7;79
"40";"360050028001";77;25;48;3;21;174
"41";"360050028002";22;35;2;0;12;71
"42";"360050028003";5;0;2;0;0;7
"43";"360050028004";87;32;21;0;6;146
"44";"360050031001";134;51;34;14;28;261
"45";"360050033001";14;6;17;10;23;70
"46";"360050033002";44;7;8;6;14;79
"47";"360050033003";55;68;15;1;14;153
"48";"360050035001";30;24;37;4;35;130
"49";"360050035002";182;67;7;0;2;258
"50";"360050035003";61;34;27;2;29;153
"51";"360050037001";12;13;7;2;5;39
"52";"360050038001";157;5;46;34;30;272
"53";"360050039001";48;5;17;0;15;85
"54";"360050039002";57;33;15;90;30;225
"55";"360050039003";38;27;17;2;46;130
"56";"360050039004";47;15;30;3;21;116
"57";"360050039005";78;22;75;1;31;207
"58";"360050040011";25;16;93;14;39;187
"59";"360050041001";156;19;9;1;12;197
"60";"360050041002";99;9;65;3;35;211
"61";"360050041003";1;0;9;1;3;14
"62";"360050041004";88;41;15;3;24;171
"63";"360050042001";21;1;2;0;0;24
"64";"360050042002";99;2;3;0;3;107
"65";"360050042003";17;4;15;0;3;39
"66";"360050042004";4;4;4;0;1;13
"67";"360050042005";26;10;20;4;7;67
"68";"360050042006";0;4;12;0;4;20
"69";"360050042007";45;5;1;0;1;52
"70";"360050043001";105;79;22;13;22;241
"71";"360050043002";41;21;39;2;32;135
"72";"360050043003";203;25;20;1;15;264
"73";"360050043004";124;24;64;1;9;222
"74";"360050044001";32;7;3;0;9;51
"75";"360050044002";16;4;0;0;1;21
"76";"360050044003";32;5;39;3;16;95
"77";"360050044004";36;14;5;1;6;62
"78";"360050046001";158;17;23;8;19;225
"79";"360050048001";269;71;12;0;33;385
"80";"360050048002";134;24;57;1;27;243
"81";"360050050011";63;15;41;1;10;130
"82";"360050050012";246;28;9;0;123;406
"83";"360050050013";54;53;23;2;18;150
"84";"360050050014";53;10;8;0;17;88
"85";"360050050021";105;14;26;7;38;190
"86";"360050050022";58;20;66;0;6;150
"87";"360050050023";48;5;8;0;20;81
"88";"360050050024";69;14;6;0;15;104
"89";"360050051001";17;12;63;7;29;128
"90";"360050051002";229;15;105;6;28;383
"91";"360050051003";144;5;0;0;2;151
"92";"360050052001";17;2;99;34;26;178
"93";"360050052002";149;19;16;6;16;206
"94";"360050053001";168;4;1;0;10;183
"95";"360050053002";0;0;3;0;0;3
"96";"360050054001";66;4;76;1;26;173
"97";"360050054002";106;35;104;1;50;296
"98";"360050054003";38;26;68;4;23;159
"99";"360050054004";133;51;7;1;18;210
"100";"360050056001";123;12;45;1;9;190
"101";"360050056002";12;6;13;7;1;39
"102";"360050056003";19;19;64;6;31;139
"103";"360050059021";35;11;9;0;10;65
"104";"360050059022";9;12;52;0;5;78
"105";"360050060001";101;92;41;3;24;261
"106";"360050061001";1;0;16;0;1;18
"107";"360050061002";50;8;2;3;2;65
"108";"360050061003";0;6;19;0;4;29
"109";"360050062001";100;40;36;0;18;194
"110";"360050062002";102;3;14;1;7;127
"111";"360050062003";97;11;12;2;18;140
"112";"360050062004";89;9;47;1;16;162
"113";"360050062005";3;1;5;1;1;11
"114";"360050063001";40;37;15;1;16;109
"115";"360050063002";42;146;77;25;41;331
"116";"360050063003";65;64;27;0;26;182
"117";"360050063004";21;81;0;0;11;113
"118";"360050063005";147;81;3;0;18;249
"119";"360050063006";413;305;26;1;44;789
"120";"360050064001";78;11;66;6;36;197
"121";"360050064002";26;7;11;3;6;53
"122";"360050064003";21;2;19;2;6;50
"123";"360050064004";61;22;45;3;17;148
"124";"360050065001";71;36;40;4;31;182
"125";"360050065002";81;14;20;1;15;131
"126";"360050065003";41;5;17;3;9;75
"127";"360050065004";49;41;20;3;20;133
"128";"360050067001";196;93;31;0;13;333
"129";"360050067002";111;43;23;1;13;191
"130";"360050067003";95;22;4;0;3;124
"131";"360050067004";73;5;3;1;8;90
"132";"360050067005";23;8;1;1;4;37
"133";"360050067006";44;13;34;7;6;104
"134";"360050068001";51;18;39;2;19;129
"135";"360050068002";22;6;20;2;21;71
"136";"360050068003";129;63;71;6;27;296
"137";"360050069001";99;90;44;3;22;258
"138";"360050069002";353;39;61;7;46;506
"139";"360050069003";20;7;1;0;0;28
"140";"360050069004";28;0;2;0;0;30
"141";"360050070001";178;24;89;3;36;330
"142";"360050070002";49;1353;64;1;23;1490
"143";"360050070003";264;209;55;0;29;557
"144";"360050071001";26;13;41;1;11;92
"145";"360050071002";272;86;40;3;41;442
"146";"360050072001";76;21;45;1;22;165
"147";"360050072002";71;27;43;5;32;178
"148";"360050072003";53;16;26;0;31;126
"149";"360050072004";11;10;57;0;20;98
"150";"360050073001";82;11;18;2;14;127
"151";"360050073002";150;7;5;2;15;179
"152";"360050073003";49;24;24;10;29;136
"153";"360050074001";71;10;54;22;12;169
"154";"360050074002";28;6;27;28;32;121
"155";"360050074003";20;3;2;1;9;35
"156";"360050075001";162;5;68;21;21;277
"157";"360050075002";160;53;51;7;23;294
"158";"360050075003";118;1;11;0;9;139
"159";"360050075004";44;13;1;0;6;64
"160";"360050076001";15;0;7;1;5;28
"161";"360050076002";102;15;64;3;46;230
"162";"360050076003";31;2;36;1;7;77
"163";"360050076004";100;15;88;6;28;237
"164";"360050076005";21;8;69;3;27;128
"165";"360050077001";52;43;76;9;29;209
"166";"360050078001";53;22;107;2;36;220
"167";"360050078002";270;15;234;11;91;621
"168";"360050078003";47;37;19;1;7;111
"169";"360050078004";136;9;39;0;20;204
"170";"360050079001";167;28;11;3;24;233
"171";"360050079002";60;25;5;3;14;107
"172";"360050079003";31;1;6;4;12;54
"173";"360050079004";53;13;15;1;6;88
"174";"360050079005";22;2;3;0;5;32
"175";"360050079006";34;3;3;0;4;44
"176";"360050083001";98;21;18;0;13;150
"177";"360050083002";9;5;13;6;7;40
"178";"360050083003";50;5;29;5;11;100
"179";"360050083004";62;26;47;0;15;150
"180";"360050083005";30;12;19;1;19;81
"181";"360050083006";85;35;140;10;14;284
"182";"360050084001";11;1;18;4;6;40
"183";"360050084002";73;3;107;25;43;251
"184";"360050085001";58;28;53;5;16;160
"185";"360050085002";45;29;76;2;23;175
"186";"360050085003";20;4;22;1;9;56
"187";"360050085004";16;3;0;0;0;19
"188";"360050085005";115;1;5;3;4;128
"189";"360050086001";4;2;27;33;7;73
"190";"360050086002";57;2;2;1;2;64
"191";"360050086003";74;1;1;0;3;79
"192";"360050087001";45;16;10;3;14;88
"193";"360050087002";118;30;8;1;5;162
"194";"360050087003";53;8;21;0;8;90
"195";"360050087004";41;13;4;0;2;60
"196";"360050087005";97;18;5;1;34;155
"197";"360050089001";29;7;14;1;17;68
"198";"360050089002";33;3;16;1;15;68
"199";"360050090001";3;1;28;5;7;44
"200";"360050090002";4;22;33;13;24;96
"201";"360050090003";42;7;2;0;5;56
"202";"360050090004";22;2;93;42;23;182
"203";"360050090005";75;6;1;4;3;89
"204";"360050092001";30;5;19;4;20;78
"205";"360050092002";120;25;32;2;15;194
"206";"360050092003";94;31;68;4;33;230
"207";"360050092004";13;57;24;3;27;124
"208";"360050092005";76;11;51;2;13;153
"209";"360050093001";11;2;35;17;39;104
"210";"360050093002";88;27;65;4;43;227
"211";"360050093003";68;22;25;2;21;138
"212";"360050093004";347;31;31;4;20;433
"213";"360050093005";110;19;65;43;30;267
"214";"360050093006";2;41;129;86;86;344
"215";"360050096001";54;7;87;5;43;196
"216";"360050096002";36;30;101;43;56;266
"217";"360050098001";86;93;58;6;41;284
"218";"360050098002";95;8;28;3;9;143
"219";"360050098003";126;12;42;13;35;228
"220";"360050098004";9;13;57;3;9;91
"221";"360050098005";90;8;21;0;19;138
"222";"360050110001";24;5;37;16;13;95
"223";"360050115021";195;6;53;10;84;348
"224";"360050115022";332;22;37;4;38;433
"225";"360050115023";34;15;31;3;22;105
"226";"360050117001";240;31;18;3;26;318
"227";"360050117002";0;0;17;11;9;37
"228";"360050118000";0;0;1;0;0;1
"229";"360050118001";8;1;101;26;25;161
"230";"360050118002";8;4;219;7;9;247
"231";"360050118003";47;15;64;19;34;179
"232";"360050119001";80;55;5;0;49;189
"233";"360050119002";79;14;25;1;5;124
"234";"360050119003";52;2;34;0;6;94
"235";"360050119004";99;5;12;2;25;143
"236";"360050119005";249;14;5;3;12;283
"237";"360050121011";82;31;25;0;15;153
"238";"360050121012";82;38;54;6;17;197
"239";"360050121021";77;18;26;10;32;163
"240";"360050123001";161;23;40;4;27;255
"241";"360050123002";46;17;38;2;20;123
"242";"360050123003";53;7;21;15;19;115
"243";"360050125001";137;40;87;4;57;325
"244";"360050125002";69;165;78;7;24;343
"245";"360050127011";30;20;15;0;21;86
"246";"360050127012";66;8;8;0;14;96
"247";"360050129011";25;12;29;7;54;127
"248";"360050129012";175;179;46;0;40;440
"249";"360050130001";31;5;48;27;13;124
"250";"360050131001";63;37;13;0;9;122
"251";"360050131002";85;19;68;9;25;206
"252";"360050131003";61;14;57;13;28;173
"253";"360050132001";88;5;157;31;33;314
"254";"360050132002";152;10;57;26;13;258
"255";"360050132003";28;6;59;28;44;165
"256";"360050132004";49;18;97;18;46;228
"257";"360050132005";62;4;45;15;28;154
"258";"360050133001";67;18;3;0;5;93
"259";"360050133002";78;24;27;0;17;146
"260";"360050133003";19;9;1;0;2;31
"261";"360050133004";117;0;29;0;1;147
"262";"360050135001";117;34;36;0;45;232
"263";"360050135002";50;17;7;0;6;80
"264";"360050135003";130;16;72;2;23;243
"265";"360050138001";26;57;52;52;18;205
"266";"360050138002";38;6;90;25;17;176
"267";"360050141001";102;47;61;1;7;218
"268";"360050141002";139;29;10;0;17;195
"269";"360050141003";109;24;30;10;17;190
"270";"360050143001";104;9;48;8;27;196
"271";"360050144001";9;1;3;0;2;15
"272";"360050144002";22;0;2;0;2;26
"273";"360050144003";30;1;3;0;3;37
"274";"360050144004";49;0;1;0;1;51
"275";"360050144005";80;11;91;25;16;223
"276";"360050144006";141;3;63;11;17;235
"277";"360050145001";597;22;23;4;25;671
"278";"360050145002";74;9;7;0;10;100
"279";"360050145003";25;5;59;10;19;118
"280";"360050145004";178;13;44;14;18;267
"281";"360050147011";76;12;5;2;6;101
"282";"360050147012";43;32;49;0;15;139
"283";"360050147013";76;54;66;0;2;198
"284";"360050147021";49;2;20;0;5;76
"285";"360050147022";68;15;35;1;4;123
"286";"360050147023";36;14;1;0;4;55
"287";"360050147024";10;1;2;3;0;16
"288";"360050149001";77;10;70;1;18;176
"289";"360050149002";54;10;45;0;7;116
"290";"360050149003";99;9;37;0;25;170
"291";"360050151001";36;9;15;1;15;76
"292";"360050151002";53;70;31;3;10;167
"293";"360050151003";45;19;45;2;27;138
"294";"360050151004";151;14;52;23;50;290
"295";"360050152001";75;4;126;21;35;261
"296";"360050152002";53;64;65;21;92;295
"297";"360050153001";159;82;81;8;14;344
"298";"360050153002";66;25;8;3;8;110
"299";"360050153003";39;12;46;7;29;133
"300";"360050155001";86;20;11;3;9;129
"301";"360050155002";39;4;15;6;23;87
"302";"360050157001";188;44;58;0;20;310
"303";"360050157002";103;14;27;4;21;169
"304";"360050157003";178;18;66;3;23;288
"305";"360050158001";148;22;151;43;27;391
"306";"360050159001";110;14;16;4;20;164
"307";"360050159002";152;7;10;3;8;180
"308";"360050160001";51;5;141;33;50;280
"309";"360050160002";2;3;19;5;10;39
"310";"360050160003";5;4;16;9;13;47
"311";"360050160004";23;0;80;9;9;121
"312";"360050161001";44;21;7;3;9;84
"313";"360050161002";54;53;15;6;7;135
"314";"360050161003";210;20;3;0;6;239
"315";"360050161004";78;157;8;1;16;260
"316";"360050162001";7;0;37;5;16;65
"317";"360050162002";62;11;144;7;21;245
"318";"360050163001";61;17;17;0;10;105
"319";"360050164001";50;5;33;21;16;125
"320";"360050165001";78;40;45;29;26;218
"321";"360050166001";64;23;94;14;37;232
"322";"360050166002";20;1;63;25;24;133
"323";"360050167001";13;55;25;1;1;95
"324";"360050167002";122;85;49;8;20;284
"325";"360050169001";69;18;45;6;21;159
"326";"360050171001";76;101;27;0;13;217
"327";"360050173001";62;10;44;3;7;126
"328";"360050173002";40;7;23;0;27;97
"329";"360050173003";45;33;28;6;21;133
"330";"360050173004";71;44;23;1;6;145
"331";"360050175001";93;22;8;0;17;140
"332";"360050175002";134;6;1;1;8;150
"333";"360050175003";137;37;0;0;4;178
"334";"360050175004";246;27;36;4;16;329
"335";"360050175005";38;8;2;1;7;56
"336";"360050175006";113;6;14;0;3;136
"337";"360050177011";125;37;82;2;22;268
"338";"360050177012";69;11;4;1;16;101
"339";"360050177013";99;21;18;2;17;157
"340";"360050177021";53;1;59;0;7;120
"341";"360050177022";29;15;98;2;33;177
"342";"360050177023";170;261;112;1;24;568
"343";"360050177024";87;44;40;0;11;182
"344";"360050179011";282;353;17;0;30;682
"345";"360050179012";60;9;1;0;4;74
"346";"360050179013";143;20;4;0;11;178
"347";"360050179021";145;67;38;4;11;265
"348";"360050179022";48;41;3;2;5;99
"349";"360050179023";103;81;2;1;6;193
"350";"360050181011";210;29;80;4;31;354
"351";"360050181012";88;10;14;0;4;116
"352";"360050181013";76;22;21;1;4;124
"353";"360050181021";58;21;5;0;7;91
"354";"360050181022";90;51;9;4;5;159
"355";"360050181023";80;55;5;0;7;147
"356";"360050181024";70;14;6;0;7;97
"357";"360050183011";121;34;27;1;6;189
"358";"360050183012";167;47;15;0;6;235
"359";"360050183013";140;29;9;0;4;182
"360";"360050183021";294;99;23;1;16;433
"361";"360050183022";53;55;9;7;7;131
"362";"360050183023";56;22;52;1;7;138
"363";"360050184001";40;1;72;14;10;137
"364";"360050184002";24;10;133;17;47;231
"365";"360050184003";34;19;41;19;31;144
"366";"360050184004";38;102;155;51;21;367
"367";"360050185001";322;22;143;27;45;559
"368";"360050185002";176;7;41;2;8;234
"369";"360050185003";149;18;56;17;28;268
"370";"360050185004";68;16;13;3;8;108
"371";"360050185005";62;13;29;0;10;114
"372";"360050189001";288;30;21;5;18;362
"373";"360050189002";35;11;6;0;4;56
"374";"360050189003";582;116;59;5;126;888
"375";"360050189004";232;54;159;8;37;490
"376";"360050193001";322;64;26;3;18;433
"377";"360050193002";63;11;2;0;2;78
"378";"360050193003";65;4;8;0;7;84
"379";"360050193004";132;51;120;2;20;325
"380";"360050194001";87;39;153;41;64;384
"381";"360050195001";153;40;13;5;32;243
"382";"360050195002";231;274;39;4;52;600
"383";"360050195003";143;24;20;1;9;197
"384";"360050195004";102;28;9;0;6;145
"385";"360050197001";115;17;6;0;12;150
"386";"360050197002";328;29;12;0;12;381
"387";"360050197003";90;20;6;7;30;153
"388";"360050197004";13;9;1;1;9;33
"389";"360050197005";329;11;4;0;5;349
"390";"360050199001";48;19;8;0;13;88
"391";"360050199002";125;108;3;0;10;246
"392";"360050199003";20;23;67;0;9;119
"393";"360050199004";149;14;47;8;21;239
"394";"360050199005";63;13;11;0;4;91
"395";"360050199006";99;29;113;3;13;257
"396";"360050200001";50;10;46;1;36;143
"397";"360050200002";15;63;51;21;13;163
"398";"360050200003";32;7;52;16;48;155
"399";"360050200004";50;18;27;0;19;114
"400";"360050201001";53;49;37;6;15;160
"401";"360050201002";176;31;24;6;10;247
"402";"360050201003";124;22;27;7;8;188
"403";"360050202001";40;8;67;3;8;126
"404";"360050202002";80;10;58;2;65;215
"405";"360050204001";61;13;45;0;21;140
"406";"360050204002";13;9;53;3;12;90
"407";"360050204003";61;87;57;2;23;230
"408";"360050205011";130;28;14;6;27;205
"409";"360050205012";142;30;52;2;16;242
"410";"360050205013";196;29;59;2;11;297
"411";"360050205014";75;21;123;26;4;249
"412";"360050205021";57;20;48;5;10;140
"413";"360050205022";33;6;86;2;7;134
"414";"360050205023";24;9;87;4;15;139
"415";"360050206011";119;29;44;0;45;237
"416";"360050206012";25;7;163;12;36;243
"417";"360050209001";53;11;72;5;11;152
"418";"360050209002";80;55;7;1;4;147
"419";"360050209003";70;14;3;2;6;95
"420";"360050209004";232;33;48;2;7;322
"421";"360050210011";8;3;8;0;1;20
"422";"360050210012";12;0;2;0;7;21
"423";"360050210013";3;3;1;2;0;9
"424";"360050210014";4;3;8;0;5;20
"425";"360050210015";37;2;4;0;2;45
"426";"360050210016";123;1;3;1;4;132
"427";"360050210021";12;4;4;0;1;21
"428";"360050210022";82;4;5;0;2;93
"429";"360050210024";0;0;1;0;0;1
"430";"360050210025";17;2;2;0;2;23
"431";"360050210026";16;2;1;0;4;23
"432";"360050210027";14;0;0;0;0;14
"433";"360050210028";0;0;4;0;0;4
"434";"360050211001";95;12;114;0;14;235
"435";"360050211002";62;32;30;12;16;152
"436";"360050211003";46;16;21;1;10;94
"437";"360050211004";60;7;15;0;1;83
"438";"360050212001";2;0;3;0;1;6
"439";"360050212002";3;0;1;0;0;4
"440";"360050212004";8;2;6;0;1;17
"441";"360050212005";4;0;0;0;1;5
"442";"360050213011";3;2;11;2;1;19
"443";"360050213012";28;65;35;8;13;149
"444";"360050213021";67;27;90;11;27;222
"445";"360050213022";22;10;34;0;14;80
"446";"360050213023";11;4;18;1;3;37
"447";"360050213024";79;17;27;5;9;137
"448";"360050215011";26;16;6;1;3;52
"449";"360050215012";300;43;42;7;10;402
"450";"360050215013";51;11;105;1;4;172
"451";"360050215021";132;37;39;6;9;223
"452";"360050215022";81;28;71;2;12;194
"453";"360050215023";86;12;187;3;6;294
"454";"360050215024";31;12;30;0;4;77
"455";"360050215025";84;9;21;1;4;119
"456";"360050216011";81;6;59;6;33;185
"457";"360050216012";65;14;115;2;17;213
"458";"360050216013";54;4;4;1;8;71
"459";"360050216014";80;4;29;4;7;124
"460";"360050216021";26;8;32;2;14;82
"461";"360050216022";5;3;8;0;2;18
"462";"360050216023";148;2;7;2;2;161
"463";"360050216024";12;7;12;1;11;43
"464";"360050216025";16;15;12;1;9;53
"465";"360050217001";97;88;172;14;32;403
"466";"360050217002";264;36;4;1;35;340
"467";"360050217003";1;8;31;15;24;79
"468";"360050217004";74;29;22;1;9;135
"469";"360050218001";102;17;3;0;10;132
"470";"360050218002";218;24;52;2;14;310
"471";"360050218003";232;31;120;11;36;430
"472";"360050218004";82;2;46;21;19;170
"473";"360050218005";148;4;6;4;17;179
"474";"360050219001";243;124;131;58;36;592
"475";"360050220001";119;22;74;18;33;266
"476";"360050221011";111;10;4;1;2;128
"477";"360050221012";51;33;10;0;17;111
"478";"360050221013";105;61;26;6;9;207
"479";"360050221021";97;114;4;2;22;239
"480";"360050221022";43;25;0;2;4;74
"481";"360050221023";328;26;13;1;23;391
"482";"360050222001";69;21;74;2;12;178
"483";"360050222002";58;5;35;0;19;117
"484";"360050222003";32;16;79;1;28;156
"485";"360050222004";22;10;17;0;20;69
"486";"360050223001";71;216;9;15;10;321
"487";"360050223002";116;186;16;0;12;330
"488";"360050223003";129;22;2;2;5;160
"489";"360050223004";37;14;2;0;18;71
"490";"360050224011";78;5;1;0;6;90
"491";"360050224012";136;19;30;1;18;204
"492";"360050224031";89;45;8;3;29;174
"493";"360050224032";153;44;18;4;61;280
"494";"360050224041";46;25;12;0;26;109
"495";"360050224042";238;21;8;1;11;279
"496";"360050224043";135;30;30;0;16;211
"497";"360050225001";218;38;7;5;16;284
"498";"360050225002";97;61;49;2;22;231
"499";"360050225003";59;62;5;2;17;145
"500";"360050225004";77;26;6;1;5;115
"501";"360050225005";65;21;0;1;9;96
"502";"360050225006";26;14;4;0;7;51
"503";"360050227011";41;22;12;3;10;88
"504";"360050227012";118;58;21;2;17;216
"505";"360050227013";67;48;102;13;17;247
"506";"360050227021";191;19;17;6;19;252
"507";"360050227031";132;39;35;2;8;216
"508";"360050228001";42;17;121;2;25;207
"509";"360050228002";176;13;85;1;19;294
"510";"360050228003";331;49;6;0;16;402
"511";"360050228004";133;10;7;0;5;155
"512";"360050229011";314;36;7;1;19;377
"513";"360050229012";96;14;17;2;14;143
"514";"360050229013";69;134;7;1;12;223
"515";"360050229014";66;16;55;5;7;149
"516";"360050229015";132;158;54;0;19;363
"517";"360050229021";56;54;18;0;13;141
"518";"360050229022";38;199;14;0;18;269
"519";"360050229023";85;181;34;6;9;315
"520";"360050230001";251;16;107;1;49;424
"521";"360050230002";123;6;115;17;53;314
"522";"360050231001";42;16;99;15;33;205
"523";"360050232001";53;30;85;4;45;217
"524";"360050232002";60;20;123;7;40;250
"525";"360050233011";32;22;26;9;19;108
"526";"360050233012";182;115;28;0;32;357
"527";"360050233013";32;12;41;2;16;103
"528";"360050233014";38;1;10;0;5;54
"529";"360050233021";167;41;6;0;19;233
"530";"360050233022";137;61;24;0;12;234
"531";"360050235011";136;45;7;1;47;236
"532";"360050235012";32;1;2;0;3;38
"533";"360050235013";217;22;1;0;3;243
"534";"360050235021";52;31;47;1;7;138
"535";"360050235022";65;12;9;0;7;93
"536";"360050235023";33;2;12;3;16;66
"537";"360050235024";257;8;7;5;15;292
"538";"360050236001";36;23;34;1;34;128
"539";"360050236002";24;14;25;3;38;104
"540";"360050237021";120;23;4;0;19;166
"541";"360050237031";126;21;12;1;33;193
"542";"360050237032";276;11;5;0;202;494
"543";"360050237033";53;20;27;1;9;110
"544";"360050237041";52;29;3;1;17;102
"545";"360050237042";300;12;22;1;18;353
"546";"360050237043";248;12;3;1;11;275
"547";"360050238001";0;25;54;6;25;110
"548";"360050238002";41;21;114;5;29;210
"549";"360050238003";119;11;120;10;54;314
"550";"360050239001";219;130;42;2;46;439
"551";"360050239002";115;100;16;2;27;260
"552";"360050239003";88;14;24;2;16;144
"553";"360050239004";359;42;23;5;40;469
"554";"360050239005";38;19;7;0;8;72
"555";"360050239006";70;7;4;0;6;87
"556";"360050240001";139;30;314;71;95;649
"557";"360050240002";44;8;30;8;11;101
"558";"360050240003";144;31;95;6;50;326
"559";"360050241001";92;55;47;1;22;217
"560";"360050241002";37;18;55;0;24;134
"561";"360050241003";95;12;28;3;10;148
"562";"360050241004";76;21;14;0;22;133
"563";"360050241005";153;13;7;0;10;183
"564";"360050243001";86;67;14;1;17;185
"565";"360050243002";71;26;184;0;9;290
"566";"360050243003";76;1;5;0;6;88
"567";"360050243004";156;40;118;0;18;332
"568";"360050244001";37;8;56;15;20;136
"569";"360050244002";36;12;139;30;46;263
"570";"360050245011";103;21;52;4;7;187
"571";"360050245012";151;48;83;0;15;297
"572";"360050245013";48;15;13;0;6;82
"573";"360050245014";62;11;21;1;4;99
"574";"360050245021";39;17;91;1;7;155
"575";"360050245022";3;7;1;0;2;13
"576";"360050245023";259;63;70;1;15;408
"577";"360050246001";135;1;90;18;13;257
"578";"360050246002";34;10;109;19;19;191
"579";"360050247001";1;1;6;0;1;9
"580";"360050247002";19;0;11;1;3;34
"581";"360050248001";10;5;74;5;17;111
"582";"360050248002";49;7;52;21;22;151
"583";"360050248003";43;3;67;21;22;156
"584";"360050249001";73;19;40;2;7;141
"585";"360050250001";108;8;54;45;49;264
"586";"360050250002";19;2;43;43;39;146
"587";"360050251001";126;24;18;4;7;179
"588";"360050251002";47;35;38;15;6;141
"589";"360050251003";83;28;150;33;11;305
"590";"360050251004";18;2;22;0;7;49
"591";"360050251005";176;44;44;2;19;285
"592";"360050251006";61;27;29;1;7;125
"593";"360050251007";14;3;32;1;0;50
"594";"360050252001";83;11;156;9;39;298
"595";"360050252002";13;3;107;40;13;176
"596";"360050253001";633;6;7;1;23;670
"597";"360050253002";104;22;24;0;6;156
"598";"360050253003";117;8;12;0;7;144
"599";"360050253004";72;6;4;1;16;99
"600";"360050254001";26;21;48;16;23;134
"601";"360050254002";12;15;176;55;33;291
"602";"360050255001";190;40;53;0;86;369
"603";"360050255002";219;262;125;3;21;630
"604";"360050255003";70;72;30;2;19;193
"605";"360050256001";58;14;92;73;23;260
"606";"360050256002";33;37;116;23;43;252
"607";"360050257001";189;18;124;5;13;349
"608";"360050261001";61;43;48;7;22;181
"609";"360050263001";99;64;9;1;21;194
"610";"360050263002";230;35;11;0;11;287
"611";"360050263003";166;74;64;1;16;321
"612";"360050263004";11;13;15;0;1;40
"613";"360050263005";126;25;21;7;11;190
"614";"360050264001";36;8;109;19;40;212
"615";"360050264002";47;3;93;12;11;166
"616";"360050264003";52;10;102;24;57;245
"617";"360050264004";63;4;45;8;22;142
"618";"360050265001";71;52;52;3;38;216
"619";"360050265002";172;156;24;2;19;373
"620";"360050265003";605;56;12;0;19;692
"621";"360050265004";111;32;32;0;21;196
"622";"360050266011";38;5;38;11;14;106
"623";"360050266012";46;9;24;6;23;108
"624";"360050266013";9;5;36;5;13;68
"625";"360050266021";86;7;55;8;24;180
"626";"360050266022";72;11;109;19;47;258
"627";"360050266023";36;43;117;15;52;263
"628";"360050266024";18;1;41;9;10;79
"629";"360050266025";21;3;128;11;35;198
"630";"360050267011";31;5;108;1;2;147
"631";"360050267012";129;29;13;1;7;179
"632";"360050267013";85;26;38;11;19;179
"633";"360050267021";227;18;50;5;25;325
"634";"360050267022";59;1;9;1;6;76
"635";"360050267023";98;6;10;4;9;127
"636";"360050267024";25;5;17;3;13;63
"637";"360050267025";58;4;17;0;8;87
"638";"360050267026";126;21;27;0;17;191
"639";"360050269001";163;99;159;30;18;469
"640";"360050269002";151;15;34;8;6;214
"641";"360050269003";183;5;21;1;9;219
"642";"360050273001";79;62;20;20;10;191
"643";"360050273002";142;47;83;2;18;292
"644";"360050273003";167;7;107;1;21;303
"645";"360050273004";196;49;109;19;30;403
"646";"360050274011";9;8;6;8;6;37
"647";"360050274012";53;5;61;35;20;174
"648";"360050274013";31;5;82;14;120;252
"649";"360050274014";61;2;125;27;33;248
"650";"360050274021";21;37;36;14;12;120
"651";"360050274022";3;2;24;10;13;52
"652";"360050274023";22;8;116;26;42;214
"653";"360050276001";85;14;75;7;20;201
"654";"360050277001";60;32;46;4;13;155
"655";"360050277002";66;6;18;2;19;111
"656";"360050277003";48;11;36;6;10;111
"657";"360050277004";134;16;5;0;6;161
"658";"360050279001";39;8;32;4;10;93
"659";"360050279002";69;12;47;6;15;149
"660";"360050279003";115;5;41;0;16;177
"661";"360050279004";30;7;182;4;13;236
"662";"360050279005";14;4;32;0;0;50
"663";"360050279006";248;8;63;1;16;336
"664";"360050281001";98;19;65;4;8;194
"665";"360050281002";29;4;3;0;3;39
"666";"360050281003";7;4;16;3;6;36
"667";"360050283001";58;45;50;3;27;183
"668";"360050283002";181;9;6;1;7;204
"669";"360050284001";15;65;63;25;46;214
"670";"360050285001";143;29;49;2;25;248
"671";"360050285002";15;8;8;0;4;35
"672";"360050285003";39;40;10;0;6;95
"673";"360050285004";172;16;85;4;20;297
"674";"360050286001";4;4;108;31;18;165
"675";"360050286002";27;28;51;25;21;152
"676";"360050287001";88;26;114;5;40;273
"677";"360050287002";51;6;4;0;0;61
"678";"360050287003";88;43;6;1;23;161
"679";"360050288001";111;5;54;34;10;214
"680";"360050288002";9;3;86;36;13;147
"681";"360050288003";18;3;12;6;3;42
"682";"360050288004";5;1;32;13;4;55
"683";"360050289001";167;26;27;4;22;246
"684";"360050289002";83;14;0;0;4;101
"685";"360050289003";28;22;33;3;24;110
"686";"360050289004";41;17;3;2;3;66
"687";"360050293011";2;0;4;7;4;17
"688";"360050293012";2;4;25;3;3;37
"689";"360050293021";0;14;12;2;6;34
"690";"360050293022";3;3;7;13;7;33
"691";"360050293023";49;4;11;3;11;78
"692";"360050293024";62;10;117;4;22;215
"693";"360050295001";132;30;52;0;20;234
"694";"360050295002";104;71;31;0;24;230
"695";"360050295003";29;3;56;0;1;89
"696";"360050295004";75;9;30;1;19;134
"697";"360050296001";164;22;118;75;28;407
"698";"360050296002";1;4;14;11;14;44
"699";"360050297001";32;4;7;0;12;55
"700";"360050297002";33;12;44;4;10;103
"701";"360050297003";19;1;11;0;1;32
"702";"360050300001";116;6;66;8;35;231
"703";"360050300002";40;4;101;36;44;225
"704";"360050300003";26;48;66;2;12;154
"705";"360050300004";46;3;32;8;9;98
"706";"360050300005";8;4;40;17;2;71
"707";"360050300006";22;1;117;7;11;158
"708";"360050301001";4;3;24;2;3;36
"709";"360050301002";0;0;11;1;2;14
"710";"360050302001";1;0;6;0;1;8
"711";"360050302002";4;1;5;0;0;10
"712";"360050302003";5;1;88;6;5;105
"713";"360050302004";1;0;0;0;0;1
"714";"360050302005";41;3;31;4;2;81
"715";"360050302006";4;0;1;0;1;6
"716";"360050307011";8;1;29;5;5;48
"717";"360050307012";24;3;12;3;0;42
"718";"360050307013";64;7;15;1;10;97
"719";"360050307014";3;4;14;1;1;23
"720";"360050309001";2;2;3;0;1;8
"721";"360050309002";1;5;5;8;11;30
"722";"360050309003";8;3;2;0;2;15
"723";"360050309004";20;56;19;1;6;102
"724";"360050310001";12;6;37;9;15;79
"725";"360050310002";26;18;24;18;11;97
"726";"360050310003";24;4;24;17;25;94
"727";"360050312001";13;0;36;29;24;102
"728";"360050312002";10;5;32;20;20;87
"729";"360050314001";52;5;57;12;6;132
"730";"360050314002";5;3;29;18;13;68
"731";"360050316001";79;7;86;26;22;220
"732";"360050316002";14;5;12;10;75;116
"733";"360050318001";19;11;73;6;5;114
"734";"360050318002";9;5;39;18;14;85
"735";"360050319001";0;0;1;0;0;1
"736";"360050323001";22;1;2;4;0;29
"737";"360050323002";10;1;6;7;3;27
"738";"360050323003";2;2;10;3;4;21
"739";"360050323004";26;4;49;38;8;125
"740";"360050324001";151;3;22;6;9;191
"741";"360050324002";112;55;46;2;32;247
"742";"360050326001";51;9;63;1;25;149
"743";"360050326002";24;8;35;27;31;125
"744";"360050326003";9;0;32;15;8;64
"745";"360050328001";44;15;21;15;18;113
"746";"360050328002";219;14;0;0;5;238
"747";"360050328003";32;23;43;6;14;118
"748";"360050328004";42;4;44;3;9;102
"749";"360050330001";74;24;48;7;32;185
"750";"360050330002";331;19;42;12;22;426
"751";"360050330003";110;6;9;10;30;165
"752";"360050330004";31;7;16;3;8;65
"753";"360050332011";192;7;19;3;21;242
"754";"360050332012";67;5;26;3;24;125
"755";"360050332013";123;8;14;0;22;167
"756";"360050332021";18;5;15;4;16;58
"757";"360050332022";46;7;16;0;13;82
"758";"360050332023";47;3;20;0;8;78
"759";"360050332024";17;8;9;3;2;39
"760";"360050334001";26;53;27;13;27;146
"761";"360050335001";0;1;0;1;2;4
"762";"360050335002";21;30;44;9;9;113
"763";"360050335003";38;34;31;0;3;106
"764";"360050336001";64;3;46;14;13;140
"765";"360050336002";80;35;4;1;32;152
"766";"360050336003";82;22;2;0;5;111
"767";"360050336004";87;2;2;0;4;95
"768";"360050336005";54;11;3;0;12;80
"769";"360050336006";62;17;12;1;24;116
"770";"360050337001";3;5;8;4;4;24
"771";"360050337002";11;4;58;25;14;112
"772";"360050337003";3;10;50;22;19;104
"773";"360050338001";102;15;46;0;20;183
"774";"360050338002";135;18;27;0;15;195
"775";"360050338003";32;10;35;0;28;105
"776";"360050338004";162;11;69;5;46;293
"777";"360050340001";25;3;65;2;44;139
"778";"360050340002";163;23;59;3;13;261
"779";"360050340003";213;22;12;4;36;287
"780";"360050340004";59;8;44;2;4;117
"781";"360050342001";24;1;60;5;11;101
"782";"360050342002";40;6;68;23;26;163
"783";"360050343001";9;5;33;14;8;69
"784";"360050343002";46;8;66;24;15;159
"785";"360050344001";31;4;16;2;22;75
"786";"360050344002";32;3;51;23;15;124
"787";"360050345001";38;5;80;15;25;163
"788";"360050345002";22;3;54;17;15;111
"789";"360050345003";4;1;9;7;11;32
"790";"360050348001";47;8;102;58;40;255
"791";"360050348002";381;19;3;6;31;440
"792";"360050348003";57;10;147;52;10;276
"793";"360050348004";21;5;76;29;14;145
"794";"360050350001";78;12;100;14;30;234
"795";"360050350002";50;12;38;13;22;135
"796";"360050351001";6;14;18;6;4;48
"797";"360050351002";48;3;68;21;13;153
"798";"360050351003";49;6;43;17;7;122
"799";"360050356001";18;1;32;14;11;76
"800";"360050356002";42;67;80;74;27;290
"801";"360050358001";52;12;63;29;10;166
"802";"360050358002";45;7;70;38;25;185
"803";"360050358003";58;7;53;22;11;151
"804";"360050358004";63;3;48;42;16;172
"805";"360050358005";83;3;67;11;16;180
"806";"360050358006";71;6;72;5;47;201
"807";"360050358007";167;19;61;11;31;289
"808";"360050359001";219;29;47;4;26;325
"809";"360050360001";10;6;34;8;20;78
"810";"360050360002";49;7;61;12;27;156
"811";"360050360003";19;3;21;10;7;60
"812";"360050361001";33;3;14;3;7;60
"813";"360050361002";233;32;66;2;8;341
"814";"360050361003";17;6;13;2;1;39
"815";"360050361004";18;2;0;0;6;26
"816";"360050361005";218;6;7;2;10;243
"817";"360050363001";139;4;7;0;9;159
"818";"360050363002";8;1;5;0;4;18
"819";"360050363003";80;5;54;2;11;152
"820";"360050363004";445;29;62;56;27;619
"821";"360050363005";14;9;19;4;7;53
"822";"360050363006";130;21;20;12;16;199
"823";"360050364001";35;5;82;22;17;161
"824";"360050364002";15;0;21;8;16;60
"825";"360050364003";40;19;63;15;12;149
"826";"360050365011";26;3;17;13;5;64
"827";"360050365012";31;4;25;3;8;71
"828";"360050365013";67;9;21;0;9;106
"829";"360050365021";32;43;45;1;14;135
"830";"360050365022";122;28;24;0;33;207
"831";"360050367001";44;5;20;3;15;87
"832";"360050367002";412;18;16;0;18;464
"833";"360050368001";50;20;50;8;21;149
"834";"360050368002";18;2;30;2;20;72
"835";"360050369011";132;102;8;4;19;265
"836";"360050369012";29;11;22;4;9;75
"837";"360050369021";30;9;3;0;4;46
"838";"360050369022";62;21;18;4;13;118
"839";"360050370001";25;11;42;13;16;107
"840";"360050370002";13;3;34;2;10;62
"841";"360050370003";25;1;39;7;24;96
"842";"360050371001";57;4;70;12;16;159
"843";"360050371002";60;9;17;4;30;120
"844";"360050371003";227;9;6;8;15;265
"845";"360050371004";35;76;41;3;20;175
"846";"360050372001";21;5;28;3;13;70
"847";"360050372002";75;11;76;11;9;182
"848";"360050373001";116;14;12;5;15;162
"849";"360050373002";68;80;40;5;21;214
"850";"360050373003";89;31;18;5;20;163
"851";"360050373004";70;37;12;20;36;175
"852";"360050374001";203;23;44;2;12;284
"853";"360050374002";150;22;71;5;34;282
"854";"360050374003";51;6;2;1;1;61
"855";"360050374004";11;0;0;2;1;14
"856";"360050375041";35;9;39;31;14;128
"857";"360050375042";108;27;48;8;11;202
"858";"360050375043";128;108;38;7;14;295
"859";"360050376001";406;4;20;3;7;440
"860";"360050376002";15;4;17;6;25;67
"861";"360050378001";49;10;53;3;60;175
"862";"360050378002";35;4;16;0;10;65
"863";"360050378003";70;10;58;5;50;193
"864";"360050379001";16;17;62;32;23;150
"865";"360050379002";14;4;7;1;2;28
"866";"360050379003";30;4;8;1;9;52
"867";"360050379004";37;5;21;2;4;69
"868";"360050379005";148;12;14;3;6;183
"869";"360050380001";106;3;8;7;4;128
"870";"360050380002";19;3;59;4;13;98
"871";"360050380003";147;22;27;6;34;236
"872";"360050380004";63;30;48;7;34;182
"873";"360050381001";100;2;1;0;3;106
"874";"360050381002";168;14;21;2;7;212
"875";"360050381003";53;153;3;0;14;223
"876";"360050381004";13;27;29;6;13;88
"877";"360050381005";35;7;64;3;6;115
"878";"360050381006";252;21;13;1;19;306
"879";"360050382001";76;8;76;9;17;186
"880";"360050382002";36;2;45;1;10;94
"881";"360050383011";113;25;7;4;10;159
"882";"360050383012";187;10;36;2;6;241
"883";"360050383013";112;13;10;6;10;151
"884";"360050383021";84;39;27;19;33;202
"885";"360050383022";127;31;21;0;9;188
"886";"360050383023";438;15;24;4;24;505
"887";"360050385001";86;19;24;11;19;159
"888";"360050385002";19;34;7;6;10;76
"889";"360050385003";60;61;6;3;13;143
"890";"360050385004";86;60;32;19;19;216
"891";"360050386001";19;6;119;26;39;209
"892";"360050386002";30;14;87;22;29;182
"893";"360050386003";34;15;0;0;7;56
"894";"360050386004";42;12;86;3;25;168
"895";"360050386005";51;54;20;11;8;144
"896";"360050386006";23;4;22;1;8;58
"897";"360050386007";24;1;0;0;8;33
"898";"360050386008";53;25;22;0;5;105
"899";"360050387001";177;20;19;2;31;249
"900";"360050387002";188;77;22;25;18;330
"901";"360050387003";92;31;7;1;8;139
"902";"360050388001";51;4;84;5;6;150
"903";"360050388002";194;12;160;26;17;409
"904";"360050389001";119;45;39;3;23;229
"905";"360050389002";105;9;5;5;15;139
"906";"360050389003";113;81;32;3;38;267
"907";"360050389004";105;18;18;0;12;153
"908";"360050389005";69;9;10;2;28;118
"909";"360050390001";81;3;128;11;16;239
"910";"360050390002";144;27;61;0;35;267
"911";"360050391001";119;24;31;2;28;204
"912";"360050391002";122;6;33;5;14;180
"913";"360050391003";118;93;41;19;17;288
"914";"360050391004";63;157;18;1;34;273
"915";"360050391005";20;2;2;1;16;41
"916";"360050391006";51;8;2;3;15;79
"917";"360050392001";15;3;48;4;17;87
"918";"360050392002";19;9;60;6;32;126
"919";"360050393001";237;152;15;6;21;431
"920";"360050393002";196;77;6;7;18;304
"921";"360050393003";40;9;8;7;7;71
"922";"360050393004";47;16;16;1;14;94
"923";"360050393005";28;11;26;2;9;76
"924";"360050393006";138;43;52;15;9;257
"925";"360050394001";133;3;15;1;13;165
"926";"360050394002";117;21;68;6;37;249
"927";"360050394003";2;2;10;3;7;24
"928";"360050394004";175;8;90;1;25;299
"929";"360050395001";34;21;47;47;49;198
"930";"360050395002";56;28;48;60;41;233
"931";"360050395003";47;20;79;70;35;251
"932";"360050395004";74;61;64;26;38;263
"933";"360050396001";61;8;80;0;13;162
"934";"360050396002";59;6;73;5;21;164
"935";"360050396003";72;8;59;4;30;173
"936";"360050396004";31;12;114;0;26;183
"937";"360050397001";52;56;48;13;23;192
"938";"360050397002";62;16;9;6;15;108
"939";"360050398001";39;4;44;10;5;102
"940";"360050398002";7;5;46;6;16;80
"941";"360050398003";24;1;32;5;7;69
"942";"360050399011";136;20;6;1;18;181
"943";"360050399012";46;26;9;0;12;93
"944";"360050399013";51;13;8;0;9;81
"945";"360050399014";58;7;1;0;36;102
"946";"360050399015";85;22;38;2;17;164
"947";"360050399021";77;25;24;4;24;154
"948";"360050399022";37;25;1;1;8;72
"949";"360050399023";174;35;25;1;13;248
"950";"360050399024";58;5;0;0;3;66
"951";"360050399025";72;14;7;0;2;95
"952";"360050401001";175;1;3;0;13;192
"953";"360050401002";216;35;11;2;35;299
"954";"360050401003";80;5;11;0;11;107
"955";"360050401004";26;1;1;1;16;45
"956";"360050401005";459;159;3;1;27;649
"957";"360050403021";535;45;3;0;25;608
"958";"360050403022";20;18;14;1;6;59
"959";"360050403023";31;5;8;0;11;55
"960";"360050403031";220;28;59;1;14;322
"961";"360050403032";309;28;137;2;20;496
"962";"360050403033";155;32;7;0;8;202
"963";"360050403041";69;65;5;0;11;150
"964";"360050403042";216;37;19;0;10;282
"965";"360050403043";97;21;32;0;11;161
"966";"360050404001";54;5;173;10;18;260
"967";"360050404002";23;6;78;0;11;118
"968";"360050404003";10;1;58;5;25;99
"969";"360050405011";406;23;15;0;40;484
"970";"360050405012";47;3;35;1;6;92
"971";"360050405013";130;28;39;2;31;230
"972";"360050405021";49;97;40;0;11;197
"973";"360050405022";61;15;15;0;9;100
"974";"360050405023";62;16;44;2;21;145
"975";"360050405024";58;24;21;2;13;118
"976";"360050405025";66;6;18;0;12;102
"977";"360050405026";35;5;54;0;14;108
"978";"360050406001";273;55;73;9;32;442
"979";"360050406002";93;12;39;3;12;159
"980";"360050406003";61;12;38;1;25;137
"981";"360050407011";87;34;11;2;14;148
"982";"360050407012";97;3;3;9;10;122
"983";"360050407013";171;16;8;1;13;209
"984";"360050407021";44;6;4;0;12;66
"985";"360050407022";75;92;33;6;26;232
"986";"360050407023";250;28;22;1;21;322
"987";"360050407024";95;12;40;0;24;171
"988";"360050407025";49;5;27;1;30;112
"989";"360050408001";94;9;37;1;9;150
"990";"360050408002";228;24;39;0;24;315
"991";"360050408003";44;9;11;1;19;84
"992";"360050408004";160;8;121;5;29;323
"993";"360050409001";50;24;107;2;18;201
"994";"360050409002";80;20;44;1;11;156
"995";"360050411001";118;3;27;2;5;155
"996";"360050411002";117;16;28;0;18;179
"997";"360050411003";138;11;33;2;17;201
"998";"360050413001";223;84;107;0;46;460
"999";"360050413002";35;18;7;0;13;73
"1000";"360050413003";150;14;43;6;10;223
"1001";"360050413004";48;7;20;0;10;85
"1002";"360050413005";159;9;6;0;10;184
"1003";"360050413006";82;17;22;0;7;128
"1004";"360050413007";115;5;14;3;15;152
"1005";"360050414001";34;5;93;33;27;192
"1006";"360050414002";68;6;34;8;31;147
"1007";"360050414003";73;10;71;30;24;208
"1008";"360050414004";128;17;45;37;40;267
"1009";"360050415001";100;13;51;1;20;185
"1010";"360050415002";118;6;59;3;5;191
"1011";"360050415003";18;2;27;2;6;55
"1012";"360050415004";50;4;9;0;12;75
"1013";"360050415005";59;33;12;0;13;117
"1014";"360050415006";150;17;39;1;17;224
"1015";"360050418001";55;20;45;8;22;150
"1016";"360050418002";51;7;61;11;22;152
"1017";"360050418003";118;22;24;9;10;183
"1018";"360050418004";33;5;21;8;15;82
"1019";"360050419001";49;6;89;0;8;152
"1020";"360050419002";60;6;17;1;5;89
"1021";"360050419003";114;7;34;0;9;164
"1022";"360050419004";120;18;43;2;24;207
"1023";"360050419005";27;11;15;1;19;73
"1024";"360050419006";87;19;13;1;18;138
"1025";"360050419007";53;5;23;0;11;92
"1026";"360050420001";66;11;16;5;15;113
"1027";"360050420002";214;13;77;1;12;317
"1028";"360050420003";150;7;86;0;25;268
"1029";"360050421001";70;13;17;2;4;106
"1030";"360050421002";277;45;3;0;17;342
"1031";"360050421003";91;29;6;0;12;138
"1032";"360050421004";137;102;21;4;11;275
"1033";"360050421005";104;41;3;2;12;162
"1034";"360050422001";97;8;87;11;45;248
"1035";"360050422002";63;8;85;0;31;187
"1036";"360050423001";124;79;9;0;15;227
"1037";"360050423002";89;20;232;0;21;362
"1038";"360050423003";78;20;48;0;6;152
"1039";"360050424001";38;1;83;15;13;150
"1040";"360050424002";23;3;89;22;27;164
"1041";"360050425001";74;157;18;4;15;268
"1042";"360050425002";66;18;27;1;14;126
"1043";"360050425003";92;22;25;1;19;159
"1044";"360050425004";18;6;29;0;7;60
"1045";"360050425005";53;19;20;7;22;121
"1046";"360050425006";23;19;13;0;30;85
"1047";"360050425007";206;229;73;0;22;530
"1048";"360050426001";60;11;144;56;17;288
"1049";"360050426002";58;9;150;36;13;266
"1050";"360050426003";14;0;104;29;15;162
"1051";"360050426004";16;1;34;26;3;80
"1052";"360050426005";76;1;44;9;8;138
"1053";"360050426006";55;1;58;8;12;134
"1054";"360050428001";26;3;50;21;20;120
"1055";"360050428002";26;4;62;21;15;128
"1056";"360050429011";179;19;70;3;29;300
"1057";"360050429012";119;9;30;1;3;162
"1058";"360050429013";35;2;22;0;8;67
"1059";"360050429021";276;55;119;1;48;499
"1060";"360050429022";49;42;111;3;8;213
"1061";"360050429023";125;22;89;1;5;242
"1062";"360050430001";28;5;68;24;18;143
"1063";"360050430002";5;3;45;20;22;95
"1064";"360050430003";22;6;42;18;17;105
"1065";"360050431001";49;44;1;0;5;99
"1066";"360050431002";201;20;13;3;14;251
"1067";"360050431003";85;7;4;1;7;104
"1068";"360050431004";42;66;30;1;19;158
"1069";"360050431005";554;58;44;10;30;696
"1070";"360050431006";116;29;14;2;11;172
"1071";"360050431007";90;22;28;0;14;154
"1072";"360050431008";25;582;85;2;18;712
"1073";"360050434001";121;36;160;30;21;368
"1074";"360050434002";32;6;36;6;16;96
"1075";"360050434003";47;4;40;18;21;130
"1076";"360050434004";72;5;50;11;15;153
"1077";"360050435001";152;124;98;18;105;497
"1078";"360050436001";43;10;53;17;21;144
"1079";"360050436002";62;12;122;20;25;241
"1080";"360050442001";124;17;16;11;17;185
"1081";"360050442002";50;4;52;14;6;126
"1082";"360050442003";13;5;43;36;2;99
"1083";"360050442004";60;3;62;43;21;189
"1084";"360050442005";16;2;31;11;22;82
"1085";"360050444001";38;11;96;14;15;174
"1086";"360050444002";29;5;35;15;30;114
"1087";"360050444003";54;2;67;15;13;151
"1088";"360050444004";26;6;80;26;10;148
"1089";"360050448001";40;13;80;20;10;163
"1090";"360050448002";5;2;16;10;2;35
"1091";"360050449011";3;0;41;3;4;51
"1092";"360050449012";2;1;94;11;16;124
"1093";"360050449021";16;17;107;13;19;172
"1094";"360050449022";33;29;74;24;19;179
"1095";"360050451011";57;11;195;23;36;322
"1096";"360050451012";28;9;56;21;5;119
"1097";"360050451021";2;3;58;20;17;100
"1098";"360050451022";41;20;119;16;23;219
"1099";"360050456001";24;14;30;12;25;105
"1100";"360050456002";27;29;90;47;24;217
"1101";"360050456003";6;1;19;14;1;41
"1102";"360050458001";99;18;2;2;3;124
"1103";"360050458002";200;12;0;0;5;217
"1104";"360050458003";21;0;0;1;3;25
"1105";"360050458004";403;8;12;2;3;428
"1106";"360050460001";90;20;92;16;14;232
"1107";"360050460002";24;2;24;18;12;80
"1108";"360050462011";11;6;60;4;18;99
"1109";"360050462012";0;0;0;1;2;3
"1110";"360050462013";27;4;30;0;2;63
"1111";"360050462014";8;2;16;2;14;42
"1112";"360050462015";6;1;13;0;0;20
"1113";"360050462016";19;0;12;0;0;31
"1114";"360050462017";1;1;31;0;0;33
"1115";"360050462018";4;5;20;0;4;33
"1116";"360050462019";1;0;5;0;0;6
"1117";"360050462021";96;10;300;128;48;582
"1118";"360050462022";42;9;225;35;20;331
"1119";"360050462023";100;30;80;42;22;274
"1120";"360050462024";13;1;26;24;8;72
"1121";"360050462025";18;11;75;22;5;131
"1122";"360050462026";8;2;13;18;8;49
"1123";"360050484001";7;2;64;12;7;92
"1124";"360050484002";59;72;249;200;76;656
"1125";"360050484003";77;4;22;22;9;134
"1126";"360050484004";20;5;102;31;13;171
"1127";"360050504001";0;4;3;0;14;21
"1128";"360050516000";0;0;4;0;0;4
"1129";"360050516001";35;144;292;27;36;534
"1130";"360050516002";33;36;90;43;25;227
"1131";"360050516003";24;48;123;41;49;285
"1132";"360050516004";72;13;80;31;20;216
"1133";"360470001001";9;22;47;4;11;93
"1134";"360470001002";13;5;25;5;5;53
"1135";"360470001003";41;30;44;6;25;146
"1136";"360470001004";10;45;11;2;6;74
"1137";"360470002001";29;115;205;83;106;538
"1138";"360470003011";8;1;12;2;3;26
"1139";"360470003012";2;8;19;2;4;35
"1140";"360470003013";17;13;15;2;7;54
"1141";"360470003014";12;6;13;2;2;35
"1142";"360470003015";20;18;15;0;6;59
"1143";"360470005011";83;35;46;3;9;176
"1144";"360470005012";15;27;11;3;8;64
"1145";"360470005013";26;14;31;2;10;83
"1146";"360470005021";22;15;21;20;4;82
"1147";"360470005022";26;46;45;2;12;131
"1148";"360470007001";86;68;97;4;21;276
"1149";"360470007002";27;9;60;5;10;111
"1150";"360470007003";37;23;30;4;12;106
"1151";"360470009001";45;143;64;12;41;305
"1152";"360470009002";16;38;22;0;11;87
"1153";"360470011001";37;65;97;3;64;266
"1154";"360470013001";72;203;106;7;26;414
"1155";"360470013002";0;0;14;1;2;17
"1156";"360470015001";38;22;95;10;28;193
"1157";"360470015002";630;8;14;4;45;701
"1158";"360470015003";56;28;220;7;39;350
"1159";"360470018000";0;0;0;0;1;1
"1160";"360470018001";46;31;240;46;85;448
"1161";"360470020001";15;31;97;17;49;209
"1162";"360470020002";23;22;100;7;44;196
"1163";"360470021001";27;84;121;2;19;253
"1164";"360470021002";30;48;114;13;38;243
"1165";"360470021003";69;42;163;8;43;325
"1166";"360470022001";139;12;277;6;36;470
"1167";"360470022002";15;14;77;8;29;143
"1168";"360470022003";80;42;103;33;35;293
"1169";"360470023001";121;13;2;5;4;145
"1170";"360470023002";65;10;11;0;3;89
"1171";"360470023003";436;15;30;2;9;492
"1172";"360470029011";72;16;8;1;10;107
"1173";"360470029012";82;13;38;2;9;144
"1174";"360470030001";16;4;180;15;14;229
"1175";"360470030002";50;6;42;16;10;124
"1176";"360470031001";6;27;17;1;1;52
"1177";"360470031002";6;1;9;0;1;17
"1178";"360470031003";1;15;6;0;7;29
"1179";"360470033001";11;28;15;1;12;67
"1180";"360470033002";206;101;121;7;56;491
"1181";"360470034001";19;12;63;14;37;145
"1182";"360470034002";11;10;163;18;13;215
"1183";"360470034003";33;2;163;6;13;217
"1184";"360470035001";10;60;52;2;42;166
"1185";"360470035002";36;90;27;4;13;170
"1186";"360470036001";19;5;95;5;17;141
"1187";"360470036002";126;10;145;2;11;294
"1188";"360470036003";31;0;212;17;6;266
"1189";"360470037001";47;172;95;8;53;375
"1190";"360470038001";14;13;410;14;19;470
"1191";"360470039001";11;50;36;12;29;138
"1192";"360470039002";31;39;41;4;49;164
"1193";"360470039003";6;24;35;8;63;136
"1194";"360470041001";87;58;80;9;31;265
"1195";"360470041002";16;19;37;5;9;86
"1196";"360470041003";17;20;55;7;13;112
"1197";"360470043001";0;1;0;0;3;4
"1198";"360470043002";13;26;53;6;5;103
"1199";"360470043003";9;25;24;12;13;83
"1200";"360470043004";23;87;99;14;30;253
"1201";"360470044001";15;14;69;19;11;128
"1202";"360470044002";9;2;59;23;18;111
"1203";"360470045001";9;29;51;11;12;112
"1204";"360470045002";16;17;19;12;3;67
"1205";"360470045003";8;7;5;9;7;36
"1206";"360470045004";27;5;58;4;3;97
"1207";"360470046001";10;38;139;15;36;238
"1208";"360470047001";66;43;70;4;45;228
"1209";"360470049001";9;4;137;3;10;163
"1210";"360470049002";11;0;14;1;8;34
"1211";"360470049003";18;2;25;1;6;52
"1212";"360470050001";11;1;26;2;1;41
"1213";"360470050002";29;5;49;8;11;102
"1214";"360470050003";28;3;65;8;14;118
"1215";"360470051001";5;25;47;12;15;104
"1216";"360470051002";16;11;42;10;19;98
"1217";"360470051003";8;44;110;40;30;232
"1218";"360470052011";9;7;58;6;16;96
"1219";"360470052021";32;7;197;1;5;242
"1220";"360470052022";26;4;264;11;12;317
"1221";"360470053001";35;52;112;31;81;311
"1222";"360470053002";17;45;57;11;19;149
"1223";"360470053003";21;10;28;5;17;81
"1224";"360470053004";11;14;64;9;25;123
"1225";"360470054001";80;2;90;3;18;193
"1226";"360470054002";7;2;76;4;16;105
"1227";"360470054003";27;30;65;3;19;144
"1228";"360470056011";23;7;85;21;17;153
"1229";"360470056012";69;18;110;5;12;214
"1230";"360470056021";101;57;283;12;24;477
"1231";"360470058001";48;24;41;9;32;154
"1232";"360470058002";255;29;151;19;36;490
"1233";"360470058003";3;3;11;1;5;23
"1234";"360470059001";166;70;43;8;39;326
"1235";"360470059002";24;18;83;46;36;207
"1236";"360470060001";69;13;59;10;27;178
"1237";"360470060002";28;35;66;45;15;189
"1238";"360470060003";8;13;30;5;8;64
"1239";"360470062001";37;52;45;3;22;159
"1240";"360470062002";49;83;18;4;23;177
"1241";"360470062003";6;9;41;5;6;67
"1242";"360470063001";30;5;28;0;8;71
"1243";"360470063002";12;8;17;6;12;55
"1244";"360470064001";54;46;197;3;32;332
"1245";"360470064002";29;3;55;5;28;120
"1246";"360470064003";33;90;78;11;23;235
"1247";"360470065001";24;3;6;3;9;45
"1248";"360470065002";8;7;7;1;4;27
"1249";"360470065003";7;4;15;6;6;38
"1250";"360470065004";9;4;13;4;5;35
"1251";"360470065005";3;4;8;4;12;31
"1252";"360470065006";52;52;45;4;16;169
"1253";"360470065007";5;4;29;7;42;87
"1254";"360470066001";20;74;131;11;30;266
"1255";"360470066002";12;20;29;0;22;83
"1256";"360470066003";292;37;103;9;36;477
"1257";"360470067001";6;12;25;6;2;51
"1258";"360470067002";7;10;21;0;8;46
"1259";"360470067003";13;10;23;2;2;50
"1260";"360470067004";24;2;14;7;3;50
"1261";"360470067005";6;1;14;0;3;24
"1262";"360470068001";16;13;29;9;42;109
"1263";"360470068002";64;8;57;3;49;181
"1264";"360470068003";4;18;25;7;17;71
"1265";"360470068004";20;31;30;3;29;113
"1266";"360470069001";14;14;10;11;16;65
"1267";"360470069002";11;41;48;13;26;139
"1268";"360470069003";13;26;35;7;11;92
"1269";"360470069004";22;29;35;9;10;105
"1270";"360470070001";27;8;150;16;27;228
"1271";"360470070002";12;7;118;6;5;148
"1272";"360470071001";9;19;19;13;16;76
"1273";"360470071002";30;17;67;10;21;145
"1274";"360470071003";113;24;5;11;8;161
"1275";"360470071004";68;21;7;2;0;98
"1276";"360470072001";77;15;39;4;44;179
"1277";"360470074001";42;75;54;0;46;217
"1278";"360470074002";48;41;7;3;37;136
"1279";"360470074003";36;24;27;6;46;139
"1280";"360470074004";21;11;13;0;17;62
"1281";"360470075001";27;16;30;3;11;87
"1282";"360470075002";27;68;14;6;5;120
"1283";"360470075003";21;31;77;17;20;166
"1284";"360470075004";14;18;14;2;7;55
"1285";"360470075005";8;11;56;18;9;102
"1286";"360470076001";52;32;24;2;41;151
"1287";"360470076002";42;26;17;0;54;139
"1288";"360470076003";34;24;80;11;53;202
"1289";"360470077001";11;12;74;10;11;118
"1290";"360470077002";7;12;132;27;23;201
"1291";"360470077003";28;57;76;7;33;201
"1292";"360470077004";12;5;9;6;19;51
"1293";"360470078001";42;32;35;4;110;223
"1294";"360470078002";61;50;44;3;27;185
"1295";"360470078003";45;13;23;7;34;122
"1296";"360470078004";76;17;21;2;30;146
"1297";"360470080001";55;61;47;3;35;201
"1298";"360470080002";105;26;17;3;26;177
"1299";"360470080003";21;6;28;6;22;83
"1300";"360470082001";134;48;13;2;23;220
"1301";"360470082002";46;21;33;10;19;129
"1302";"360470082003";56;18;33;7;35;149
"1303";"360470084001";19;40;50;4;25;138
"1304";"360470084002";25;36;20;4;44;129
"1305";"360470084003";13;40;35;3;34;125
"1306";"360470085001";235;50;3;2;25;315
"1307";"360470085002";36;11;4;0;6;57
"1308";"360470085003";127;26;2;0;9;164
"1309";"360470086001";20;663;14;2;20;719
"1310";"360470088001";80;114;38;4;36;272
"1311";"360470088002";106;30;45;2;22;205
"1312";"360470090001";53;32;51;2;50;188
"1313";"360470090002";51;12;327;8;56;454
"1314";"360470092001";224;65;58;6;36;389
"1315";"360470092002";72;9;19;2;61;163
"1316";"360470092003";37;12;46;3;28;126
"1317";"360470094001";20;10;101;2;42;175
"1318";"360470094002";49;13;99;6;54;221
"1319";"360470094003";36;19;54;0;42;151
"1320";"360470096001";46;9;34;4;35;128
"1321";"360470096002";44;10;64;3;56;177
"1322";"360470096003";37;9;99;1;26;172
"1323";"360470096004";111;88;45;8;32;284
"1324";"360470098001";39;19;75;3;54;190
"1325";"360470098002";55;8;88;4;41;196
"1326";"360470098003";16;12;45;2;63;138
"1327";"360470098004";21;25;29;1;28;104
"1328";"360470100001";8;6;17;4;46;81
"1329";"360470100002";40;12;36;1;64;153
"1330";"360470100003";15;21;11;4;47;98
"1331";"360470100004";45;14;12;1;49;121
"1332";"360470101001";42;48;87;7;44;228
"1333";"360470101002";55;51;117;15;51;289
"1334";"360470101003";83;79;46;5;43;256
"1335";"360470102001";15;29;83;4;71;202
"1336";"360470102002";24;23;22;5;32;106
"1337";"360470102003";67;62;50;1;25;205
"1338";"360470104001";33;14;131;0;94;272
"1339";"360470104002";19;7;56;1;33;116
"1340";"360470104003";25;4;133;3;145;310
"1341";"360470106001";31;8;177;5;126;347
"1342";"360470106002";19;13;96;2;59;189
"1343";"360470106003";38;8;77;0;50;173
"1344";"360470108001";11;4;76;4;62;157
"1345";"360470108002";34;1;114;4;34;187
"1346";"360470108003";9;8;122;3;52;194
"1347";"360470110001";11;6;199;35;26;277
"1348";"360470110002";175;28;266;54;54;577
"1349";"360470112001";72;11;189;12;38;322
"1350";"360470112002";27;5;59;9;11;111
"1351";"360470112003";6;0;84;8;13;111
"1352";"360470112004";54;13;53;6;15;141
"1353";"360470114001";89;15;42;8;10;164
"1354";"360470114002";10;81;176;6;18;291
"1355";"360470114003";32;11;101;7;1;152
"1356";"360470116001";13;6;155;2;28;204
"1357";"360470116002";25;6;75;1;34;141
"1358";"360470116003";15;6;37;5;36;99
"1359";"360470117001";31;23;64;19;28;165
"1360";"360470117002";37;18;57;11;21;144
"1361";"360470117003";42;31;68;8;44;193
"1362";"360470118001";23;19;54;3;44;143
"1363";"360470118002";8;10;134;2;82;236
"1364";"360470119001";37;107;166;10;46;366
"1365";"360470119002";26;869;160;11;48;1114
"1366";"360470119003";27;44;151;9;32;263
"1367";"360470120001";57;68;130;13;83;351
"1368";"360470121001";31;23;103;14;38;209
"1369";"360470121002";19;54;102;13;55;243
"1370";"360470122001";98;21;24;0;75;218
"1371";"360470122002";16;35;64;3;48;166
"1372";"360470122003";45;72;146;6;55;324
"1373";"360470126001";65;16;56;6;38;181
"1374";"360470126002";9;44;31;4;24;112
"1375";"360470126003";30;14;56;14;9;123
"1376";"360470127001";65;36;40;5;27;173
"1377";"360470127002";123;90;121;9;32;375
"1378";"360470127003";116;23;9;0;6;154
"1379";"360470128011";114;121;87;1;31;354
"1380";"360470129011";34;29;92;16;24;195
"1381";"360470129012";44;160;180;8;29;421
"1382";"360470129013";12;14;29;7;3;65
"1383";"360470129021";3;44;42;0;14;103
"1384";"360470129022";31;187;121;10;8;357
"1385";"360470129023";14;12;32;10;6;74
"1386";"360470130001";22;12;28;1;44;107
"1387";"360470130002";75;8;92;11;28;214
"1388";"360470130003";21;11;51;20;42;145
"1389";"360470130004";53;34;20;7;43;157
"1390";"360470131001";22;23;41;2;5;93
"1391";"360470131002";19;38;29;5;16;107
"1392";"360470131003";9;16;22;6;21;74
"1393";"360470131004";58;75;34;4;17;188
"1394";"360470132001";5;7;27;2;71;112
"1395";"360470132002";9;16;84;7;88;204
"1396";"360470133001";46;32;16;8;6;108
"1397";"360470133002";43;47;88;4;11;193
"1398";"360470133003";31;16;46;6;7;106
"1399";"360470133004";10;12;54;3;4;83
"1400";"360470134001";31;8;184;19;22;264
"1401";"360470134002";64;8;58;3;28;161
"1402";"360470134003";35;13;57;13;34;152
"1403";"360470135001";17;17;19;9;6;68
"1404";"360470135002";36;74;35;13;25;183
"1405";"360470135003";21;24;55;4;14;118
"1406";"360470136001";13;10;89;10;33;155
"1407";"360470136002";19;2;50;7;19;97
"1408";"360470136003";16;22;55;1;14;108
"1409";"360470136004";38;6;60;8;29;141
"1410";"360470137001";15;114;23;12;8;172
"1411";"360470137002";21;20;64;4;20;129
"1412";"360470137003";55;27;146;27;64;319
"1413";"360470138001";41;30;104;8;37;220
"1414";"360470138002";18;3;28;5;17;71
"1415";"360470138003";20;9;36;2;24;91
"1416";"360470139001";50;14;25;1;15;105
"1417";"360470139002";45;22;18;5;16;106
"1418";"360470139003";11;22;5;3;10;51
"1419";"360470139004";29;14;16;8;38;105
"1420";"360470140001";25;2;54;4;14;99
"1421";"360470140002";6;13;46;7;15;87
"1422";"360470141001";52;35;51;4;22;164
"1423";"360470141002";9;22;38;11;32;112
"1424";"360470141003";66;42;29;10;20;167
"1425";"360470142001";59;7;65;2;36;169
"1426";"360470142002";32;45;25;1;33;136
"1427";"360470142003";116;21;35;8;36;216
"1428";"360470143001";85;48;41;12;49;235
"1429";"360470143002";52;20;50;8;53;183
"1430";"360470143003";39;5;41;6;27;118
"1431";"360470145001";71;56;185;4;45;361
"1432";"360470145002";80;85;36;8;47;256
"1433";"360470145003";72;25;159;17;35;308
"1434";"360470145004";57;26;51;24;27;185
"1435";"360470147001";43;27;17;1;6;94
"1436";"360470147002";83;17;46;6;20;172
"1437";"360470148001";5;4;32;5;4;50
"1438";"360470148002";5;8;73;3;10;99
"1439";"360470149001";15;5;35;1;11;67
"1440";"360470149002";16;35;41;5;18;115
"1441";"360470149003";10;9;19;10;15;63
"1442";"360470149004";24;9;33;4;17;87
"1443";"360470149005";27;17;70;6;21;141
"1444";"360470150001";2;0;21;8;10;41
"1445";"360470150002";15;8;71;7;13;114
"1446";"360470151001";4;4;23;3;10;44
"1447";"360470151002";18;8;19;3;7;55
"1448";"360470151003";40;15;26;7;18;106
"1449";"360470151004";11;10;10;10;4;45
"1450";"360470152001";2;1;53;7;4;67
"1451";"360470152002";3;3;36;14;2;58
"1452";"360470152003";19;2;41;9;25;96
"1453";"360470153001";5;5;41;1;7;59
"1454";"360470153002";12;7;14;7;14;54
"1455";"360470153003";20;11;22;11;12;76
"1456";"360470153004";4;4;51;8;23;90
"1457";"360470154001";2;13;43;6;3;67
"1458";"360470155001";11;8;18;3;10;50
"1459";"360470155002";26;2;15;5;7;55
"1460";"360470155003";31;27;51;3;12;124
"1461";"360470155004";5;13;23;3;6;50
"1462";"360470157001";14;17;36;8;3;78
"1463";"360470157002";12;10;24;2;5;53
"1464";"360470157003";9;47;49;7;14;126
"1465";"360470157004";13;37;14;2;6;72
"1466";"360470159001";15;47;71;8;16;157
"1467";"360470159002";11;16;22;3;14;66
"1468";"360470159003";20;27;25;3;8;83
"1469";"360470159004";12;4;26;4;10;56
"1470";"360470159005";20;7;27;7;16;77
"1471";"360470160001";27;5;30;4;17;83
"1472";"360470160002";49;36;24;6;8;123
"1473";"360470160003";41;21;43;8;21;134
"1474";"360470160004";23;140;111;31;53;358
"1475";"360470161001";71;90;81;2;9;253
"1476";"360470161002";19;24;47;4;4;98
"1477";"360470161003";58;86;75;12;39;270
"1478";"360470162001";23;11;40;5;11;90
"1479";"360470162002";11;7;59;6;19;102
"1480";"360470163001";21;17;40;2;22;102
"1481";"360470163002";55;26;21;5;19;126
"1482";"360470163003";206;28;32;7;7;280
"1483";"360470164001";1;2;2;1;1;7
"1484";"360470165001";21;18;37;5;14;95
"1485";"360470165002";19;15;36;10;15;95
"1486";"360470165003";39;13;51;1;7;111
"1487";"360470165004";28;6;16;7;6;63
"1488";"360470166001";27;1;41;19;6;94
"1489";"360470166002";17;7;37;9;11;81
"1490";"360470167001";19;6;54;3;8;90
"1491";"360470167002";17;6;24;6;9;62
"1492";"360470167003";19;10;19;14;19;81
"1493";"360470167004";21;12;68;8;11;120
"1494";"360470168001";33;6;205;13;17;274
"1495";"360470169001";8;11;9;0;8;36
"1496";"360470169002";22;48;28;5;15;118
"1497";"360470169003";13;46;21;6;17;103
"1498";"360470169004";37;18;18;0;18;91
"1499";"360470169005";23;11;31;2;5;72
"1500";"360470170001";10;5;32;1;38;86
"1501";"360470170002";8;11;102;13;30;164
"1502";"360470170003";25;8;113;5;13;164
"1503";"360470171001";4;2;37;9;7;59
"1504";"360470171002";2;4;9;3;3;21
"1505";"360470171003";5;7;31;1;2;46
"1506";"360470171004";12;1;22;8;7;50
"1507";"360470172001";19;14;212;32;43;320
"1508";"360470172002";21;4;72;3;30;130
"1509";"360470174001";10;9;138;54;14;225
"1510";"360470174002";14;9;32;2;13;70
"1511";"360470175001";12;15;23;14;3;67
"1512";"360470176001";5;3;96;11;1;116
"1513";"360470176002";26;4;111;17;32;190
"1514";"360470177001";117;232;121;27;55;552
"1515";"360470178001";30;4;24;12;27;97
"1516";"360470178002";24;10;173;15;34;256
"1517";"360470179001";77;4;7;1;2;91
"1518";"360470179002";410;120;97;1;8;636
"1519";"360470179003";20;63;30;3;11;127
"1520";"360470180001";49;5;78;19;29;180
"1521";"360470180002";10;11;130;5;29;185
"1522";"360470181001";55;29;16;5;8;113
"1523";"360470181002";15;0;25;3;4;47
"1524";"360470181003";50;118;61;7;12;248
"1525";"360470181004";22;10;26;3;12;73
"1526";"360470182001";4;4;35;5;24;72
"1527";"360470182002";23;3;96;22;32;176
"1528";"360470183001";61;83;32;15;24;215
"1529";"360470183002";40;57;19;7;17;140
"1530";"360470183003";81;36;64;14;15;210
"1531";"360470184001";11;5;123;6;11;156
"1532";"360470184002";12;13;64;0;24;113
"1533";"360470185011";10;7;8;1;6;32
"1534";"360470185012";66;7;32;4;8;117
"1535";"360470185013";108;12;9;0;7;136
"1536";"360470185014";21;5;7;1;5;39
"1537";"360470186001";9;3;88;7;31;138
"1538";"360470186002";45;3;52;4;19;123
"1539";"360470187001";95;228;72;11;49;455
"1540";"360470188001";23;10;67;19;31;150
"1541";"360470188002";24;1;289;0;31;345
"1542";"360470190001";30;6;127;11;28;202
"1543";"360470190002";19;10;70;6;40;145
"1544";"360470190003";14;28;131;8;27;208
"1545";"360470191001";131;122;86;13;43;395
"1546";"360470191002";13;16;29;4;15;77
"1547";"360470191003";55;155;93;4;23;330
"1548";"360470192001";2;1;64;6;13;86
"1549";"360470192002";17;7;129;36;41;230
"1550";"360470193001";77;119;38;9;22;265
"1551";"360470193002";54;7;11;1;3;76
"1552";"360470193003";14;4;12;1;4;35
"1553";"360470193004";11;37;4;0;6;58
"1554";"360470194001";9;5;94;37;19;164
"1555";"360470194002";86;6;80;15;27;214
"1556";"360470194003";15;8;108;18;22;171
"1557";"360470195001";39;60;51;5;11;166
"1558";"360470195002";53;118;66;5;3;245
"1559";"360470195003";31;13;27;2;4;77
"1560";"360470195004";15;18;26;5;3;67
"1561";"360470196001";28;19;46;10;32;135
"1562";"360470196002";18;5;64;6;34;127
"1563";"360470196003";16;6;90;4;24;140
"1564";"360470197001";9;10;76;3;1;99
"1565";"360470197002";46;67;38;13;10;174
"1566";"360470197003";16;26;46;1;3;92
"1567";"360470197004";24;44;19;5;13;105
"1568";"360470198001";9;4;42;5;15;75
"1569";"360470198002";14;2;94;4;17;131
"1570";"360470199001";16;19;63;3;9;110
"1571";"360470199002";147;120;29;1;16;313
"1572";"360470199003";57;172;64;1;27;321
"1573";"360470199004";49;6;15;7;9;86
"1574";"360470200001";15;0;45;4;25;89
"1575";"360470200002";14;5;56;5;20;100
"1576";"360470201001";44;56;22;3;27;152
"1577";"360470201002";53;101;33;13;28;228
"1578";"360470201003";108;49;43;2;20;222
"1579";"360470201004";109;34;78;5;14;240
"1580";"360470202001";9;0;63;6;58;136
"1581";"360470202002";6;0;63;4;12;85
"1582";"360470203001";106;274;172;20;54;626
"1583";"360470203002";38;37;61;3;24;163
"1584";"360470204001";14;4;49;5;60;132
"1585";"360470204002";10;0;111;11;23;155
"1586";"360470205001";35;60;84;8;18;205
"1587";"360470205002";35;120;42;5;10;212
"1588";"360470205003";47;17;37;6;16;123
"1589";"360470206001";27;1;73;3;34;138
"1590";"360470206002";4;2;108;7;88;209
"1591";"360470207001";174;136;50;6;17;383
"1592";"360470207002";52;66;51;21;9;199
"1593";"360470207003";6;9;24;5;5;49
"1594";"360470208001";5;0;87;2;12;106
"1595";"360470208002";14;0;43;4;30;91
"1596";"360470208003";7;2;54;1;18;82
"1597";"360470210001";41;8;198;1;26;274
"1598";"360470210002";13;2;108;3;39;165
"1599";"360470210003";11;8;10;1;25;55
"1600";"360470211001";7;11;54;2;16;90
"1601";"360470211002";50;33;392;34;61;570
"1602";"360470212001";17;5;60;24;43;149
"1603";"360470212002";82;50;60;4;39;235
"1604";"360470212003";17;10;103;3;44;177
"1605";"360470213001";73;55;9;4;15;156
"1606";"360470213002";178;20;10;5;19;232
"1607";"360470213003";74;22;18;4;11;129
"1608";"360470214001";17;5;47;24;26;119
"1609";"360470214002";6;3;90;9;24;132
"1610";"360470215001";81;91;61;1;17;251
"1611";"360470215002";83;88;27;3;22;223
"1612";"360470215003";140;45;18;2;17;222
"1613";"360470215004";84;70;36;0;17;207
"1614";"360470216001";9;5;46;5;3;68
"1615";"360470216002";6;1;80;2;4;93
"1616";"360470216003";35;22;143;9;23;232
"1617";"360470217001";118;63;44;9;17;251
"1618";"360470217002";146;324;47;3;24;544
"1619";"360470218001";12;6;42;2;11;73
"1620";"360470218002";2;0;18;4;2;26
"1621";"360470218003";11;23;83;12;9;138
"1622";"360470219001";78;55;10;6;13;162
"1623";"360470219002";59;4;11;2;12;88
"1624";"360470219003";59;67;42;8;29;205
"1625";"360470220001";8;5;30;4;11;58
"1626";"360470220002";32;10;37;3;18;100
"1627";"360470220003";10;2;21;0;0;33
"1628";"360470220004";5;8;51;5;7;76
"1629";"360470221001";42;29;17;1;30;119
"1630";"360470221002";216;167;137;5;64;589
"1631";"360470221003";39;39;17;4;16;115
"1632";"360470222001";3;6;38;8;11;66
"1633";"360470222002";7;15;97;9;10;138
"1634";"360470222003";17;26;79;18;30;170
"1635";"360470224001";1;16;70;1;12;100
"1636";"360470224002";34;2;39;1;5;81
"1637";"360470224003";21;4;139;3;7;174
"1638";"360470224004";28;4;397;14;19;462
"1639";"360470226001";24;22;205;81;28;360
"1640";"360470226002";32;12;209;59;24;336
"1641";"360470227001";48;51;27;6;38;170
"1642";"360470227002";104;276;51;14;53;498
"1643";"360470227003";73;76;39;4;22;214
"1644";"360470227004";144;74;52;13;44;327
"1645";"360470228001";20;8;88;4;30;150
"1646";"360470228002";6;21;66;9;6;108
"1647";"360470228003";6;6;66;14;13;105
"1648";"360470229001";106;34;67;1;19;227
"1649";"360470229002";92;15;29;2;40;178
"1650";"360470229003";25;34;57;5;21;142
"1651";"360470229004";201;22;37;4;30;294
"1652";"360470230001";24;2;25;3;13;67
"1653";"360470230002";3;0;22;13;5;43
"1654";"360470230003";25;10;113;60;13;221
"1655";"360470231001";173;125;65;5;23;391
"1656";"360470231002";90;45;80;9;41;265
"1657";"360470231003";93;109;17;9;30;258
"1658";"360470232001";2;1;95;10;8;116
"1659";"360470232002";20;1;43;4;6;74
"1660";"360470232003";1;4;18;7;9;39
"1661";"360470232004";1;1;17;2;6;27
"1662";"360470232005";4;17;85;2;15;123
"1663";"360470233001";91;198;39;6;33;367
"1664";"360470233002";316;13;13;0;7;349
"1665";"360470233003";123;152;148;5;42;470
"1666";"360470234001";3;3;48;0;4;58
"1667";"360470234002";18;9;55;6;10;98
"1668";"360470234003";10;6;58;1;2;77
"1669";"360470235001";152;123;124;10;52;461
"1670";"360470235002";54;12;100;49;41;256
"1671";"360470236001";3;2;70;5;5;85
"1672";"360470236002";15;8;27;17;0;67
"1673";"360470236003";4;4;44;0;0;52
"1674";"360470236004";9;3;44;7;11;74
"1675";"360470238001";4;2;18;2;4;30
"1676";"360470238002";7;6;32;6;6;57
"1677";"360470238003";4;5;29;4;7;49
"1678";"360470240001";14;3;35;3;5;60
"1679";"360470240002";0;7;77;17;3;104
"1680";"360470240003";17;1;27;7;10;62
"1681";"360470241001";109;318;299;56;115;897
"1682";"360470241002";72;33;55;3;35;198
"1683";"360470242001";2;5;91;7;8;113
"1684";"360470242002";8;3;53;5;6;75
"1685";"360470243001";105;59;28;4;21;217
"1686";"360470243002";326;117;65;11;28;547
"1687";"360470243003";156;40;22;4;25;247
"1688";"360470244001";2;4;41;2;25;74
"1689";"360470244002";12;3;71;8;15;109
"1690";"360470244003";11;8;151;14;24;208
"1691";"360470245001";74;15;43;7;15;154
"1692";"360470245002";188;867;42;3;23;1123
"1693";"360470245003";411;29;5;6;12;463
"1694";"360470245004";16;39;9;2;12;78
"1695";"360470246001";19;1;49;10;7;86
"1696";"360470246002";4;15;107;2;18;146
"1697";"360470246003";16;9;85;9;18;137
"1698";"360470247001";63;51;38;5;23;180
"1699";"360470247002";75;260;29;10;45;419
"1700";"360470248001";24;0;69;2;22;117
"1701";"360470248002";27;20;304;38;39;428
"1702";"360470249001";73;38;12;4;21;148
"1703";"360470249002";67;37;8;2;12;126
"1704";"360470249003";90;351;22;0;18;481
"1705";"360470249004";22;67;7;1;13;110
"1706";"360470250001";27;11;116;57;42;253
"1707";"360470250002";12;58;111;10;23;214
"1708";"360470251001";252;40;41;12;25;370
"1709";"360470251002";224;27;10;3;18;282
"1710";"360470251003";104;26;16;0;14;160
"1711";"360470252001";28;0;33;0;11;72
"1712";"360470252002";42;5;170;6;24;247
"1713";"360470252003";17;2;98;10;9;136
"1714";"360470252004";26;8;135;8;17;194
"1715";"360470253001";55;8;55;5;53;176
"1716";"360470253002";137;21;35;0;30;223
"1717";"360470253003";72;69;64;10;9;224
"1718";"360470254001";9;0;32;5;24;70
"1719";"360470254002";17;2;73;1;17;110
"1720";"360470254003";57;2;82;3;12;156
"1721";"360470255001";102;15;7;1;2;127
"1722";"360470255002";407;5;10;0;2;424
"1723";"360470256001";6;5;159;2;25;197
"1724";"360470256002";14;3;72;0;24;113
"1725";"360470257001";46;25;101;0;27;199
"1726";"360470257002";26;22;75;4;13;140
"1727";"360470257003";32;59;61;6;22;180
"1728";"360470258001";24;3;65;7;33;132
"1729";"360470258002";30;2;86;7;42;167
"1730";"360470258003";29;0;74;5;24;132
"1731";"360470259011";272;81;90;28;40;511
"1732";"360470259021";95;7;5;1;11;119
"1733";"360470260001";38;5;35;5;26;109
"1734";"360470260002";4;1;27;1;19;52
"1735";"360470260003";5;6;57;8;24;100
"1736";"360470261001";71;77;109;2;31;290
"1737";"360470261002";102;28;20;1;31;182
"1738";"360470261003";141;30;39;2;14;226
"1739";"360470261004";138;12;41;2;34;227
"1740";"360470261005";66;22;41;2;26;157
"1741";"360470262001";25;14;86;9;38;172
"1742";"360470262002";13;11;76;4;25;129
"1743";"360470263001";223;74;77;7;32;413
"1744";"360470264001";30;2;53;0;18;103
"1745";"360470264002";57;5;37;2;20;121
"1746";"360470264003";20;3;59;7;37;126
"1747";"360470264004";16;9;9;2;27;63
"1748";"360470265001";98;6;33;0;10;147
"1749";"360470265002";277;28;30;4;16;355
"1750";"360470265003";36;11;54;5;13;119
"1751";"360470265004";119;11;11;1;22;164
"1752";"360470266001";18;8;62;14;12;114
"1753";"360470266002";25;1;47;4;15;92
"1754";"360470266003";9;1;51;4;22;87
"1755";"360470267001";39;23;5;3;12;82
"1756";"360470267002";64;76;20;6;12;178
"1757";"360470267003";51;29;29;4;23;136
"1758";"360470267004";95;34;27;6;24;186
"1759";"360470268001";13;7;20;0;5;45
"1760";"360470268002";10;0;41;1;14;66
"1761";"360470268003";20;3;63;5;17;108
"1762";"360470268004";13;2;22;3;15;55
"1763";"360470269001";62;142;47;4;16;271
"1764";"360470269002";40;22;7;0;19;88
"1765";"360470269003";72;42;49;4;27;194
"1766";"360470270001";16;5;118;5;12;156
"1767";"360470270002";55;9;154;13;18;249
"1768";"360470271001";106;7;93;20;31;257
"1769";"360470271002";35;13;103;10;30;191
"1770";"360470272001";4;1;35;6;8;54
"1771";"360470272002";42;6;31;10;9;98
"1772";"360470272003";2;3;103;4;13;125
"1773";"360470273001";13;50;13;0;13;89
"1774";"360470273002";56;13;80;6;8;163
"1775";"360470273003";74;29;20;7;16;146
"1776";"360470274001";11;42;56;3;11;123
"1777";"360470274002";10;3;61;8;11;93
"1778";"360470275001";44;20;26;4;19;113
"1779";"360470275002";52;16;16;3;27;114
"1780";"360470275003";67;81;8;1;29;186
"1781";"360470275004";53;95;16;2;22;188
"1782";"360470276001";66;4;47;3;22;142
"1783";"360470276002";13;1;26;2;16;58
"1784";"360470276003";19;20;72;17;45;173
"1785";"360470277001";150;10;22;5;7;194
"1786";"360470277002";54;21;15;5;17;112
"1787";"360470277003";48;15;32;3;18;116
"1788";"360470277004";72;18;6;3;8;107
"1789";"360470278001";83;15;73;2;10;183
"1790";"360470278002";35;22;80;1;32;170
"1791";"360470279001";54;71;27;1;23;176
"1792";"360470279002";59;58;20;9;10;156
"1793";"360470279003";39;14;30;27;26;136
"1794";"360470279004";83;62;30;13;17;205
"1795";"360470280001";15;1;59;5;10;90
"1796";"360470280002";15;36;106;10;15;182
"1797";"360470281001";111;34;82;10;12;249
"1798";"360470281002";40;13;26;2;12;93
"1799";"360470281003";115;185;54;4;28;386
"1800";"360470282001";30;1;54;8;16;109
"1801";"360470282002";3;10;60;4;18;95
"1802";"360470282003";0;1;38;3;12;54
"1803";"360470283001";44;17;31;4;10;106
"1804";"360470283002";66;9;277;15;18;385
"1805";"360470283003";72;50;49;11;11;193
"1806";"360470284001";91;2;74;3;5;175
"1807";"360470284002";15;16;133;1;23;188
"1808";"360470284003";23;2;120;0;24;169
"1809";"360470285011";21;11;47;0;21;100
"1810";"360470285021";359;28;35;1;11;434
"1811";"360470286001";37;9;0;1;0;47
"1812";"360470286002";57;0;23;5;4;89
"1813";"360470286003";6;1;3;0;0;10
"1814";"360470286004";5;10;130;4;14;163
"1815";"360470286005";10;4;52;1;8;75
"1816";"360470287001";62;168;68;14;63;375
"1817";"360470287002";59;7;41;12;17;136
"1818";"360470287003";104;23;8;6;14;155
"1819";"360470288001";21;2;46;14;14;97
"1820";"360470288002";29;6;28;1;21;85
"1821";"360470288003";28;20;37;3;18;106
"1822";"360470289001";48;32;17;5;23;125
"1823";"360470289002";59;65;27;7;27;185
"1824";"360470289003";24;12;11;1;24;72
"1825";"360470289004";87;14;18;0;16;135
"1826";"360470290001";68;1;43;0;2;114
"1827";"360470290002";7;3;38;4;2;54
"1828";"360470290003";53;20;55;0;29;157
"1829";"360470291001";84;84;61;4;50;283
"1830";"360470291002";57;23;104;6;34;224
"1831";"360470291003";17;6;19;6;28;76
"1832";"360470292001";23;22;76;9;9;139
"1833";"360470292002";26;2;148;5;33;214
"1834";"360470293001";45;6;2;1;6;60
"1835";"360470293002";32;4;0;2;5;43
"1836";"360470293003";117;9;22;2;14;164
"1837";"360470293004";71;15;15;2;24;127
"1838";"360470294001";24;7;61;5;30;127
"1839";"360470295001";86;20;44;7;21;178
"1840";"360470295002";50;17;17;4;19;107
"1841";"360470295003";49;12;7;5;15;88
"1842";"360470295004";43;5;20;2;6;76
"1843";"360470296001";64;2;93;32;8;199
"1844";"360470296002";13;11;56;3;16;99
"1845";"360470296003";11;28;60;2;32;133
"1846";"360470296004";14;6;86;0;16;122
"1847";"360470297001";31;219;16;9;12;287
"1848";"360470297002";130;136;18;7;8;299
"1849";"360470297003";40;16;16;2;11;85
"1850";"360470298001";27;3;110;9;14;163
"1851";"360470298002";17;58;105;4;37;221
"1852";"360470298003";11;0;51;0;26;88
"1853";"360470299001";12;6;35;5;31;89
"1854";"360470299002";52;23;25;40;25;165
"1855";"360470300001";33;21;171;4;60;289
"1856";"360470300002";15;9;64;5;15;108
"1857";"360470301001";28;6;41;10;25;110
"1858";"360470301002";18;8;18;2;30;76
"1859";"360470301003";23;17;43;20;15;118
"1860";"360470302001";9;3;89;15;21;137
"1861";"360470302002";21;0;49;7;17;94
"1862";"360470302003";8;3;18;6;7;42
"1863";"360470303001";51;21;51;3;21;147
"1864";"360470303002";46;10;21;7;15;99
"1865";"360470303003";115;31;41;14;29;230
"1866";"360470304001";16;5;104;24;21;170
"1867";"360470304002";68;5;119;4;27;223
"1868";"360470304003";28;7;55;8;11;109
"1869";"360470305001";78;745;264;93;79;1259
"1870";"360470305002";109;92;90;3;29;323
"1871";"360470305003";126;62;24;1;22;235
"1872";"360470305004";224;70;17;12;15;338
"1873";"360470306001";66;14;192;19;52;343
"1874";"360470307001";109;4;5;0;4;122
"1875";"360470307002";79;4;11;0;7;101
"1876";"360470307003";204;86;113;26;62;491
"1877";"360470308001";215;25;127;23;27;417
"1878";"360470309001";88;56;44;11;21;220
"1879";"360470309002";20;4;38;14;22;98
"1880";"360470311001";73;6;57;3;37;176
"1881";"360470311002";149;150;36;5;17;357
"1882";"360470311003";61;26;37;4;19;147
"1883";"360470313001";90;19;29;11;29;178
"1884";"360470313002";39;12;25;8;26;110
"1885";"360470313003";136;32;24;2;25;219
"1886";"360470313004";33;7;124;4;22;190
"1887";"360470314001";44;6;80;9;15;154
"1888";"360470314002";13;15;79;19;6;132
"1889";"360470314003";4;4;7;4;2;21
"1890";"360470314004";70;4;97;5;29;205
"1891";"360470315001";135;214;163;4;59;575
"1892";"360470315002";140;34;13;1;11;199
"1893";"360470315003";132;110;24;4;31;301
"1894";"360470315004";190;167;8;10;47;422
"1895";"360470317011";196;31;102;10;25;364
"1896";"360470317012";53;68;26;2;24;173
"1897";"360470317013";247;48;28;5;34;362
"1898";"360470317021";193;59;11;5;22;290
"1899";"360470317022";109;24;11;1;20;165
"1900";"360470317023";324;63;45;4;47;483
"1901";"360470319001";145;75;30;9;13;272
"1902";"360470319002";19;24;43;2;10;98
"1903";"360470319003";160;9;66;30;20;285
"1904";"360470321001";53;48;8;0;11;120
"1905";"360470321002";73;44;16;1;5;139
"1906";"360470321003";161;71;12;0;10;254
"1907";"360470321004";56;58;36;4;14;168
"1908";"360470323001";199;66;19;1;16;301
"1909";"360470323002";66;8;15;5;9;103
"1910";"360470323003";95;25;41;18;8;187
"1911";"360470325001";84;38;17;3;45;187
"1912";"360470325002";129;26;15;0;13;183
"1913";"360470325003";161;26;17;31;12;247
"1914";"360470326001";37;23;46;2;30;138
"1915";"360470326002";94;29;12;2;20;157
"1916";"360470326003";91;15;9;1;15;131
"1917";"360470326004";37;16;3;0;9;65
"1918";"360470326005";27;15;30;10;8;90
"1919";"360470327001";49;68;32;9;21;179
"1920";"360470327002";165;40;41;9;10;265
"1921";"360470327003";30;18;19;6;13;86
"1922";"360470328001";39;10;19;3;7;78
"1923";"360470328002";8;4;17;0;1;30
"1924";"360470328003";565;10;6;2;9;592
"1925";"360470328004";23;4;20;5;8;60
"1926";"360470329001";75;12;50;17;18;172
"1927";"360470329002";142;14;20;7;35;218
"1928";"360470329003";161;519;23;1;20;724
"1929";"360470329004";56;54;13;2;26;151
"1930";"360470330001";42;14;3;0;11;70
"1931";"360470330002";10;0;7;1;4;22
"1932";"360470330003";148;23;15;30;6;222
"1933";"360470331001";278;17;33;9;7;344
"1934";"360470331002";228;9;13;3;7;260
"1935";"360470331003";9;5;10;3;5;32
"1936";"360470333001";20;4;23;0;10;57
"1937";"360470333002";36;11;80;10;8;145
"1938";"360470333003";56;1;30;5;5;97
"1939";"360470335001";71;12;117;2;15;217
"1940";"360470335002";16;2;35;5;9;67
"1941";"360470335003";9;29;65;14;9;126
"1942";"360470336001";12;1;11;1;8;33
"1943";"360470336002";9;8;6;3;13;39
"1944";"360470336003";1;0;1;0;8;10
"1945";"360470336004";29;2;1;1;6;39
"1946";"360470336005";6;8;6;1;17;38
"1947";"360470337001";53;12;39;15;16;135
"1948";"360470337002";49;37;40;31;24;181
"1949";"360470337003";79;53;48;8;34;222
"1950";"360470339001";109;7;64;13;13;206
"1951";"360470339002";113;127;37;3;23;303
"1952";"360470339003";32;12;27;2;8;81
"1953";"360470339004";76;16;20;3;16;131
"1954";"360470340001";241;10;26;2;6;285
"1955";"360470340002";5;8;2;1;0;16
"1956";"360470341001";55;24;20;3;9;111
"1957";"360470341002";103;26;25;7;12;173
"1958";"360470341003";146;13;14;5;10;188
"1959";"360470342001";168;11;9;4;12;204
"1960";"360470342002";75;13;16;0;10;114
"1961";"360470342003";281;13;9;0;14;317
"1962";"360470342004";25;3;2;0;2;32
"1963";"360470343001";369;12;6;1;8;396
"1964";"360470343002";37;14;68;7;10;136
"1965";"360470343003";124;170;38;15;29;376
"1966";"360470345001";90;14;23;6;13;146
"1967";"360470345002";51;52;53;38;31;225
"1968";"360470347001";65;4;38;5;11;123
"1969";"360470347002";146;19;42;2;12;221
"1970";"360470347003";232;23;50;4;29;338
"1971";"360470348001";44;16;195;69;49;373
"1972";"360470348002";41;6;53;6;34;140
"1973";"360470349001";69;126;5;1;10;211
"1974";"360470349002";87;8;70;6;10;181
"1975";"360470349003";171;25;97;7;40;340
"1976";"360470349004";41;23;7;3;12;86
"1977";"360470350001";3;1;1;2;2;9
"1978";"360470350002";4;39;18;1;27;89
"1979";"360470351001";164;41;64;1;18;288
"1980";"360470351002";112;15;29;5;22;183
"1981";"360470351003";166;26;39;2;36;269
"1982";"360470352001";11;48;20;4;16;99
"1983";"360470353001";217;38;49;3;27;334
"1984";"360470353002";190;33;59;11;14;307
"1985";"360470353003";192;64;44;3;17;320
"1986";"360470354001";4;5;20;0;19;48
"1987";"360470354002";26;7;25;4;24;86
"1988";"360470354003";3;16;6;1;4;30
"1989";"360470355001";386;50;53;6;20;515
"1990";"360470355002";46;8;22;2;22;100
"1991";"360470355003";155;27;43;7;20;252
"1992";"360470356011";4;5;6;2;3;20
"1993";"360470356021";39;3;27;2;1;72
"1994";"360470356022";17;6;16;0;4;43
"1995";"360470356023";20;28;44;2;7;101
"1996";"360470357001";670;45;84;9;39;847
"1997";"360470359001";101;31;68;5;29;234
"1998";"360470359002";110;12;51;5;16;194
"1999";"360470359003";128;24;50;26;13;241
"2000";"360470359004";178;14;34;17;30;273
"2001";"360470360011";26;24;8;0;11;69
"2002";"360470360012";37;8;7;1;5;58
"2003";"360470360013";21;5;16;0;3;45
"2004";"360470360021";122;25;12;0;23;182
"2005";"360470360022";205;91;9;1;17;323
"2006";"360470361001";23;6;8;6;14;57
"2007";"360470361002";24;11;27;7;15;84
"2008";"360470361003";29;12;21;54;11;127
"2009";"360470362001";110;57;131;2;69;369
"2010";"360470362002";42;13;119;4;44;222
"2011";"360470362003";29;13;94;9;44;189
"2012";"360470363001";23;10;13;10;16;72
"2013";"360470363002";49;25;62;17;18;171
"2014";"360470363003";69;18;33;7;26;153
"2015";"360470363004";38;9;15;2;8;72
"2016";"360470364001";54;16;106;1;52;229
"2017";"360470364002";34;9;125;4;39;211
"2018";"360470365011";33;8;30;8;22;101
"2019";"360470365012";48;8;141;16;24;237
"2020";"360470365021";57;15;107;38;65;282
"2021";"360470366001";35;21;102;45;27;230
"2022";"360470366002";58;13;81;14;20;186
"2023";"360470366003";35;2;56;44;16;153
"2024";"360470367001";73;13;51;9;29;175
"2025";"360470367002";4;6;26;3;8;47
"2026";"360470369001";113;21;37;10;15;196
"2027";"360470369002";44;5;29;8;26;112
"2028";"360470369003";91;17;35;9;37;189
"2029";"360470369004";95;12;47;8;27;189
"2030";"360470370001";16;9;82;17;42;166
"2031";"360470370002";9;1;43;1;5;59
"2032";"360470370003";1;2;117;11;8;139
"2033";"360470370004";3;0;52;32;2;89
"2034";"360470371001";27;12;29;4;21;93
"2035";"360470371002";27;10;17;7;13;74
"2036";"360470371003";22;5;65;1;11;104
"2037";"360470371004";27;5;35;0;11;78
"2038";"360470371005";19;3;32;4;17;75
"2039";"360470373001";45;12;16;1;22;96
"2040";"360470373002";16;4;22;8;16;66
"2041";"360470373003";62;23;11;4;30;130
"2042";"360470373004";68;41;21;3;23;156
"2043";"360470374011";31;11;143;2;21;208
"2044";"360470374012";37;8;128;9;20;202
"2045";"360470374013";37;3;35;3;25;103
"2046";"360470374021";8;23;56;18;13;118
"2047";"360470374022";35;5;13;4;3;60
"2048";"360470374023";23;1;10;0;4;38
"2049";"360470374024";10;8;159;9;10;196
"2050";"360470375001";56;33;19;14;13;135
"2051";"360470375002";150;75;35;11;56;327
"2052";"360470375003";144;104;15;10;18;291
"2053";"360470377001";151;63;25;12;20;271
"2054";"360470377002";142;42;21;18;14;237
"2055";"360470377003";111;23;21;3;23;181
"2056";"360470377004";98;9;68;11;21;207
"2057";"360470379001";94;36;24;4;20;178
"2058";"360470379002";78;17;118;16;30;259
"2059";"360470379003";94;25;53;20;19;211
"2060";"360470381001";104;30;21;9;14;178
"2061";"360470381002";132;23;8;2;12;177
"2062";"360470381003";80;55;51;8;21;215
"2063";"360470381004";98;37;7;8;31;181
"2064";"360470382001";17;4;51;2;31;105
"2065";"360470382002";149;5;15;2;3;174
"2066";"360470382003";58;0;2;2;0;62
"2067";"360470383001";101;49;44;4;27;225
"2068";"360470383002";126;24;52;6;16;224
"2069";"360470383003";19;11;23;5;26;84
"2070";"360470383004";45;17;25;6;19;112
"2071";"360470385001";66;13;15;3;21;118
"2072";"360470385002";78;39;35;5;12;169
"2073";"360470385003";79;53;48;6;37;223
"2074";"360470385004";25;18;33;6;16;98
"2075";"360470386001";41;10;149;67;56;323
"2076";"360470386002";18;6;119;23;56;222
"2077";"360470387001";27;17;58;15;20;137
"2078";"360470387002";35;3;16;4;22;80
"2079";"360470387003";33;7;43;1;18;102
"2080";"360470387004";63;47;52;4;22;188
"2081";"360470388001";23;0;26;6;3;58
"2082";"360470388002";9;3;45;8;18;83
"2083";"360470388003";9;5;77;7;19;117
"2084";"360470388004";11;4;31;3;1;50
"2085";"360470389001";108;65;37;23;27;260
"2086";"360470389002";88;36;33;5;25;187
"2087";"360470389003";160;96;34;3;63;356
"2088";"360470390001";45;1;55;33;23;157
"2089";"360470390002";4;3;77;13;8;105
"2090";"360470391001";80;39;32;26;21;198
"2091";"360470391002";165;49;44;6;65;329
"2092";"360470392001";18;67;112;25;17;239
"2093";"360470392002";47;7;34;33;13;134
"2094";"360470393001";163;7;76;4;105;355
"2095";"360470393002";86;77;77;5;27;272
"2096";"360470393003";143;72;27;7;45;294
"2097";"360470394001";53;27;34;4;26;144
"2098";"360470394002";14;2;38;9;10;73
"2099";"360470394003";11;5;30;10;11;67
"2100";"360470395001";103;54;53;4;19;233
"2101";"360470395002";139;32;22;8;30;231
"2102";"360470395003";52;19;59;7;29;166
"2103";"360470396001";12;1;53;11;24;101
"2104";"360470396002";14;3;65;11;15;108
"2105";"360470397001";85;19;89;3;37;233
"2106";"360470397002";122;126;54;4;30;336
"2107";"360470397003";124;28;75;8;49;284
"2108";"360470398001";37;60;161;197;73;528
"2109";"360470398002";29;9;69;30;38;175
"2110";"360470399001";126;24;89;7;50;296
"2111";"360470399002";111;42;32;9;31;225
"2112";"360470399003";28;11;29;6;22;96
"2113";"360470400001";15;2;126;47;53;243
"2114";"360470400002";9;8;45;1;13;76
"2115";"360470400003";25;4;46;2;22;99
"2116";"360470401001";56;13;16;1;7;93
"2117";"360470401002";159;18;49;20;34;280
"2118";"360470401003";114;14;90;10;28;256
"2119";"360470402001";16;17;88;41;32;194
"2120";"360470402002";20;12;87;20;23;162
"2121";"360470403001";178;34;47;21;38;318
"2122";"360470403002";64;19;41;8;28;160
"2123";"360470403003";93;16;18;7;30;164
"2124";"360470404001";9;10;104;5;10;138
"2125";"360470404002";6;15;79;13;33;146
"2126";"360470405001";79;33;126;90;54;382
"2127";"360470405002";37;6;33;7;16;99
"2128";"360470406001";13;9;123;6;22;173
"2129";"360470406002";8;5;54;1;7;75
"2130";"360470406003";47;8;96;13;15;179
"2131";"360470407001";1;0;7;11;0;19
"2132";"360470408001";7;20;30;1;15;73
"2133";"360470408002";50;7;35;4;15;111
"2134";"360470408003";4;5;67;8;16;100
"2135";"360470409001";83;30;46;8;26;193
"2136";"360470409002";302;125;41;4;23;495
"2137";"360470409003";57;18;52;7;9;143
"2138";"360470410001";11;24;107;43;26;211
"2139";"360470410002";3;4;42;5;8;62
"2140";"360470411001";175;52;28;2;23;280
"2141";"360470411002";30;17;20;2;17;86
"2142";"360470411003";113;8;34;1;20;176
"2143";"360470412001";16;16;67;10;35;144
"2144";"360470412002";78;10;375;4;30;497
"2145";"360470413001";90;15;37;14;24;180
"2146";"360470413002";93;64;36;3;28;224
"2147";"360470413003";89;22;20;0;19;150
"2148";"360470414011";5;11;24;11;9;60
"2149";"360470414012";6;9;631;21;33;700
"2150";"360470414021";251;2;15;9;6;283
"2151";"360470414022";27;6;18;9;7;67
"2152";"360470415001";125;16;44;4;36;225
"2153";"360470415002";169;63;40;5;30;307
"2154";"360470415003";82;4;43;4;14;147
"2155";"360470416001";34;5;67;4;23;133
"2156";"360470416002";44;1;33;1;5;84
"2157";"360470417001";32;6;17;3;6;64
"2158";"360470417002";80;9;17;11;14;131
"2159";"360470417003";56;31;29;1;14;131
"2160";"360470417004";29;33;15;1;10;88
"2161";"360470418001";38;19;42;1;16;116
"2162";"360470418002";14;3;26;3;13;59
"2163";"360470419001";155;50;50;9;34;298
"2164";"360470419002";123;75;51;26;17;292
"2165";"360470419003";75;12;20;12;10;129
"2166";"360470420001";17;23;52;18;21;131
"2167";"360470420002";5;10;43;8;15;81
"2168";"360470421001";63;42;30;10;20;165
"2169";"360470421002";88;28;37;16;26;195
"2170";"360470421003";78;46;27;7;26;184
"2171";"360470421004";78;139;55;29;19;320
"2172";"360470422001";29;5;96;2;22;154
"2173";"360470422002";18;5;112;10;38;183
"2174";"360470422003";23;3;51;9;51;137
"2175";"360470423001";158;30;89;14;47;338
"2176";"360470423002";136;105;74;12;38;365
"2177";"360470423003";44;18;23;2;16;103
"2178";"360470424001";12;11;76;5;34;138
"2179";"360470424002";21;12;92;11;17;153
"2180";"360470424003";22;6;169;2;12;211
"2181";"360470425001";82;53;71;10;24;240
"2182";"360470425002";134;61;31;5;31;262
"2183";"360470425003";80;46;70;21;33;250
"2184";"360470426001";27;7;79;4;12;129
"2185";"360470426002";23;2;104;18;26;173
"2186";"360470426003";10;102;64;7;13;196
"2187";"360470427001";184;90;30;4;24;332
"2188";"360470427002";182;61;60;1;26;330
"2189";"360470427003";270;123;37;6;39;475
"2190";"360470427004";37;31;33;8;30;139
"2191";"360470428001";9;5;83;3;9;109
"2192";"360470428002";56;1;77;5;17;156
"2193";"360470428003";24;7;59;1;7;98
"2194";"360470429001";70;52;34;3;20;179
"2195";"360470429002";119;45;26;0;23;213
"2196";"360470429003";134;147;26;0;46;353
"2197";"360470429004";191;35;7;1;34;268
"2198";"360470430001";10;13;70;7;15;115
"2199";"360470430002";11;11;49;8;15;94
"2200";"360470430003";51;20;88;11;22;192
"2201";"360470431001";67;40;84;6;21;218
"2202";"360470431002";94;74;11;1;26;206
"2203";"360470431003";138;38;4;4;20;204
"2204";"360470431004";132;189;34;2;49;406
"2205";"360470432001";28;5;152;5;24;214
"2206";"360470432002";46;14;99;7;60;226
"2207";"360470432003";47;7;81;10;38;183
"2208";"360470433001";43;21;3;12;5;84
"2209";"360470433002";125;145;22;3;28;323
"2210";"360470433003";139;94;14;1;33;281
"2211";"360470434001";123;16;85;3;12;239
"2212";"360470434002";29;5;91;3;17;145
"2213";"360470434003";71;5;63;8;22;169
"2214";"360470435001";135;28;119;1;33;316
"2215";"360470435002";102;65;51;8;30;256
"2216";"360470435003";99;22;25;5;24;175
"2217";"360470436001";29;4;69;14;18;134
"2218";"360470436002";25;20;29;2;23;99
"2219";"360470436003";25;1;79;1;13;119
"2220";"360470437001";146;25;57;5;7;240
"2221";"360470437002";166;63;25;3;27;284
"2222";"360470437003";76;30;36;4;31;177
"2223";"360470437004";307;53;9;1;33;403
"2224";"360470438001";32;27;52;13;16;140
"2225";"360470438002";69;72;157;23;71;392
"2226";"360470439001";197;88;94;7;36;422
"2227";"360470439002";121;24;84;3;33;265
"2228";"360470439003";127;60;129;5;45;366
"2229";"360470440001";7;3;60;11;11;92
"2230";"360470440002";17;6;152;25;15;215
"2231";"360470440003";7;18;154;19;72;270
"2232";"360470441001";240;225;81;5;65;616
"2233";"360470441002";112;37;27;5;36;217
"2234";"360470441003";150;41;21;3;11;226
"2235";"360470442001";92;15;44;11;13;175
"2236";"360470442002";9;1;77;9;9;105
"2237";"360470443001";46;5;10;3;5;69
"2238";"360470443002";127;67;71;13;23;301
"2239";"360470443003";126;46;44;1;22;239
"2240";"360470443004";80;23;20;3;14;140
"2241";"360470444001";1;0;71;8;11;91
"2242";"360470444002";10;0;79;16;10;115
"2243";"360470444003";199;22;63;2;16;302
"2244";"360470445001";116;16;78;4;16;230
"2245";"360470445002";148;64;65;3;20;300
"2246";"360470445003";162;254;58;6;27;507
"2247";"360470446001";9;1;66;7;23;106
"2248";"360470446002";4;8;93;1;9;115
"2249";"360470447001";224;129;86;16;45;500
"2250";"360470447002";57;141;127;12;55;392
"2251";"360470448001";6;52;111;13;20;202
"2252";"360470448002";32;3;73;2;24;134
"2253";"360470449001";35;43;6;2;6;92
"2254";"360470449002";81;82;6;5;11;185
"2255";"360470449003";101;71;135;26;64;397
"2256";"360470449004";21;314;191;91;117;734
"2257";"360470450001";8;19;145;15;26;213
"2258";"360470452001";5;0;74;17;6;102
"2259";"360470452002";30;4;25;11;12;82
"2260";"360470453001";78;113;161;24;99;475
"2261";"360470453002";231;184;62;29;71;577
"2262";"360470454001";14;5;46;2;40;107
"2263";"360470454002";0;1;46;10;6;63
"2264";"360470456001";18;14;48;17;37;134
"2265";"360470456002";65;15;42;24;10;156
"2266";"360470458001";47;6;68;15;3;139
"2267";"360470458002";12;0;22;12;1;47
"2268";"360470460001";29;7;93;14;11;154
"2269";"360470460002";40;14;109;3;31;197
"2270";"360470460003";9;10;80;24;43;166
"2271";"360470462011";98;8;139;11;18;274
"2272";"360470462012";34;31;453;9;9;536
"2273";"360470462021";3;5;55;2;11;76
"2274";"360470462022";13;12;107;15;39;186
"2275";"360470464001";4;11;37;10;20;82
"2276";"360470464002";7;4;57;7;46;121
"2277";"360470468001";26;57;201;20;38;342
"2278";"360470470001";11;10;66;15;9;111
"2279";"360470470002";6;6;61;2;12;87
"2280";"360470472001";1;0;22;23;2;48
"2281";"360470472002";10;22;108;5;16;161
"2282";"360470472003";0;0;25;8;2;35
"2283";"360470474001";2;5;94;26;9;136
"2284";"360470474002";0;1;27;8;7;43
"2285";"360470476001";17;98;65;38;14;232
"2286";"360470476002";1;6;21;5;4;37
"2287";"360470476003";3;1;94;5;5;108
"2288";"360470477001";122;32;82;36;51;323
"2289";"360470477002";109;199;74;10;52;444
"2290";"360470478001";23;61;110;32;51;277
"2291";"360470478002";5;3;25;7;17;57
"2292";"360470478003";19;8;130;35;21;213
"2293";"360470480001";47;9;89;5;27;177
"2294";"360470480002";15;48;151;28;29;271
"2295";"360470481001";52;14;14;0;37;117
"2296";"360470481002";27;9;115;22;33;206
"2297";"360470481003";119;45;50;7;38;259
"2298";"360470482001";37;47;196;69;34;383
"2299";"360470482002";22;24;73;32;30;181
"2300";"360470482003";22;8;151;13;13;207
"2301";"360470482004";128;77;109;14;20;348
"2302";"360470484001";54;20;80;12;30;196
"2303";"360470484002";26;50;436;6;20;538
"2304";"360470484003";20;4;40;6;11;81
"2305";"360470485001";298;188;280;40;128;934
"2306";"360470485002";232;361;145;51;79;868
"2307";"360470486001";21;20;119;7;54;221
"2308";"360470486002";208;42;61;19;27;357
"2309";"360470486003";7;46;58;18;43;172
"2310";"360470488001";31;19;131;6;32;219
"2311";"360470488002";14;9;542;15;16;596
"2312";"360470488003";9;5;101;5;18;138
"2313";"360470489001";122;37;1;0;5;165
"2314";"360470489002";39;5;4;0;6;54
"2315";"360470489003";452;45;2;0;2;501
"2316";"360470490001";215;18;70;4;19;326
"2317";"360470490002";112;14;147;4;14;291
"2318";"360470490003";44;4;115;6;19;188
"2319";"360470491001";25;16;6;3;5;55
"2320";"360470491002";59;971;19;2;53;1104
"2321";"360470491003";173;94;23;8;17;315
"2322";"360470491004";24;8;12;4;6;54
"2323";"360470492001";52;18;79;28;18;195
"2324";"360470492002";46;39;104;35;47;271
"2325";"360470492003";63;30;110;31;33;267
"2326";"360470493001";422;20;5;0;11;458
"2327";"360470493002";299;122;38;1;53;513
"2328";"360470493003";59;52;15;6;16;148
"2329";"360470493004";65;5;4;1;6;81
"2330";"360470493005";99;103;4;6;40;252
"2331";"360470494001";69;15;52;6;18;160
"2332";"360470494002";45;11;74;8;12;150
"2333";"360470494003";25;9;55;2;7;98
"2334";"360470494004";6;2;28;1;1;38
"2335";"360470495001";41;54;29;6;23;153
"2336";"360470495002";78;43;31;15;27;194
"2337";"360470495003";33;130;38;10;32;243
"2338";"360470496001";22;15;91;12;27;167
"2339";"360470496002";22;4;72;10;31;139
"2340";"360470496003";18;17;71;9;23;138
"2341";"360470497001";23;22;47;11;50;153
"2342";"360470497002";46;29;31;9;40;155
"2343";"360470497003";48;18;36;8;35;145
"2344";"360470498001";50;43;42;15;28;178
"2345";"360470498002";50;25;58;5;25;163
"2346";"360470498003";12;5;101;19;10;147
"2347";"360470499001";16;23;17;3;43;102
"2348";"360470499002";32;7;55;12;39;145
"2349";"360470500001";12;0;21;2;7;42
"2350";"360470500002";12;30;40;5;10;97
"2351";"360470500003";46;2;47;7;6;108
"2352";"360470501001";19;4;39;11;27;100
"2353";"360470501002";36;17;13;1;16;83
"2354";"360470501003";39;93;87;28;53;300
"2355";"360470502021";4;6;37;3;22;72
"2356";"360470502022";21;13;101;5;16;156
"2357";"360470503001";53;76;87;17;35;268
"2358";"360470503002";105;37;39;5;21;207
"2359";"360470503003";39;116;46;26;28;255
"2360";"360470504001";7;21;19;3;11;61
"2361";"360470504002";66;75;125;31;26;323
"2362";"360470504003";114;10;110;43;35;312
"2363";"360470505001";86;62;4;0;15;167
"2364";"360470505002";118;80;20;6;45;269
"2365";"360470505003";138;160;19;3;30;350
"2366";"360470506001";148;39;22;1;15;225
"2367";"360470506002";188;21;65;2;30;306
"2368";"360470506003";168;32;18;0;19;237
"2369";"360470506004";84;21;19;1;16;141
"2370";"360470507001";21;18;127;110;70;346
"2371";"360470508011";134;13;10;6;8;171
"2372";"360470508012";168;23;19;1;29;240
"2373";"360470508031";380;105;42;4;27;558
"2374";"360470508041";119;139;98;6;26;388
"2375";"360470508042";198;104;88;2;23;415
"2376";"360470508043";176;20;34;4;18;252
"2377";"360470509001";24;89;116;61;14;304
"2378";"360470509002";5;9;55;21;18;108
"2379";"360470510011";71;17;6;0;10;104
"2380";"360470510012";394;188;16;3;21;622
"2381";"360470510021";162;31;29;6;15;243
"2382";"360470510022";201;9;8;0;10;228
"2383";"360470510023";94;26;11;0;4;135
"2384";"360470511001";7;21;9;1;6;44
"2385";"360470511002";194;31;36;6;38;305
"2386";"360470511003";74;148;49;4;29;304
"2387";"360470512001";216;87;39;5;25;372
"2388";"360470512002";278;32;11;3;11;335
"2389";"360470512003";122;59;10;20;11;222
"2390";"360470512004";68;50;43;32;11;204
"2391";"360470513001";60;195;113;14;43;425
"2392";"360470513002";97;65;17;4;7;190
"2393";"360470513003";201;196;99;14;100;610
"2394";"360470513004";51;90;6;11;7;165
"2395";"360470514001";33;18;59;21;17;148
"2396";"360470514002";118;41;20;5;21;205
"2397";"360470514003";136;52;78;9;24;299
"2398";"360470514004";131;25;41;1;16;214
"2399";"360470515001";110;122;69;13;35;349
"2400";"360470516011";130;21;28;4;18;201
"2401";"360470516012";117;18;55;5;14;209
"2402";"360470516013";312;92;120;6;38;568
"2403";"360470516021";151;59;38;8;23;279
"2404";"360470516022";469;142;31;12;54;708
"2405";"360470517001";34;59;40;4;33;170
"2406";"360470517002";48;110;42;7;38;245
"2407";"360470518001";66;2;55;14;6;143
"2408";"360470518002";60;52;61;13;8;194
"2409";"360470518003";28;11;20;4;11;74
"2410";"360470519001";180;72;74;30;50;406
"2411";"360470519002";82;45;98;15;46;286
"2412";"360470519003";122;139;178;14;57;510
"2413";"360470520001";62;16;59;6;15;158
"2414";"360470520002";9;26;77;14;21;147
"2415";"360470520003";22;16;6;2;9;55
"2416";"360470523001";154;541;14;0;42;751
"2417";"360470523002";99;378;29;0;27;533
"2418";"360470523003";132;60;30;10;22;254
"2419";"360470523004";79;58;8;4;12;161
"2420";"360470523005";41;150;35;1;34;261
"2421";"360470525001";191;74;20;22;54;361
"2422";"360470525002";26;17;13;4;21;81
"2423";"360470526001";60;41;71;21;34;227
"2424";"360470526002";67;15;120;14;26;242
"2425";"360470526003";10;2;47;7;5;71
"2426";"360470527001";75;38;39;5;38;195
"2427";"360470527002";43;134;5;7;28;217
"2428";"360470527003";92;127;24;11;80;334
"2429";"360470527004";69;57;17;3;35;181
"2430";"360470527005";197;406;3;4;23;633
"2431";"360470527006";127;776;35;25;27;990
"2432";"360470527007";30;29;17;0;12;88
"2433";"360470528001";17;4;63;13;6;103
"2434";"360470528002";6;5;145;13;33;202
"2435";"360470529001";3;7;46;8;9;73
"2436";"360470529002";26;10;5;12;16;69
"2437";"360470529003";9;19;11;4;32;75
"2438";"360470530001";41;14;30;3;10;98
"2439";"360470530002";56;18;53;7;8;142
"2440";"360470530003";36;7;103;40;7;193
"2441";"360470531001";11;9;54;4;20;98
"2442";"360470531002";5;3;16;5;4;33
"2443";"360470531003";0;1;6;0;8;15
"2444";"360470531004";2;1;13;3;4;23
"2445";"360470532001";25;21;76;7;16;145
"2446";"360470532002";7;13;82;10;14;126
"2447";"360470533001";1;0;7;7;1;16
"2448";"360470533002";0;0;9;2;1;12
"2449";"360470533003";0;2;4;1;0;7
"2450";"360470533004";13;0;11;2;2;28
"2451";"360470533005";3;10;14;3;0;30
"2452";"360470534001";49;9;62;10;22;152
"2453";"360470534002";15;3;33;6;12;69
"2454";"360470534003";21;6;43;3;18;91
"2455";"360470534004";27;11;47;1;7;93
"2456";"360470535001";2;2;6;0;9;19
"2457";"360470535002";1;1;6;0;12;20
"2458";"360470535003";2;3;38;2;8;53
"2459";"360470535004";1;24;53;5;9;92
"2460";"360470537001";0;0;14;6;5;25
"2461";"360470537002";2;3;23;8;14;50
"2462";"360470538001";26;36;40;2;10;114
"2463";"360470538002";228;8;49;8;15;308
"2464";"360470538003";35;84;111;7;18;255
"2465";"360470539001";0;2;33;12;3;50
"2466";"360470539002";25;9;20;2;5;61
"2467";"360470542001";35;5;193;14;68;315
"2468";"360470542002";36;27;78;13;25;179
"2469";"360470542003";3;0;94;2;8;107
"2470";"360470543001";6;15;32;5;7;65
"2471";"360470543002";13;35;121;54;54;277
"2472";"360470544001";14;3;98;6;11;132
"2473";"360470544002";37;7;180;7;14;245
"2474";"360470544003";2;4;135;12;4;157
"2475";"360470545001";1;0;7;7;4;19
"2476";"360470545002";1;6;3;0;5;15
"2477";"360470545003";83;8;10;5;6;112
"2478";"360470545004";1;2;0;0;0;3
"2479";"360470545005";185;27;14;0;15;241
"2480";"360470545006";49;13;15;2;6;85
"2481";"360470546001";13;22;72;7;4;118
"2482";"360470546002";50;3;81;0;16;150
"2483";"360470546003";40;15;81;22;7;165
"2484";"360470547001";66;31;10;10;20;137
"2485";"360470547002";19;3;167;2;16;207
"2486";"360470547003";43;46;92;19;18;218
"2487";"360470548001";16;1;45;26;15;103
"2488";"360470548002";9;1;40;54;4;108
"2489";"360470549001";50;129;67;1;35;282
"2490";"360470549002";125;319;138;13;73;668
"2491";"360470550001";118;2;52;24;11;207
"2492";"360470550002";32;3;229;35;13;312
"2493";"360470550003";59;24;66;5;20;174
"2494";"360470551001";72;157;122;11;30;392
"2495";"360470551002";76;40;32;10;40;198
"2496";"360470551003";142;137;37;5;25;346
"2497";"360470551004";83;40;15;1;18;157
"2498";"360470552001";73;5;70;3;17;168
"2499";"360470552002";69;30;77;10;15;201
"2500";"360470552003";15;4;58;10;14;101
"2501";"360470553001";73;179;56;44;48;400
"2502";"360470553002";38;62;49;16;42;207
"2503";"360470553003";79;207;82;11;52;431
"2504";"360470554001";36;12;63;8;17;136
"2505";"360470554002";36;15;37;1;8;97
"2506";"360470554003";25;42;64;4;19;154
"2507";"360470555001";390;545;380;45;120;1480
"2508";"360470556001";20;9;86;2;25;142
"2509";"360470556002";23;1;74;8;2;108
"2510";"360470556003";52;3;68;6;29;158
"2511";"360470557001";38;51;42;1;23;155
"2512";"360470557002";110;225;98;11;51;495
"2513";"360470558001";24;6;74;2;15;121
"2514";"360470558002";18;102;137;18;24;299
"2515";"360470560001";14;3;130;40;16;203
"2516";"360470560002";18;1;60;2;6;87
"2517";"360470560003";26;3;35;9;8;81
"2518";"360470561001";64;31;65;5;41;206
"2519";"360470561002";17;3;9;8;23;60
"2520";"360470561003";27;72;61;4;47;211
"2521";"360470561004";32;47;50;8;35;172
"2522";"360470562001";1;1;34;25;13;74
"2523";"360470562002";7;0;78;68;7;160
"2524";"360470563001";37;67;59;4;29;196
"2525";"360470563002";162;159;80;6;36;443
"2526";"360470563003";53;30;55;7;35;180
"2527";"360470563004";117;79;164;2;24;386
"2528";"360470564001";5;3;32;22;15;77
"2529";"360470564002";7;1;40;5;8;61
"2530";"360470564003";1;2;20;9;6;38
"2531";"360470565001";27;155;84;7;67;340
"2532";"360470565002";72;18;48;13;26;177
"2533";"360470565003";32;43;20;9;24;128
"2534";"360470566001";71;4;63;40;21;199
"2535";"360470566002";8;5;18;21;18;70
"2536";"360470568001";4;3;32;10;15;64
"2537";"360470568002";3;0;33;20;2;58
"2538";"360470569001";73;144;17;14;89;337
"2539";"360470569002";53;46;44;4;59;206
"2540";"360470570001";8;2;3;3;1;17
"2541";"360470570002";5;1;10;6;2;24
"2542";"360470570003";3;2;4;4;7;20
"2543";"360470570004";14;19;47;39;25;144
"2544";"360470571001";47;105;28;5;29;214
"2545";"360470571002";22;16;24;6;11;79
"2546";"360470571003";16;25;17;11;34;103
"2547";"360470571004";25;14;28;4;20;91
"2548";"360470572001";393;21;9;11;8;442
"2549";"360470572002";207;15;6;11;19;258
"2550";"360470573001";43;25;31;6;25;130
"2551";"360470573002";63;8;27;2;13;113
"2552";"360470573003";40;11;30;10;13;104
"2553";"360470574001";6;13;23;19;18;79
"2554";"360470574002";7;2;42;4;21;76
"2555";"360470575001";33;11;23;4;40;111
"2556";"360470575002";16;27;28;6;27;104
"2557";"360470575003";19;18;30;12;39;118
"2558";"360470575004";51;28;29;2;37;147
"2559";"360470576001";4;3;43;15;16;81
"2560";"360470576002";12;1;54;28;17;112
"2561";"360470578001";40;6;134;31;29;240
"2562";"360470578002";61;10;82;1;45;199
"2563";"360470579001";64;12;31;5;26;138
"2564";"360470579002";21;17;149;29;52;268
"2565";"360470580001";105;6;84;8;30;233
"2566";"360470580002";23;5;65;5;35;133
"2567";"360470582001";5;3;66;4;37;115
"2568";"360470582002";3;12;37;2;14;68
"2569";"360470582003";32;7;60;1;29;129
"2570";"360470584001";22;5;80;9;20;136
"2571";"360470584002";111;12;104;14;22;263
"2572";"360470586001";8;9;75;12;28;132
"2573";"360470586002";5;4;69;14;6;98
"2574";"360470588001";52;1;120;9;29;211
"2575";"360470588002";58;13;24;1;10;106
"2576";"360470589001";32;52;78;8;30;200
"2577";"360470589002";38;23;29;5;21;116
"2578";"360470590001";31;30;122;35;36;254
"2579";"360470591001";16;13;21;6;10;66
"2580";"360470591002";37;16;13;14;9;89
"2581";"360470591003";36;23;26;6;20;111
"2582";"360470591004";9;36;31;0;17;93
"2583";"360470592001";15;2;47;3;13;80
"2584";"360470592002";46;16;122;25;23;232
"2585";"360470592003";51;4;16;2;31;104
"2586";"360470593001";5;7;50;11;17;90
"2587";"360470593002";64;30;17;5;14;130
"2588";"360470594011";3;3;27;24;7;64
"2589";"360470594012";4;1;170;35;11;221
"2590";"360470594013";9;2;79;63;27;180
"2591";"360470594014";9;13;92;54;26;194
"2592";"360470594015";29;2;31;6;23;91
"2593";"360470594016";93;14;55;22;16;200
"2594";"360470594021";16;12;33;6;32;99
"2595";"360470594022";48;3;120;28;24;223
"2596";"360470594023";10;0;133;72;4;219
"2597";"360470594024";2;1;38;13;10;64
"2598";"360470596001";22;12;3;9;5;51
"2599";"360470596002";1;7;8;2;1;19
"2600";"360470596003";11;11;112;35;19;188
"2601";"360470598001";28;5;36;17;18;104
"2602";"360470598002";25;8;40;27;15;115
"2603";"360470600001";7;6;125;19;14;171
"2604";"360470600002";16;2;113;45;18;194
"2605";"360470600003";21;4;268;304;34;631
"2606";"360470600004";12;4;75;13;26;130
"2607";"360470600005";17;8;74;10;32;141
"2608";"360470606001";39;14;56;5;56;170
"2609";"360470606002";12;8;46;30;16;112
"2610";"360470608001";39;29;97;37;28;230
"2611";"360470608002";59;11;68;37;34;209
"2612";"360470608003";78;26;89;3;34;230
"2613";"360470610021";25;7;87;1;14;134
"2614";"360470610022";142;9;13;1;5;170
"2615";"360470610031";10;4;19;4;18;55
"2616";"360470610032";24;4;31;1;30;90
"2617";"360470610041";10;5;63;0;81;159
"2618";"360470610042";20;6;129;1;19;175
"2619";"360470610043";25;18;131;11;7;192
"2620";"360470610044";213;2;27;2;6;250
"2621";"360470610045";40;6;29;2;14;91
"2622";"360470612001";19;6;46;12;30;113
"2623";"360470616001";22;21;152;2;30;227
"2624";"360470620001";18;20;27;2;20;87
"2625";"360470620002";2;15;41;3;13;74
"2626";"360470622001";46;6;103;22;54;231
"2627";"360470622002";22;24;134;83;52;315
"2628";"360470626001";24;6;76;28;20;154
"2629";"360470626002";10;31;89;34;17;181
"2630";"360470628001";18;12;46;41;27;144
"2631";"360470628002";23;10;124;22;58;237
"2632";"360470628003";5;8;26;11;20;70
"2633";"360470628004";38;4;44;32;41;159
"2634";"360470632001";28;7;7;7;7;56
"2635";"360470632002";13;4;24;5;10;56
"2636";"360470636001";17;5;127;39;23;211
"2637";"360470638001";6;3;11;11;2;33
"2638";"360470638002";5;8;21;20;2;56
"2639";"360470640001";60;1;39;20;19;139
"2640";"360470640002";1;2;59;12;11;85
"2641";"360470642001";24;6;84;82;15;211
"2642";"360470642002";31;7;41;19;4;102
"2643";"360470644001";26;2;78;19;25;150
"2644";"360470644002";28;12;80;51;35;206
"2645";"360470646001";9;7;40;31;13;100
"2646";"360470646002";19;5;74;27;22;147
"2647";"360470648001";90;10;65;80;32;277
"2648";"360470648002";7;2;56;19;19;103
"2649";"360470650001";11;12;50;14;18;105
"2650";"360470650002";57;4;81;61;12;215
"2651";"360470652001";6;192;74;9;27;308
"2652";"360470654001";2;3;40;37;9;91
"2653";"360470654002";33;5;19;18;25;100
"2654";"360470656001";18;16;28;14;6;82
"2655";"360470656002";2;2;36;25;12;77
"2656";"360470658001";6;8;67;4;13;98
"2657";"360470658002";11;3;67;7;16;104
"2658";"360470660001";9;0;51;20;9;89
"2659";"360470660002";8;3;21;32;6;70
"2660";"360470662001";39;19;142;49;54;303
"2661";"360470666001";12;57;56;21;13;159
"2662";"360470670001";44;1;110;39;8;202
"2663";"360470670002";64;7;126;75;53;325
"2664";"360470672001";124;18;111;110;30;393
"2665";"360470674001";13;7;50;38;72;180
"2666";"360470674002";41;9;98;137;8;293
"2667";"360470676001";15;1;47;33;4;100
"2668";"360470676002";18;32;90;58;11;209
"2669";"360470678001";22;3;87;55;10;177
"2670";"360470678002";53;3;82;74;9;221
"2671";"360470680001";26;12;69;68;6;181
"2672";"360470680002";28;50;114;45;15;252
"2673";"360470682001";61;84;56;69;21;291
"2674";"360470682002";88;3;73;91;8;263
"2675";"360470686001";4;2;36;40;24;106
"2676";"360470686002";10;1;56;30;18;115
"2677";"360470688001";33;4;58;24;22;141
"2678";"360470688002";14;0;29;15;7;65
"2679";"360470690001";21;5;50;42;6;124
"2680";"360470690002";75;17;69;63;9;233
"2681";"360470692001";77;7;134;111;26;355
"2682";"360470692002";26;6;48;22;4;106
"2683";"360470696011";77;6;194;32;29;338
"2684";"360470696012";60;4;153;23;34;274
"2685";"360470696021";6;6;31;20;15;78
"2686";"360470696022";76;6;94;73;17;266
"2687";"360470696023";59;14;225;36;47;381
"2688";"360470698001";6;1;8;9;13;37
"2689";"360470698002";35;35;131;49;41;291
"2690";"360470700001";3;2;39;10;3;57
"2691";"360470700002";11;10;86;74;13;194
"2692";"360470702011";16;4;34;14;7;75
"2693";"360470702012";7;0;6;18;17;48
"2694";"360470702013";23;2;43;16;9;93
"2695";"360470702014";8;39;150;37;18;252
"2696";"360470702015";20;2;111;62;33;228
"2697";"360470702021";0;1;0;1;2;4
"2698";"360470706001";26;26;83;23;86;244
"2699";"360470706002";31;273;124;36;45;509
"2700";"360470720001";65;15;153;146;38;417
"2701";"360470722001";49;8;127;49;12;245
"2702";"360470722002";28;4;95;119;23;269
"2703";"360470724001";34;4;39;7;13;97
"2704";"360470724002";20;10;43;87;14;174
"2705";"360470726001";77;20;112;132;32;373
"2706";"360470728001";158;21;139;21;16;355
"2707";"360470728002";17;10;39;53;17;136
"2708";"360470730001";19;15;89;74;6;203
"2709";"360470730002";54;3;38;33;11;139
"2710";"360470732001";50;1;79;16;23;169
"2711";"360470732002";40;5;83;28;9;165
"2712";"360470734001";13;3;29;9;8;62
"2713";"360470734002";18;7;68;15;18;126
"2714";"360470736001";107;0;32;44;3;186
"2715";"360470736002";16;2;30;17;11;76
"2716";"360470736003";49;12;30;13;34;138
"2717";"360470738001";41;18;172;16;27;274
"2718";"360470738002";147;5;54;19;1;226
"2719";"360470738003";36;7;75;62;11;191
"2720";"360470740001";100;14;82;26;19;241
"2721";"360470740002";62;16;86;15;22;201
"2722";"360470742001";80;12;229;29;25;375
"2723";"360470742002";143;16;89;21;14;283
"2724";"360470744001";5;1;89;20;5;120
"2725";"360470744002";2;14;53;15;11;95
"2726";"360470746001";24;9;51;12;9;105
"2727";"360470746002";9;24;90;18;19;160
"2728";"360470748001";29;2;68;41;13;153
"2729";"360470748002";3;2;28;14;0;47
"2730";"360470750001";6;1;71;4;18;100
"2731";"360470750002";80;2;49;16;6;153
"2732";"360470752001";2;1;62;16;11;92
"2733";"360470754001";7;1;18;14;4;44
"2734";"360470754002";2;1;18;18;4;43
"2735";"360470756001";20;7;71;15;13;126
"2736";"360470756002";4;2;43;13;8;70
"2737";"360470758001";3;2;109;17;9;140
"2738";"360470758002";12;8;53;4;5;82
"2739";"360470760001";2;0;34;6;0;42
"2740";"360470760002";20;0;47;3;7;77
"2741";"360470760003";37;1;18;0;15;71
"2742";"360470762001";134;3;28;4;1;170
"2743";"360470762002";21;2;56;4;5;88
"2744";"360470762003";82;7;40;0;14;143
"2745";"360470764001";130;8;64;6;9;217
"2746";"360470764002";91;17;73;9;7;197
"2747";"360470764003";33;55;289;0;3;380
"2748";"360470766001";152;21;124;12;8;317
"2749";"360470768001";32;13;65;19;22;151
"2750";"360470768002";13;12;74;3;11;113
"2751";"360470768003";11;4;113;2;41;171
"2752";"360470770001";46;59;73;32;25;235
"2753";"360470770002";74;40;138;37;27;316
"2754";"360470772001";95;17;147;17;6;282
"2755";"360470772002";60;13;62;11;19;165
"2756";"360470774001";25;3;32;5;20;85
"2757";"360470774002";120;34;59;15;22;250
"2758";"360470776001";46;4;6;12;17;85
"2759";"360470776002";27;5;32;20;4;88
"2760";"360470776003";19;12;67;20;10;128
"2761";"360470780001";33;7;32;14;9;95
"2762";"360470780002";118;3;100;27;18;266
"2763";"360470782001";43;3;46;16;6;114
"2764";"360470782002";381;8;59;3;5;456
"2765";"360470784001";54;5;93;3;15;170
"2766";"360470784002";24;6;68;15;35;148
"2767";"360470786001";51;10;43;14;13;131
"2768";"360470786002";25;9;50;8;19;111
"2769";"360470786003";140;10;111;8;17;286
"2770";"360470788001";44;22;85;8;10;169
"2771";"360470788002";64;8;51;20;17;160
"2772";"360470788003";24;35;34;53;14;160
"2773";"360470790001";402;241;40;20;13;716
"2774";"360470790002";133;307;79;13;29;561
"2775";"360470790003";50;7;32;20;13;122
"2776";"360470790004";41;9;56;35;16;157
"2777";"360470792001";74;164;97;41;23;399
"2778";"360470792002";65;26;30;18;38;177
"2779";"360470792003";90;40;138;87;52;407
"2780";"360470794001";76;44;111;42;28;301
"2781";"360470794002";21;24;47;21;22;135
"2782";"360470796011";157;143;88;2;25;415
"2783";"360470796012";395;40;52;6;30;523
"2784";"360470796021";455;93;109;5;40;702
"2785";"360470796022";367;122;58;9;29;585
"2786";"360470798011";109;105;55;3;16;288
"2787";"360470798012";133;105;68;8;27;341
"2788";"360470798021";187;98;27;2;25;339
"2789";"360470798022";168;166;18;2;29;383
"2790";"360470798023";193;151;42;23;40;449
"2791";"360470800001";101;93;27;3;23;247
"2792";"360470800002";59;27;60;7;25;178
"2793";"360470800003";26;7;36;4;6;79
"2794";"360470802001";130;41;75;9;37;292
"2795";"360470802002";96;38;96;3;16;249
"2796";"360470802003";301;32;83;2;37;455
"2797";"360470804001";81;55;56;8;15;215
"2798";"360470804002";51;41;31;3;6;132
"2799";"360470804003";17;8;68;8;15;116
"2800";"360470806001";61;35;82;29;50;257
"2801";"360470806002";80;18;95;27;18;238
"2802";"360470808001";40;15;45;8;7;115
"2803";"360470810001";91;31;99;9;30;260
"2804";"360470810002";16;38;133;7;6;200
"2805";"360470814001";54;13;76;16;19;178
"2806";"360470814002";70;16;155;26;27;294
"2807";"360470816001";42;11;169;7;8;237
"2808";"360470816002";40;25;79;23;20;187
"2809";"360470818001";332;48;53;1;14;448
"2810";"360470818002";68;6;26;4;7;111
"2811";"360470818003";58;16;96;2;24;196
"2812";"360470820001";256;35;139;0;23;453
"2813";"360470820002";215;23;91;1;16;346
"2814";"360470820003";158;74;68;1;15;316
"2815";"360470822001";156;26;48;0;6;236
"2816";"360470822002";581;169;48;4;21;823
"2817";"360470822003";356;132;53;14;28;583
"2818";"360470822004";150;42;64;5;32;293
"2819";"360470824001";42;3;68;8;21;142
"2820";"360470824002";45;13;25;1;23;107
"2821";"360470824003";54;12;138;29;18;251
"2822";"360470824004";47;33;118;19;13;230
"2823";"360470826001";48;8;71;8;14;149
"2824";"360470826002";43;5;98;7;16;169
"2825";"360470826003";157;51;78;8;29;323
"2826";"360470826004";67;37;51;28;21;204
"2827";"360470828001";81;35;16;5;27;164
"2828";"360470828002";85;39;90;16;30;260
"2829";"360470828003";101;26;96;11;55;289
"2830";"360470830001";61;8;124;11;13;217
"2831";"360470830002";28;3;65;8;8;112
"2832";"360470830003";126;4;50;2;5;187
"2833";"360470830004";321;1;10;4;9;345
"2834";"360470832001";32;2;50;40;4;128
"2835";"360470832002";16;4;55;14;21;110
"2836";"360470834001";13;0;38;2;8;61
"2837";"360470834002";17;2;45;4;9;77
"2838";"360470836001";88;4;45;11;46;194
"2839";"360470836002";39;16;41;39;17;152
"2840";"360470838001";62;9;38;12;13;134
"2841";"360470838002";24;9;54;19;9;115
"2842";"360470840001";16;11;104;82;9;222
"2843";"360470840002";15;8;116;57;15;211
"2844";"360470846001";60;25;88;57;20;250
"2845";"360470846002";19;24;105;27;22;197
"2846";"360470848001";24;4;51;13;13;105
"2847";"360470848002";39;5;23;17;13;97
"2848";"360470850001";24;5;65;50;26;170
"2849";"360470852001";1;2;1;4;0;8
"2850";"360470854001";93;8;35;20;15;171
"2851";"360470854002";49;10;76;33;14;182
"2852";"360470856001";75;12;37;12;11;147
"2853";"360470856002";74;10;33;7;12;136
"2854";"360470856003";56;13;83;12;18;182
"2855";"360470858001";24;8;38;24;15;109
"2856";"360470858002";72;31;36;13;38;190
"2857";"360470860001";12;30;38;16;18;114
"2858";"360470860002";79;12;60;7;14;172
"2859";"360470860003";30;15;21;10;6;82
"2860";"360470862001";40;21;71;3;5;140
"2861";"360470862002";33;14;84;2;12;145
"2862";"360470862003";41;8;22;2;6;79
"2863";"360470864001";87;13;83;33;31;247
"2864";"360470864002";20;3;87;23;8;141
"2865";"360470866001";46;20;77;27;32;202
"2866";"360470866002";136;59;77;5;28;305
"2867";"360470866003";71;37;52;2;13;175
"2868";"360470868001";77;6;22;0;11;116
"2869";"360470868002";24;27;122;9;30;212
"2870";"360470868003";82;30;69;7;25;213
"2871";"360470870001";8;5;41;2;15;71
"2872";"360470870002";17;10;33;5;25;90
"2873";"360470870003";21;1;30;6;4;62
"2874";"360470872001";6;3;14;18;6;47
"2875";"360470872002";19;0;35;10;13;77
"2876";"360470872003";55;7;41;11;19;133
"2877";"360470874011";73;53;147;83;15;371
"2878";"360470874012";250;29;84;8;8;379
"2879";"360470876001";38;62;36;24;16;176
"2880";"360470876002";10;2;46;15;11;84
"2881";"360470878001";34;11;79;8;20;152
"2882";"360470878002";2;2;18;0;3;25
"2883";"360470878003";80;34;66;16;6;202
"2884";"360470880001";28;4;88;23;10;153
"2885";"360470880002";33;11;4;0;1;49
"2886";"360470880003";144;59;69;10;23;305
"2887";"360470882001";112;12;43;0;7;174
"2888";"360470882002";47;28;35;3;26;139
"2889";"360470882003";33;4;22;2;15;76
"2890";"360470882004";59;8;69;7;26;169
"2891";"360470884001";153;6;41;3;34;237
"2892";"360470884002";56;40;39;5;22;162
"2893";"360470884003";64;10;69;2;25;170
"2894";"360470886001";57;10;52;4;20;143
"2895";"360470886002";157;44;50;7;25;283
"2896";"360470886003";160;6;82;27;28;303
"2897";"360470888001";34;14;107;4;39;198
"2898";"360470888002";22;0;55;9;14;100
"2899";"360470888003";42;11;51;21;12;137
"2900";"360470890001";56;7;26;4;13;106
"2901";"360470890002";58;22;49;4;19;152
"2902";"360470890003";34;19;16;2;3;74
"2903";"360470890004";180;15;39;2;14;250
"2904";"360470890005";6;8;30;0;3;47
"2905";"360470890006";10;1;22;0;5;38
"2906";"360470892001";189;2;20;4;12;227
"2907";"360470892002";46;16;39;3;17;121
"2908";"360470892003";200;13;21;2;30;266
"2909";"360470892004";110;2;8;6;38;164
"2910";"360470894001";19;5;14;1;13;52
"2911";"360470894002";35;8;24;8;15;90
"2912";"360470894003";62;8;4;0;21;95
"2913";"360470894004";9;2;5;1;18;35
"2914";"360470896001";12;2;14;5;17;50
"2915";"360470896002";161;19;74;18;14;286
"2916";"360470896003";83;21;28;1;30;163
"2917";"360470898001";8;7;28;3;14;60
"2918";"360470898002";49;13;50;7;10;129
"2919";"360470900001";19;1;25;3;15;63
"2920";"360470900002";7;2;9;2;4;24
"2921";"360470900003";36;3;5;3;13;60
"2922";"360470900004";17;3;27;2;5;54
"2923";"360470900005";99;14;23;5;16;157
"2924";"360470900006";91;36;34;5;74;240
"2925";"360470900007";9;3;7;1;6;26
"2926";"360470902001";31;10;11;4;20;76
"2927";"360470902002";0;0;2;4;0;6
"2928";"360470902003";4;2;15;1;4;26
"2929";"360470902004";22;5;39;3;25;94
"2930";"360470902005";6;4;21;1;6;38
"2931";"360470906001";67;1;5;0;8;81
"2932";"360470906002";95;10;36;8;43;192
"2933";"360470906003";121;9;5;2;17;154
"2934";"360470908001";88;27;46;45;49;255
"2935";"360470908002";18;1;3;2;1;25
"2936";"360470908003";39;5;12;4;13;73
"2937";"360470910001";32;2;1;0;2;37
"2938";"360470910002";222;23;2;2;1;250
"2939";"360470910003";35;4;0;0;2;41
"2940";"360470910004";11;3;33;4;14;65
"2941";"360470912001";107;4;1;0;12;124
"2942";"360470912002";186;3;2;0;6;197
"2943";"360470912003";142;8;0;0;11;161
"2944";"360470916001";30;6;10;6;7;59
"2945";"360470916002";58;5;20;3;23;109
"2946";"360470916003";6;1;38;13;19;77
"2947";"360470916004";83;10;68;18;30;209
"2948";"360470918001";58;8;10;3;19;98
"2949";"360470918002";8;2;35;13;15;73
"2950";"360470920001";10;7;11;5;9;42
"2951";"360470920002";99;14;18;12;14;157
"2952";"360470920003";11;10;39;58;44;162
"2953";"360470922001";41;8;26;4;16;95
"2954";"360470922002";18;1;18;21;15;73
"2955";"360470924001";44;16;38;8;22;128
"2956";"360470924002";20;5;56;4;19;104
"2957";"360470924003";9;1;6;5;14;35
"2958";"360470928001";47;4;82;15;12;160
"2959";"360470928002";31;1;105;27;17;181
"2960";"360470930001";20;2;68;2;16;108
"2961";"360470930002";17;5;77;37;12;148
"2962";"360470932001";37;54;156;111;38;396
"2963";"360470934001";51;8;52;3;4;118
"2964";"360470934002";24;6;27;26;16;99
"2965";"360470936001";14;5;19;11;7;56
"2966";"360470936002";26;6;36;24;2;94
"2967";"360470938001";50;11;36;4;5;106
"2968";"360470938002";13;4;40;8;10;75
"2969";"360470944011";27;3;6;18;3;57
"2970";"360470944012";12;13;57;25;11;118
"2971";"360470944013";96;19;38;13;16;182
"2972";"360470944014";12;10;10;9;9;50
"2973";"360470944021";366;21;13;13;8;421
"2974";"360470946001";17;4;24;16;7;68
"2975";"360470946002";1;4;15;6;1;27
"2976";"360470946003";27;27;48;80;5;187
"2977";"360470950001";214;28;80;14;13;349
"2978";"360470950002";33;5;43;36;11;128
"2979";"360470954001";18;2;47;14;10;91
"2980";"360470954002";68;2;28;15;16;129
"2981";"360470954003";105;13;96;6;41;261
"2982";"360470956001";40;8;32;27;6;113
"2983";"360470956002";78;3;227;8;26;342
"2984";"360470958001";44;7;39;44;15;149
"2985";"360470958002";48;3;241;25;33;350
"2986";"360470960001";13;13;68;90;29;213
"2987";"360470962001";91;9;136;22;24;282
"2988";"360470964001";16;4;74;20;17;131
"2989";"360470964002";56;5;82;31;28;202
"2990";"360470966001";32;4;87;30;12;165
"2991";"360470966002";23;4;69;11;22;129
"2992";"360470968001";38;45;71;1;18;173
"2993";"360470968002";40;13;70;15;10;148
"2994";"360470970001";31;4;66;12;12;125
"2995";"360470970002";20;4;76;19;23;142
"2996";"360470974001";74;15;72;11;14;186
"2997";"360470974002";53;21;133;31;19;257
"2998";"360470982001";185;9;9;9;4;216
"2999";"360470982002";168;10;5;4;11;198
"3000";"360470984001";30;6;98;32;22;188
"3001";"360470986001";33;3;42;15;8;101
"3002";"360470986002";75;12;49;22;12;170
"3003";"360470988001";55;7;52;13;18;145
"3004";"360470988002";15;2;55;8;7;87
"3005";"360470990001";62;36;103;17;12;230
"3006";"360470992001";60;27;86;68;11;252
"3007";"360470994001";117;33;135;37;14;336
"3008";"360470996001";70;9;155;34;21;289
"3009";"360470996002";50;3;79;40;7;179
"3010";"360470998001";57;14;136;15;21;243
"3011";"360470998002";48;16;268;25;20;377
"3012";"360471004001";46;5;102;23;16;192
"3013";"360471006001";39;9;85;18;6;157
"3014";"360471006002";28;3;71;12;4;118
"3015";"360471008001";29;13;60;55;13;170
"3016";"360471008002";33;4;58;24;2;121
"3017";"360471010001";48;11;63;7;11;140
"3018";"360471010002";35;4;71;17;31;158
"3019";"360471012001";31;2;61;8;6;108
"3020";"360471012002";32;2;33;24;4;95
"3021";"360471014001";54;1;36;2;9;102
"3022";"360471014002";45;4;3;6;5;63
"3023";"360471016001";40;4;39;17;8;108
"3024";"360471018001";87;7;21;15;11;141
"3025";"360471020001";59;2;45;31;9;146
"3026";"360471022001";99;8;97;39;33;276
"3027";"360471024001";56;7;111;32;17;223
"3028";"360471026001";100;23;150;36;37;346
"3029";"360471028001";22;25;66;19;8;140
"3030";"360471028002";16;6;35;5;7;69
"3031";"360471034001";330;29;37;8;14;418
"3032";"360471058011";16;1;10;2;5;34
"3033";"360471058012";14;6;18;1;4;43
"3034";"360471058013";9;0;9;3;3;24
"3035";"360471058041";2;0;62;5;2;71
"3036";"360471058042";136;5;1;2;1;145
"3037";"360471058043";13;1;25;3;1;43
"3038";"360471058044";15;2;31;12;6;66
"3039";"360471070001";60;8;48;55;10;181
"3040";"360471078001";10;0;35;9;31;85
"3041";"360471078002";6;19;33;10;8;76
"3042";"360471078003";24;2;27;15;6;74
"3043";"360471078004";10;1;11;2;3;27
"3044";"360471098001";61;8;71;19;38;197
"3045";"360471098002";24;6;96;191;31;348
"3046";"360471104001";38;12;89;67;27;233
"3047";"360471104002";371;5;62;39;28;505
"3048";"360471104003";29;7;33;6;16;91
"3049";"360471104004";60;2;30;18;18;128
"3050";"360471106001";156;2;2;0;7;167
"3051";"360471106002";170;1;3;0;4;178
"3052";"360471110001";246;21;4;13;9;293
"3053";"360471110002";122;9;2;3;12;148
"3054";"360471116001";83;14;50;16;18;181
"3055";"360471116002";30;13;79;45;71;238
"3056";"360471118001";85;10;41;15;22;173
"3057";"360471118002";73;23;79;14;257;446
"3058";"360471120001";21;12;21;11;17;82
"3059";"360471120002";70;17;76;6;28;197
"3060";"360471122001";121;26;93;16;36;292
"3061";"360471122002";35;11;83;21;20;170
"3062";"360471124001";58;2;26;21;24;131
"3063";"360471124002";60;12;22;8;23;125
"3064";"360471124003";32;4;19;3;26;84
"3065";"360471126001";45;4;14;6;24;93
"3066";"360471126002";21;0;22;3;8;54
"3067";"360471126003";49;10;52;4;18;133
"3068";"360471128001";37;1;42;9;41;130
"3069";"360471128002";57;2;23;4;51;137
"3070";"360471128003";124;31;59;19;24;257
"3071";"360471130001";12;0;7;1;6;26
"3072";"360471130002";33;16;29;9;9;96
"3073";"360471130003";90;8;28;6;20;152
"3074";"360471130004";23;4;52;17;7;103
"3075";"360471132001";14;9;63;10;23;119
"3076";"360471132002";29;8;63;50;16;166
"3077";"360471134001";34;9;37;8;20;108
"3078";"360471134002";44;2;16;2;6;70
"3079";"360471134003";117;6;4;6;11;144
"3080";"360471142011";35;26;118;43;17;239
"3081";"360471142012";9;12;145;50;20;236
"3082";"360471142021";65;20;168;31;28;312
"3083";"360471142022";94;4;22;8;33;161
"3084";"360471144001";8;9;51;25;52;145
"3085";"360471144002";51;13;18;17;19;118
"3086";"360471144003";20;5;16;15;32;88
"3087";"360471144004";19;2;8;0;5;34
"3088";"360471146001";110;192;117;20;84;523
"3089";"360471146002";52;109;183;28;76;448
"3090";"360471150001";61;22;35;16;32;166
"3091";"360471150002";64;14;62;40;17;197
"3092";"360471150003";75;36;51;6;46;214
"3093";"360471152001";28;10;27;37;33;135
"3094";"360471152002";91;9;17;14;18;149
"3095";"360471152003";83;16;33;9;44;185
"3096";"360471156001";41;3;41;5;7;97
"3097";"360471156002";481;5;2;0;11;499
"3098";"360471156003";23;4;2;2;1;32
"3099";"360471156004";34;3;13;1;36;87
"3100";"360471158001";49;3;41;3;16;112
"3101";"360471158002";69;25;20;4;17;135
"3102";"360471158003";80;24;18;3;29;154
"3103";"360471160001";15;4;12;0;27;58
"3104";"360471160002";50;9;11;1;15;86
"3105";"360471160003";57;5;21;5;7;95
"3106";"360471162001";49;8;7;12;14;90
"3107";"360471162002";25;1;14;9;13;62
"3108";"360471162003";9;1;20;0;24;54
"3109";"360471164001";9;62;24;30;39;164
"3110";"360471164002";13;17;40;5;14;89
"3111";"360471164003";54;3;19;13;22;111
"3112";"360471166001";28;12;35;4;36;115
"3113";"360471166002";38;6;48;21;21;134
"3114";"360471166003";34;15;32;36;30;147
"3115";"360471168001";82;31;57;19;79;268
"3116";"360471168002";27;17;130;27;46;247
"3117";"360471170001";36;25;61;5;11;138
"3118";"360471170002";40;16;41;17;47;161
"3119";"360471172011";98;30;80;13;21;242
"3120";"360471172012";130;68;75;9;49;331
"3121";"360471172021";51;5;78;9;26;169
"3122";"360471172022";88;34;106;7;37;272
"3123";"360471174001";120;118;118;35;56;447
"3124";"360471174002";66;112;156;51;138;523
"3125";"360471176011";46;14;115;45;71;291
"3126";"360471176012";150;57;92;13;46;358
"3127";"360471176021";74;20;179;24;48;345
"3128";"360471176022";273;54;68;21;87;503
"3129";"360471178001";53;38;67;13;62;233
"3130";"360471180001";9;45;36;12;32;134
"3131";"360471182011";47;25;146;18;28;264
"3132";"360471182012";63;10;87;10;33;203
"3133";"360471182021";132;68;70;16;47;333
"3134";"360471182022";147;63;86;23;48;367
"3135";"360471184001";107;100;102;14;74;397
"3136";"360471184002";98;83;149;29;85;444
"3137";"360471184003";62;23;35;20;52;192
"3138";"360471186001";61;4;76;22;35;198
"3139";"360471186002";101;16;106;26;33;282
"3140";"360471188001";204;85;159;4;43;495
"3141";"360471188002";41;13;23;6;51;134
"3142";"360471188003";47;13;30;4;50;144
"3143";"360471190001";138;21;50;17;20;246
"3144";"360471190002";58;8;29;2;53;150
"3145";"360471192001";72;15;73;19;49;228
"3146";"360471192002";51;11;35;12;24;133
"3147";"360471192003";24;9;24;37;28;122
"3148";"360471194001";39;4;30;11;48;132
"3149";"360471194002";61;7;80;24;35;207
"3150";"360471194003";154;16;109;24;40;343
"3151";"360471196001";72;12;53;15;33;185
"3152";"360471196002";36;22;71;13;38;180
"3153";"360471196003";78;10;76;6;34;204
"3154";"360471196004";104;4;71;11;23;213
"3155";"360471198001";35;17;51;26;25;154
"3156";"360471198002";30;28;115;25;60;258
"3157";"360471198003";65;104;120;48;133;470
"3158";"360471200001";14;6;50;7;28;105
"3159";"360471200002";75;9;110;11;27;232
"3160";"360471202001";25;17;35;12;25;114
"3161";"360471202002";11;7;15;6;35;74
"3162";"360471208001";43;11;124;5;27;210
"3163";"360471208002";89;9;162;22;33;315
"3164";"360471208003";18;1;3;2;7;31
"3165";"360471208004";75;1;0;0;1;77
"3166";"360471208005";86;6;88;49;35;264
"3167";"360471210001";62;1;0;0;3;66
"3168";"360471210002";32;2;1;0;2;37
"3169";"360471214001";77;28;5;1;1;112
"3170";"360471214002";81;2;6;5;4;98
"3171";"360471220001";181;29;197;121;24;552
"3172";"360471220002";251;20;131;99;74;575
"3173";"360471237001";33;27;245;18;26;349
"3174";"360471237002";25;21;99;8;30;183
"3175";"360471237003";13;31;153;25;44;266
"3176";"360471502001";31;7;114;8;10;170
"3177";"360471502002";13;5;38;20;6;82
"3178";"360471502003";28;33;78;26;33;198
"3179";"360471522001";32;135;109;99;23;398
"3180";"360471522002";47;31;65;18;26;187
"3181";"360471522003";42;27;133;39;16;257
"3182";"360593005005";0;0;0;1;0;1
"3183";"360593009003";0;0;0;0;1;1
"3184";"360594043002";0;0;0;0;3;3
"3185";"360594043003";1;0;1;4;0;6
"3186";"360594103004";2;1;0;0;0;3
"3187";"360594103005";0;0;0;1;0;1
"3188";"360594109001";0;0;2;0;0;2
"3189";"360610002011";76;9;5;1;15;106
"3190";"360610002012";157;7;28;0;9;201
"3191";"360610002021";78;79;14;2;15;188
"3192";"360610002022";37;28;24;6;5;100
"3193";"360610002023";251;35;6;1;18;311
"3194";"360610002024";138;9;7;0;6;160
"3195";"360610002025";22;28;26;4;3;83
"3196";"360610005001";3;6;0;0;0;9
"3197";"360610006001";26;40;32;6;59;163
"3198";"360610006002";54;54;169;9;10;296
"3199";"360610006003";33;97;42;5;38;215
"3200";"360610006004";20;6;5;2;28;61
"3201";"360610006005";23;25;11;0;12;71
"3202";"360610006006";29;11;37;0;4;81
"3203";"360610007001";171;410;197;9;112;899
"3204";"360610008000";0;0;0;0;1;1
"3205";"360610008001";25;7;15;2;51;100
"3206";"360610008002";27;18;44;0;15;104
"3207";"360610008003";14;8;6;1;10;39
"3208";"360610008004";6;3;4;1;1;15
"3209";"360610008005";93;17;24;1;2;137
"3210";"360610008006";28;183;363;0;63;637
"3211";"360610009001";39;119;199;8;80;445
"3212";"360610010010";0;1;0;0;1;2
"3213";"360610010011";15;6;5;2;5;33
"3214";"360610010021";69;1;2;1;2;75
"3215";"360610010022";66;6;2;0;8;82
"3216";"360610010023";310;4;16;1;11;342
"3217";"360610012001";71;27;16;2;8;124
"3218";"360610012002";11;7;15;2;12;47
"3219";"360610012003";68;19;18;1;1;107
"3220";"360610013001";12;50;33;1;29;125
"3221";"360610013002";57;168;96;3;78;402
"3222";"360610014011";6;91;20;3;13;133
"3223";"360610014012";11;32;3;2;5;53
"3224";"360610014021";83;211;19;10;36;359
"3225";"360610014022";94;89;17;3;72;275
"3226";"360610015010";1;3;2;0;3;9
"3227";"360610015011";35;119;89;3;45;291
"3228";"360610015012";22;19;52;4;17;114
"3229";"360610015013";53;70;21;2;15;161
"3230";"360610015021";105;163;91;11;104;474
"3231";"360610015022";78;128;41;7;40;294
"3232";"360610016001";22;19;20;3;41;105
"3233";"360610016002";28;21;2;0;27;78
"3234";"360610016003";20;56;21;3;62;162
"3235";"360610016004";147;167;13;2;77;406
"3236";"360610016005";57;247;87;10;136;537
"3237";"360610018001";247;128;4;4;48;431
"3238";"360610018002";55;104;11;3;90;263
"3239";"360610018003";123;253;20;5;87;488
"3240";"360610018004";19;16;5;1;22;63
"3241";"360610018005";51;253;18;3;80;405
"3242";"360610018006";36;212;8;9;44;309
"3243";"360610018007";127;126;4;0;80;337
"3244";"360610020001";67;2;5;1;5;80
"3245";"360610020002";113;6;9;0;9;137
"3246";"360610020003";32;7;34;5;5;83
"3247";"360610021001";108;169;132;13;100;522
"3248";"360610021002";15;45;52;2;31;145
"3249";"360610022011";136;41;50;3;45;275
"3250";"360610022012";148;226;65;2;39;480
"3251";"360610022013";519;37;9;0;5;570
"3252";"360610022014";2;6;1;3;6;18
"3253";"360610022021";258;126;50;13;38;485
"3254";"360610024000";1;9;0;0;0;10
"3255";"360610024001";657;48;12;1;22;740
"3256";"360610024002";73;1;12;1;3;90
"3257";"360610025001";545;44;13;0;26;628
"3258";"360610025002";11;3;4;1;2;21
"3259";"360610025003";34;8;11;0;7;60
"3260";"360610026011";246;190;32;20;55;543
"3261";"360610026012";157;142;23;8;35;365
"3262";"360610026021";142;57;61;15;22;297
"3263";"360610026022";256;256;38;12;38;600
"3264";"360610027001";16;19;137;5;28;205
"3265";"360610028001";61;116;10;4;27;218
"3266";"360610028002";73;41;19;6;23;162
"3267";"360610028003";172;134;56;4;52;418
"3268";"360610028004";50;96;54;19;29;248
"3269";"360610029001";29;129;11;4;17;190
"3270";"360610029002";22;33;9;1;14;79
"3271";"360610029003";36;53;7;3;31;130
"3272";"360610029004";8;38;10;3;19;78
"3273";"360610030011";97;299;13;2;54;465
"3274";"360610030012";191;247;5;4;69;516
"3275";"360610030013";102;66;32;3;67;270
"3276";"360610030014";293;66;7;0;56;422
"3277";"360610030021";207;166;30;5;70;478
"3278";"360610030022";212;520;16;4;41;793
"3279";"360610031001";52;450;97;6;231;836
"3280";"360610032001";157;312;31;11;50;561
"3281";"360610032002";77;105;6;2;33;223
"3282";"360610032003";23;107;20;6;22;178
"3283";"360610032004";36;56;3;4;17;116
"3284";"360610032005";137;242;28;12;46;465
"3285";"360610032006";261;142;30;8;56;497
"3286";"360610032007";59;82;16;3;50;210
"3287";"360610033001";89;162;44;20;76;391
"3288";"360610033002";28;44;29;5;30;136
"3289";"360610033003";19;38;41;5;26;129
"3290";"360610034001";164;242;22;16;77;521
"3291";"360610034002";344;218;29;8;39;638
"3292";"360610034003";171;227;47;31;81;557
"3293";"360610034004";177;121;30;17;98;443
"3294";"360610036011";24;28;4;0;9;65
"3295";"360610036012";83;57;7;1;31;179
"3296";"360610036013";88;145;16;9;46;304
"3297";"360610036021";199;81;79;9;59;427
"3298";"360610036022";47;75;27;10;30;189
"3299";"360610037001";45;79;58;9;21;212
"3300";"360610037002";13;47;68;7;15;150
"3301";"360610037003";16;113;59;15;32;235
"3302";"360610038001";151;238;14;3;64;470
"3303";"360610038002";30;35;6;1;17;89
"3304";"360610038003";68;103;28;17;47;263
"3305";"360610038004";49;63;9;5;31;157
"3306";"360610038005";150;149;6;15;35;355
"3307";"360610038006";70;53;2;4;22;151
"3308";"360610038007";124;95;15;10;46;290
"3309";"360610039000";0;1;0;0;0;1
"3310";"360610039001";43;138;47;2;26;256
"3311";"360610039002";21;89;38;0;21;169
"3312";"360610039003";0;2;5;2;3;12
"3313";"360610039004";32;65;70;6;82;255
"3314";"360610040001";186;143;6;6;33;374
"3315";"360610040002";30;34;6;5;14;89
"3316";"360610040003";43;45;8;11;33;140
"3317";"360610040004";91;23;4;4;17;139
"3318";"360610040005";107;52;10;2;29;200
"3319";"360610040006";135;67;39;6;32;279
"3320";"360610041001";44;60;14;4;52;174
"3321";"360610041002";22;168;15;2;38;245
"3322";"360610041003";19;34;6;5;42;106
"3323";"360610041004";40;89;12;5;29;175
"3324";"360610041005";19;35;18;2;27;101
"3325";"360610041006";86;215;13;17;57;388
"3326";"360610042001";132;179;36;5;57;409
"3327";"360610042002";102;92;21;5;33;253
"3328";"360610043001";90;146;26;21;84;367
"3329";"360610043002";115;148;10;5;55;333
"3330";"360610043003";94;176;86;20;88;464
"3331";"360610044001";29;43;18;4;5;99
"3332";"360610044002";19;2;11;2;3;37
"3333";"360610044003";10;0;2;0;2;14
"3334";"360610044004";21;14;4;1;6;46
"3335";"360610044005";11;7;10;1;7;36
"3336";"360610044006";16;2;6;0;2;26
"3337";"360610044007";35;7;7;0;24;73
"3338";"360610044008";25;10;36;2;6;79
"3339";"360610045001";46;149;110;11;100;416
"3340";"360610047001";45;74;9;3;39;170
"3341";"360610047002";169;123;31;9;75;407
"3342";"360610048001";13;12;9;5;4;43
"3343";"360610048002";5;4;12;1;2;24
"3344";"360610048003";8;8;16;2;12;46
"3345";"360610048004";40;124;19;3;29;215
"3346";"360610048005";68;61;52;0;24;205
"3347";"360610048006";86;29;3;4;21;143
"3348";"360610048007";2;4;13;0;14;33
"3349";"360610049001";122;253;66;15;84;540
"3350";"360610049002";115;127;6;4;44;296
"3351";"360610049003";75;62;19;5;18;179
"3352";"360610050001";45;33;17;3;8;106
"3353";"360610050002";39;31;17;1;19;107
"3354";"360610050003";10;104;21;1;42;178
"3355";"360610050004";9;14;8;3;49;83
"3356";"360610050005";25;163;12;5;20;225
"3357";"360610052001";61;353;51;1;109;575
"3358";"360610052002";56;235;78;13;77;459
"3359";"360610054001";75;117;51;8;79;330
"3360";"360610054002";12;13;34;2;11;72
"3361";"360610054003";18;18;7;0;22;65
"3362";"360610055011";33;56;15;4;39;147
"3363";"360610055012";6;15;8;1;10;40
"3364";"360610055013";3;15;3;1;3;25
"3365";"360610055021";41;200;14;3;28;286
"3366";"360610055022";53;149;67;11;99;379
"3367";"360610056001";66;73;32;3;38;212
"3368";"360610056002";18;172;27;2;37;256
"3369";"360610056003";32;45;7;6;11;101
"3370";"360610057001";15;94;12;3;18;142
"3371";"360610057002";52;77;30;10;47;216
"3372";"360610058001";86;194;49;2;145;476
"3373";"360610059001";26;15;9;2;18;70
"3374";"360610059002";10;115;17;0;13;155
"3375";"360610059003";35;101;52;1;31;220
"3376";"360610059004";3;14;0;1;12;30
"3377";"360610059005";9;14;2;1;8;34
"3378";"360610060001";108;2;2;0;5;117
"3379";"360610060002";19;12;10;1;17;59
"3380";"360610060003";2;1;2;0;8;13
"3381";"360610061001";35;58;27;5;41;166
"3382";"360610061002";77;21;27;1;37;163
"3383";"360610061003";28;163;34;1;119;345
"3384";"360610062001";6;15;71;3;14;109
"3385";"360610062002";7;10;6;0;3;26
"3386";"360610063001";23;51;32;2;23;131
"3387";"360610063002";31;22;25;5;35;118
"3388";"360610063003";39;96;22;1;10;168
"3389";"360610063004";19;33;3;1;18;74
"3390";"360610063005";25;116;5;0;26;172
"3391";"360610064001";41;29;26;8;18;122
"3392";"360610064002";287;10;5;1;4;307
"3393";"360610064003";11;27;8;3;4;53
"3394";"360610064004";64;21;43;1;39;168
"3395";"360610064005";32;20;34;1;16;103
"3396";"360610064006";3;2;9;0;9;23
"3397";"360610065001";70;243;30;1;39;383
"3398";"360610065002";58;92;4;0;22;176
"3399";"360610065003";31;179;16;7;26;259
"3400";"360610065004";101;291;15;2;30;439
"3401";"360610065005";77;175;24;8;20;304
"3402";"360610066001";47;65;6;1;26;145
"3403";"360610066002";52;16;8;1;25;102
"3404";"360610066003";59;50;10;0;20;139
"3405";"360610066004";45;12;12;0;12;81
"3406";"360610066005";54;23;6;3;11;97
"3407";"360610066006";3;4;11;0;4;22
"3408";"360610066007";28;2;5;1;135;171
"3409";"360610066008";143;43;38;0;14;238
"3410";"360610066009";5;1;9;0;3;18
"3411";"360610067001";71;213;10;6;28;328
"3412";"360610067002";84;215;12;4;52;367
"3413";"360610067003";32;51;10;1;29;123
"3414";"360610067004";103;40;27;13;43;226
"3415";"360610068001";18;66;41;1;25;151
"3416";"360610068002";17;29;7;1;27;81
"3417";"360610068003";31;56;16;0;14;117
"3418";"360610068004";418;21;15;3;13;470
"3419";"360610068005";31;55;33;0;3;122
"3420";"360610068006";62;166;20;1;50;299
"3421";"360610069001";283;323;70;10;46;732
"3422";"360610070001";74;61;25;4;65;229
"3423";"360610070002";70;51;19;0;98;238
"3424";"360610070003";69;29;34;0;34;166
"3425";"360610070004";5;13;31;1;13;63
"3426";"360610070005";1;1;1;2;1;6
"3427";"360610070006";110;44;7;0;19;180
"3428";"360610071001";13;14;2;3;22;54
"3429";"360610071002";28;21;4;1;10;64
"3430";"360610071003";35;45;22;1;29;132
"3431";"360610071004";49;57;15;7;23;151
"3432";"360610071005";44;147;19;3;24;237
"3433";"360610072001";5;7;10;1;4;27
"3434";"360610072002";31;23;9;1;39;103
"3435";"360610072003";49;46;18;2;45;160
"3436";"360610072004";97;121;23;2;35;278
"3437";"360610072005";25;13;17;3;50;108
"3438";"360610072006";4;14;4;1;19;42
"3439";"360610072007";9;17;2;7;10;45
"3440";"360610073001";29;9;80;13;16;147
"3441";"360610073002";24;49;3;4;12;92
"3442";"360610073003";33;71;11;4;23;142
"3443";"360610073004";71;243;8;1;36;359
"3444";"360610073005";22;3;56;9;2;92
"3445";"360610073006";76;84;13;5;30;208
"3446";"360610074001";47;53;20;0;28;148
"3447";"360610074002";21;97;16;0;37;171
"3448";"360610074003";38;120;37;0;61;256
"3449";"360610075001";40;89;60;10;25;224
"3450";"360610075002";13;12;13;10;10;58
"3451";"360610075003";127;125;22;13;13;300
"3452";"360610076001";42;130;63;0;66;301
"3453";"360610076002";35;53;47;8;70;213
"3454";"360610077001";89;590;22;6;79;786
"3455";"360610077002";44;42;4;5;13;108
"3456";"360610077003";70;143;17;6;34;270
"3457";"360610077004";37;36;18;7;31;129
"3458";"360610077005";32;19;10;5;20;86
"3459";"360610078001";56;20;3;0;11;90
"3460";"360610078002";18;96;7;1;15;137
"3461";"360610078003";20;20;5;0;14;59
"3462";"360610078004";75;58;16;3;39;191
"3463";"360610078005";15;10;6;1;28;60
"3464";"360610078006";17;6;2;1;10;36
"3465";"360610078007";37;4;4;1;3;49
"3466";"360610079001";19;181;34;9;32;275
"3467";"360610079002";14;15;22;0;4;55
"3468";"360610079003";33;66;23;9;16;147
"3469";"360610079004";7;51;9;4;4;75
"3470";"360610080001";39;46;17;1;39;142
"3471";"360610080002";18;64;29;1;39;151
"3472";"360610080003";5;4;12;0;10;31
"3473";"360610080004";19;43;20;4;12;98
"3474";"360610080005";25;32;41;2;13;113
"3475";"360610081001";30;32;11;5;27;105
"3476";"360610081002";34;37;23;4;17;115
"3477";"360610081003";36;22;48;3;26;135
"3478";"360610081004";48;57;8;14;49;176
"3479";"360610081005";52;18;7;1;8;86
"3480";"360610081006";62;26;6;8;26;128
"3481";"360610082001";7;35;47;5;70;164
"3482";"360610082002";11;43;34;0;25;113
"3483";"360610082003";17;12;14;0;17;60
"3484";"360610083001";60;149;33;4;37;283
"3485";"360610083002";23;55;7;1;11;97
"3486";"360610083003";88;107;89;1;35;320
"3487";"360610084001";2;13;10;0;20;45
"3488";"360610084002";39;179;132;4;89;443
"3489";"360610086010";0;0;1;0;1;2
"3490";"360610086011";4;9;56;5;8;82
"3491";"360610086012";20;15;22;2;16;75
"3492";"360610086020";0;6;0;0;0;6
"3493";"360610086021";4;37;14;0;4;59
"3494";"360610086030";0;0;0;0;1;1
"3495";"360610086031";7;12;8;2;6;35
"3496";"360610086032";3;5;26;4;5;43
"3497";"360610086033";4;2;9;2;5;22
"3498";"360610086034";18;3;28;7;4;60
"3499";"360610087001";143;201;45;2;34;425
"3500";"360610087002";37;29;7;5;11;89
"3501";"360610087003";32;153;7;3;14;209
"3502";"360610087004";46;28;31;0;23;128
"3503";"360610087005";32;23;13;3;17;88
"3504";"360610088001";3;38;37;7;34;119
"3505";"360610088002";9;31;22;4;11;77
"3506";"360610088003";4;8;11;1;4;28
"3507";"360610088004";3;10;3;0;0;16
"3508";"360610088005";7;10;4;0;2;23
"3509";"360610088006";6;7;16;0;3;32
"3510";"360610088007";8;2;0;1;0;11
"3511";"360610089001";20;30;1;9;7;67
"3512";"360610089002";28;34;19;2;33;116
"3513";"360610089003";100;37;31;4;20;192
"3514";"360610089004";14;22;14;8;15;73
"3515";"360610089005";50;9;11;2;11;83
"3516";"360610090001";112;618;549;2;28;1309
"3517";"360610090002";13;3;84;0;4;104
"3518";"360610090003";5;134;179;0;6;324
"3519";"360610090004";16;85;6;1;10;118
"3520";"360610090005";2;18;12;0;13;45
"3521";"360610090006";18;103;52;1;2;176
"3522";"360610091001";63;129;29;19;95;335
"3523";"360610091002";28;46;13;1;29;117
"3524";"360610091003";41;15;2;4;21;83
"3525";"360610091004";11;28;12;1;21;73
"3526";"360610092001";29;179;100;1;147;456
"3527";"360610093001";18;6;16;2;16;58
"3528";"360610093002";43;18;5;4;27;97
"3529";"360610093003";6;10;5;1;5;27
"3530";"360610093004";6;2;2;0;24;34
"3531";"360610093005";23;9;6;4;20;62
"3532";"360610093006";107;16;11;0;11;145
"3533";"360610093007";34;25;18;3;16;96
"3534";"360610094001";8;30;61;1;57;157
"3535";"360610095001";62;154;45;6;145;412
"3536";"360610095002";35;34;35;3;41;148
"3537";"360610096001";12;123;104;7;126;372
"3538";"360610097001";11;9;8;7;16;51
"3539";"360610097002";145;25;16;0;20;206
"3540";"360610097003";1;2;4;0;5;12
"3541";"360610097004";247;23;10;5;15;300
"3542";"360610098001";20;97;7;0;9;133
"3543";"360610098002";27;87;10;1;18;143
"3544";"360610098003";61;60;10;2;13;146
"3545";"360610098004";24;8;8;1;8;49
"3546";"360610098005";30;42;2;0;9;83
"3547";"360610098006";39;90;54;1;13;197
"3548";"360610098007";74;37;11;9;25;156
"3549";"360610099000";0;0;0;0;1;1
"3550";"360610099001";152;261;409;11;151;984
"3551";"360610100001";6;96;35;2;43;182
"3552";"360610100002";9;36;29;9;30;113
"3553";"360610101001";17;93;55;3;121;289
"3554";"360610102001";10;32;53;2;37;134
"3555";"360610103001";116;94;72;7;47;336
"3556";"360610104001";18;85;50;3;181;337
"3557";"360610106011";5;21;1;0;1;28
"3558";"360610106012";11;10;14;1;5;41
"3559";"360610106013";3;41;14;0;7;65
"3560";"360610106014";0;13;12;1;2;28
"3561";"360610106015";10;7;3;0;11;31
"3562";"360610106016";0;5;26;1;3;35
"3563";"360610106021";14;102;7;0;20;143
"3564";"360610106022";12;135;24;3;32;206
"3565";"360610106023";2;4;17;2;8;33
"3566";"360610108001";4;8;3;0;10;25
"3567";"360610108002";14;7;13;0;7;41
"3568";"360610108003";11;36;13;2;7;69
"3569";"360610108004";0;5;0;0;4;9
"3570";"360610108005";46;22;12;0;10;90
"3571";"360610108006";23;65;14;0;27;129
"3572";"360610108007";19;64;22;2;25;132
"3573";"360610109001";22;181;69;3;126;401
"3574";"360610110001";17;49;18;3;4;91
"3575";"360610110002";19;11;2;0;13;45
"3576";"360610110003";50;72;29;3;21;175
"3577";"360610110004";12;51;4;1;6;74
"3578";"360610110005";17;122;5;1;13;158
"3579";"360610110006";27;92;13;5;47;184
"3580";"360610111001";69;71;61;5;43;249
"3581";"360610111002";22;11;26;4;17;80
"3582";"360610111003";117;52;59;2;32;262
"3583";"360610112011";1;41;38;2;85;167
"3584";"360610112021";3;151;87;2;92;335
"3585";"360610112031";11;13;15;2;19;60
"3586";"360610112032";3;7;12;0;14;36
"3587";"360610113001";28;124;135;4;154;445
"3588";"360610114011";10;12;8;1;8;39
"3589";"360610114012";10;16;81;2;25;134
"3590";"360610114021";14;34;20;2;48;118
"3591";"360610114022";9;23;26;6;25;89
"3592";"360610115001";27;134;73;5;53;292
"3593";"360610115002";43;83;47;3;38;214
"3594";"360610116001";10;19;33;2;13;77
"3595";"360610116002";16;23;43;1;7;90
"3596";"360610116003";12;275;22;6;12;327
"3597";"360610117000";0;9;0;0;0;9
"3598";"360610117001";20;116;21;4;23;184
"3599";"360610118001";3;35;6;0;1;45
"3600";"360610118002";1;5;6;0;5;17
"3601";"360610118003";8;112;5;0;7;132
"3602";"360610118004";34;22;52;1;21;130
"3603";"360610118005";27;10;5;0;8;50
"3604";"360610118006";20;11;17;1;11;60
"3605";"360610118007";15;4;8;1;7;35
"3606";"360610118008";2;5;13;0;3;23
"3607";"360610119001";21;45;50;3;48;167
"3608";"360610119002";77;73;68;2;36;256
"3609";"360610120001";2;38;38;2;2;82
"3610";"360610120002";3;2;16;1;11;33
"3611";"360610120003";18;6;26;1;10;61
"3612";"360610120004";6;23;19;3;24;75
"3613";"360610121001";70;103;24;2;74;273
"3614";"360610121002";3;8;2;1;7;21
"3615";"360610121003";46;22;10;0;50;128
"3616";"360610121004";46;194;24;6;57;327
"3617";"360610121005";91;132;11;5;37;276
"3618";"360610121006";58;63;3;2;25;151
"3619";"360610122001";45;10;16;0;9;80
"3620";"360610122002";4;2;12;1;9;28
"3621";"360610122003";10;10;15;3;13;51
"3622";"360610122004";4;13;22;0;5;44
"3623";"360610124001";70;56;47;2;15;190
"3624";"360610124002";39;10;45;0;18;112
"3625";"360610124003";9;10;16;1;0;36
"3626";"360610124004";17;21;5;1;2;46
"3627";"360610124005";5;11;8;0;1;25
"3628";"360610124006";5;2;6;0;2;15
"3629";"360610124007";3;5;16;1;0;25
"3630";"360610124008";4;1;1;0;3;9
"3631";"360610125001";18;132;58;0;102;310
"3632";"360610125002";34;706;84;2;50;876
"3633";"360610126001";34;57;67;4;27;189
"3634";"360610126002";4;11;15;1;7;38
"3635";"360610126003";14;4;6;0;5;29
"3636";"360610126004";13;2;15;2;5;37
"3637";"360610126005";6;11;19;7;13;56
"3638";"360610126006";27;31;13;2;15;88
"3639";"360610126007";24;9;16;0;10;59
"3640";"360610126008";19;11;12;0;1;43
"3641";"360610127001";63;56;27;0;17;163
"3642";"360610127002";72;156;38;0;45;311
"3643";"360610127003";87;57;41;2;20;207
"3644";"360610127004";82;87;165;6;45;385
"3645";"360610127005";7;31;18;5;43;104
"3646";"360610128001";23;11;6;0;14;54
"3647";"360610128002";2;3;7;7;6;25
"3648";"360610128003";17;3;37;4;5;66
"3649";"360610128004";7;19;55;1;9;91
"3650";"360610128005";12;5;40;0;5;62
"3651";"360610129000";0;1;0;0;0;1
"3652";"360610129001";127;301;202;13;57;700
"3653";"360610129002";54;433;1025;85;41;1638
"3654";"360610130001";10;8;12;0;4;34
"3655";"360610130002";7;12;43;3;8;73
"3656";"360610130003";17;9;28;1;12;67
"3657";"360610130004";25;3;22;1;22;73
"3658";"360610131001";8;46;46;0;40;140
"3659";"360610131002";29;84;21;2;31;167
"3660";"360610132001";35;6;15;0;15;71
"3661";"360610132002";35;29;24;0;21;109
"3662";"360610132003";47;30;6;0;5;88
"3663";"360610132004";73;38;28;4;26;169
"3664";"360610132005";71;13;16;1;9;110
"3665";"360610132006";20;24;4;0;0;48
"3666";"360610132007";34;6;11;0;10;61
"3667";"360610133001";15;33;3;3;4;58
"3668";"360610133002";45;91;15;1;26;178
"3669";"360610133003";95;189;33;0;61;378
"3670";"360610133004";60;131;20;3;10;224
"3671";"360610133005";47;48;22;2;19;138
"3672";"360610134001";27;14;9;4;17;71
"3673";"360610134002";28;11;4;0;24;67
"3674";"360610134003";22;9;13;0;6;50
"3675";"360610134004";2;42;8;4;6;62
"3676";"360610134005";22;57;31;2;14;126
"3677";"360610134006";35;69;10;5;20;139
"3678";"360610134007";67;74;14;1;21;177
"3679";"360610134008";15;29;40;1;23;108
"3680";"360610134009";31;29;6;0;10;76
"3681";"360610135000";0;1;0;0;0;1
"3682";"360610135001";57;124;102;9;30;322
"3683";"360610135002";71;46;67;11;42;237
"3684";"360610136001";76;54;13;3;19;165
"3685";"360610136002";35;11;10;0;8;64
"3686";"360610136003";14;5;10;7;7;43
"3687";"360610136004";120;15;32;4;20;191
"3688";"360610136005";9;12;35;6;3;65
"3689";"360610136006";16;7;14;0;4;41
"3690";"360610136007";183;5;10;4;10;212
"3691";"360610136008";97;39;26;4;20;186
"3692";"360610137001";20;369;18;1;37;445
"3693";"360610137002";12;28;53;2;27;122
"3694";"360610137003";62;185;45;0;54;346
"3695";"360610137004";4;79;63;9;57;212
"3696";"360610137005";4;20;53;1;20;98
"3697";"360610137006";15;59;29;0;17;120
"3698";"360610138001";10;12;9;2;18;51
"3699";"360610138002";48;17;6;1;13;85
"3700";"360610138003";17;34;11;4;12;78
"3701";"360610138004";101;103;25;0;21;250
"3702";"360610138005";29;16;10;0;12;67
"3703";"360610138006";53;43;4;1;3;104
"3704";"360610138007";22;6;13;1;25;67
"3705";"360610138008";36;3;10;3;17;69
"3706";"360610138009";4;10;25;2;7;48
"3707";"360610139001";38;24;10;1;17;90
"3708";"360610139002";29;37;11;4;10;91
"3709";"360610139003";132;105;48;9;35;329
"3710";"360610139004";135;35;19;0;13;202
"3711";"360610139005";32;117;9;2;17;177
"3712";"360610139006";11;20;15;4;19;69
"3713";"360610139007";50;62;16;3;24;155
"3714";"360610140001";35;13;7;0;15;70
"3715";"360610140002";31;29;19;4;13;96
"3716";"360610140003";14;250;18;4;23;309
"3717";"360610140004";4;4;31;4;8;51
"3718";"360610140005";19;28;27;1;8;83
"3719";"360610140006";15;5;18;1;9;48
"3720";"360610142001";1;2;8;1;2;14
"3721";"360610142002";15;5;21;2;4;47
"3722";"360610142003";2;2;9;2;10;25
"3723";"360610142004";8;12;36;2;9;67
"3724";"360610142005";16;22;4;0;6;48
"3725";"360610142006";8;24;13;0;16;61
"3726";"360610143001";79;535;138;6;145;903
"3727";"360610144011";56;5;9;2;2;74
"3728";"360610144012";25;7;4;0;5;41
"3729";"360610144013";91;26;9;5;7;138
"3730";"360610144014";19;9;3;10;3;44
"3731";"360610144021";24;26;14;2;12;78
"3732";"360610144022";58;12;7;1;4;82
"3733";"360610144023";27;1;9;6;3;46
"3734";"360610144024";55;28;35;3;16;137
"3735";"360610144025";44;24;19;0;8;95
"3736";"360610145001";28;25;67;1;28;149
"3737";"360610145002";1;1;5;0;5;12
"3738";"360610145003";13;118;50;4;63;248
"3739";"360610145004";6;74;98;1;26;205
"3740";"360610146011";28;85;21;1;5;140
"3741";"360610146012";30;108;6;2;19;165
"3742";"360610146013";31;76;22;1;14;144
"3743";"360610146014";27;83;25;3;11;149
"3744";"360610146021";19;25;17;0;15;76
"3745";"360610146022";28;7;9;0;8;52
"3746";"360610146023";52;29;4;0;9;94
"3747";"360610146024";74;10;1;3;18;106
"3748";"360610146025";17;58;8;2;16;101
"3749";"360610146026";12;18;8;1;8;47
"3750";"360610147001";37;33;32;0;9;111
"3751";"360610148011";11;40;18;1;46;116
"3752";"360610148012";6;24;37;1;47;115
"3753";"360610148021";46;33;10;0;20;109
"3754";"360610148022";30;32;37;0;68;167
"3755";"360610148023";14;9;16;1;9;49
"3756";"360610148024";22;13;3;0;9;47
"3757";"360610148025";3;7;71;0;35;116
"3758";"360610149001";9;90;45;2;29;175
"3759";"360610149002";5;8;8;0;1;22
"3760";"360610149003";25;17;37;0;15;94
"3761";"360610149004";6;14;19;0;21;60
"3762";"360610149005";1;11;28;0;6;46
"3763";"360610150011";3;9;6;1;9;28
"3764";"360610150012";19;8;15;4;4;50
"3765";"360610150021";1;4;29;2;4;40
"3766";"360610150022";2;6;19;3;2;32
"3767";"360610150023";1;5;27;0;4;37
"3768";"360610150024";11;12;11;0;13;47
"3769";"360610151001";89;69;14;2;6;180
"3770";"360610151002";239;16;14;1;17;287
"3771";"360610151003";89;19;22;2;3;135
"3772";"360610151004";78;46;47;1;14;186
"3773";"360610152001";115;1;5;1;4;126
"3774";"360610152002";228;8;8;0;11;255
"3775";"360610152003";4;5;16;3;9;37
"3776";"360610152004";15;5;13;1;3;37
"3777";"360610152005";6;3;19;0;4;32
"3778";"360610152006";11;26;18;0;8;63
"3779";"360610153001";23;15;4;2;34;78
"3780";"360610153002";14;22;48;0;17;101
"3781";"360610153003";6;18;64;1;36;125
"3782";"360610153004";5;25;61;4;28;123
"3783";"360610153005";27;3;8;3;29;70
"3784";"360610153006";21;5;35;1;25;87
"3785";"360610153007";15;48;19;2;15;99
"3786";"360610154001";74;101;26;3;22;226
"3787";"360610154002";20;5;4;1;2;32
"3788";"360610154003";59;15;2;2;22;100
"3789";"360610154004";13;43;12;1;5;74
"3790";"360610154005";86;25;6;1;20;138
"3791";"360610154006";123;25;5;2;10;165
"3792";"360610154007";5;4;6;1;1;17
"3793";"360610154008";95;14;21;4;10;144
"3794";"360610154009";287;20;13;0;8;328
"3795";"360610155001";5;2;20;0;2;29
"3796";"360610155002";0;1;38;0;3;42
"3797";"360610155003";3;3;4;0;4;14
"3798";"360610155004";0;0;18;0;0;18
"3799";"360610155005";3;3;10;0;0;16
"3800";"360610155006";4;34;40;2;5;85
"3801";"360610156011";36;15;3;1;6;61
"3802";"360610156012";36;18;8;2;9;73
"3803";"360610156013";45;50;34;2;17;148
"3804";"360610156014";10;5;11;0;1;27
"3805";"360610156021";181;38;65;1;18;303
"3806";"360610157001";26;5;51;4;3;89
"3807";"360610157002";18;10;11;0;10;49
"3808";"360610157003";28;27;13;0;28;96
"3809";"360610157004";63;13;18;1;10;105
"3810";"360610157005";35;8;13;0;5;61
"3811";"360610157006";51;70;10;1;14;146
"3812";"360610157007";32;74;13;10;43;172
"3813";"360610157008";22;16;10;0;16;64
"3814";"360610158011";14;28;37;1;15;95
"3815";"360610158012";44;49;17;0;13;123
"3816";"360610158013";19;18;20;0;11;68
"3817";"360610158014";1;5;8;1;14;29
"3818";"360610158021";25;24;54;1;18;122
"3819";"360610158022";58;105;52;1;10;226
"3820";"360610159001";16;9;11;0;6;42
"3821";"360610159002";23;9;22;1;9;64
"3822";"360610159003";6;6;12;1;11;36
"3823";"360610159004";62;35;8;1;18;124
"3824";"360610159005";27;114;10;0;30;181
"3825";"360610159006";22;56;13;9;21;121
"3826";"360610159007";1;21;12;2;15;51
"3827";"360610160011";2;10;14;1;3;30
"3828";"360610160012";3;2;22;1;4;32
"3829";"360610160013";2;2;15;0;18;37
"3830";"360610160014";5;5;6;2;7;25
"3831";"360610160021";11;68;13;0;13;105
"3832";"360610160022";33;11;11;2;4;61
"3833";"360610161001";35;17;13;0;16;81
"3834";"360610161002";61;20;17;0;6;104
"3835";"360610161003";60;10;22;5;9;106
"3836";"360610161004";37;7;59;2;8;113
"3837";"360610161005";28;16;51;4;25;124
"3838";"360610161006";17;11;17;2;17;64
"3839";"360610162000";0;0;0;0;2;2
"3840";"360610162001";21;15;8;2;8;54
"3841";"360610162002";32;5;6;0;3;46
"3842";"360610162003";155;9;8;0;2;174
"3843";"360610162004";196;44;26;2;19;287
"3844";"360610162005";88;30;19;1;17;155
"3845";"360610163000";0;2;0;0;2;4
"3846";"360610163001";35;5;27;2;11;80
"3847";"360610163002";30;11;22;2;9;74
"3848";"360610163003";171;33;19;2;8;233
"3849";"360610163004";21;28;39;1;13;102
"3850";"360610163005";59;63;27;2;26;177
"3851";"360610164001";112;19;11;2;19;163
"3852";"360610164002";121;28;22;1;18;190
"3853";"360610164003";100;9;19;1;9;138
"3854";"360610164004";33;2;5;0;10;50
"3855";"360610165001";19;32;75;1;20;147
"3856";"360610165002";24;9;7;1;8;49
"3857";"360610165003";20;19;20;0;12;71
"3858";"360610165004";6;16;9;0;7;38
"3859";"360610165005";32;16;22;3;8;81
"3860";"360610166001";51;71;11;0;38;171
"3861";"360610166002";84;29;13;0;13;139
"3862";"360610166003";319;55;14;0;17;405
"3863";"360610166004";140;25;8;0;29;202
"3864";"360610166005";89;6;4;1;10;110
"3865";"360610166006";379;80;28;2;29;518
"3866";"360610167001";16;9;25;3;7;60
"3867";"360610167002";9;16;13;1;17;56
"3868";"360610167003";7;18;14;1;20;60
"3869";"360610167004";54;76;13;4;15;162
"3870";"360610167005";13;35;10;0;18;76
"3871";"360610168001";194;12;16;1;6;229
"3872";"360610168002";82;20;48;1;4;155
"3873";"360610168003";34;40;23;5;7;109
"3874";"360610169001";13;6;19;2;11;51
"3875";"360610169002";25;165;11;4;12;217
"3876";"360610169003";54;99;23;0;16;192
"3877";"360610169004";95;39;78;2;9;223
"3878";"360610169005";7;13;19;0;11;50
"3879";"360610169006";35;11;8;1;8;63
"3880";"360610170001";8;7;12;1;6;34
"3881";"360610170002";23;17;17;1;30;88
"3882";"360610170003";63;60;22;1;27;173
"3883";"360610170004";37;41;29;2;28;137
"3884";"360610170005";64;84;22;4;15;189
"3885";"360610171001";29;18;27;2;17;93
"3886";"360610171002";40;41;17;0;15;113
"3887";"360610171003";27;12;35;4;11;89
"3888";"360610171004";48;3;6;9;5;71
"3889";"360610171005";82;7;25;1;9;124
"3890";"360610171006";35;14;13;1;3;66
"3891";"360610172001";129;101;65;6;46;347
"3892";"360610172002";54;10;7;0;5;76
"3893";"360610172003";24;12;19;1;13;69
"3894";"360610172004";34;145;9;0;48;236
"3895";"360610172005";37;78;11;1;24;151
"3896";"360610173001";23;22;9;0;10;64
"3897";"360610173002";34;13;11;1;6;65
"3898";"360610173003";124;33;22;2;14;195
"3899";"360610173004";43;34;2;0;12;91
"3900";"360610173005";17;5;12;0;0;34
"3901";"360610173006";55;6;11;1;8;81
"3902";"360610173007";68;6;11;2;14;101
"3903";"360610174011";71;38;20;2;10;141
"3904";"360610174012";62;268;7;2;7;346
"3905";"360610174013";64;120;40;2;18;244
"3906";"360610174021";214;91;16;0;24;345
"3907";"360610175001";51;14;30;1;15;111
"3908";"360610175002";17;7;14;1;10;49
"3909";"360610175003";86;13;30;1;29;159
"3910";"360610175004";2;12;6;0;7;27
"3911";"360610175005";10;14;30;0;6;60
"3912";"360610175006";61;22;9;0;23;115
"3913";"360610175007";21;50;7;0;16;94
"3914";"360610177001";12;26;7;0;6;51
"3915";"360610177002";64;38;10;0;6;118
"3916";"360610177003";12;34;16;1;18;81
"3917";"360610177004";301;13;1;0;7;322
"3918";"360610177005";247;24;31;2;2;306
"3919";"360610177006";118;17;10;2;7;154
"3920";"360610177007";15;20;15;0;5;55
"3921";"360610177008";39;22;31;0;15;107
"3922";"360610178001";95;181;30;1;25;332
"3923";"360610178002";139;129;115;9;24;416
"3924";"360610178003";142;125;24;3;25;319
"3925";"360610179001";43;20;15;1;26;105
"3926";"360610179002";7;5;2;3;7;24
"3927";"360610179003";16;16;12;2;5;51
"3928";"360610179004";21;8;14;3;16;62
"3929";"360610179005";10;5;9;2;13;39
"3930";"360610179006";48;47;14;4;20;133
"3931";"360610179007";13;19;10;2;25;69
"3932";"360610180001";188;26;18;5;19;256
"3933";"360610180002";274;84;103;3;85;549
"3934";"360610180003";131;66;71;7;31;306
"3935";"360610180004";33;12;3;0;7;55
"3936";"360610181001";46;21;6;0;23;96
"3937";"360610181002";31;8;6;0;20;65
"3938";"360610181003";33;29;15;0;10;87
"3939";"360610181004";37;9;6;0;2;54
"3940";"360610181005";17;4;12;1;6;40
"3941";"360610181006";10;18;4;1;13;46
"3942";"360610182001";135;153;5;2;24;319
"3943";"360610182002";338;75;26;2;18;459
"3944";"360610182003";53;142;27;3;28;253
"3945";"360610182004";157;11;9;3;6;186
"3946";"360610182005";187;27;4;2;3;223
"3947";"360610183001";64;45;15;2;25;151
"3948";"360610183002";41;2;2;0;3;48
"3949";"360610183003";41;12;13;0;13;79
"3950";"360610183004";20;15;40;3;9;87
"3951";"360610183005";7;24;92;2;13;138
"3952";"360610183006";48;133;43;2;48;274
"3953";"360610183007";37;145;22;0;17;221
"3954";"360610184001";138;66;40;2;24;270
"3955";"360610184002";63;38;12;0;15;128
"3956";"360610184003";67;11;6;1;10;95
"3957";"360610184004";139;5;10;4;9;167
"3958";"360610185001";19;16;7;1;3;46
"3959";"360610185002";47;46;66;2;22;183
"3960";"360610185003";0;5;4;0;6;15
"3961";"360610186001";157;47;22;2;15;243
"3962";"360610186002";213;128;23;5;16;385
"3963";"360610186003";140;45;4;5;7;201
"3964";"360610187001";71;10;18;0;12;111
"3965";"360610187002";43;13;19;0;9;84
"3966";"360610187003";33;9;12;0;7;61
"3967";"360610187004";37;14;10;7;6;74
"3968";"360610187005";251;25;13;2;15;306
"3969";"360610187006";55;58;82;4;25;224
"3970";"360610188001";97;91;15;3;21;227
"3971";"360610188002";170;304;215;6;42;737
"3972";"360610188003";196;1429;39;1;33;1698
"3973";"360610188004";130;74;16;0;14;234
"3974";"360610189001";34;32;15;1;13;95
"3975";"360610189002";71;37;17;1;12;138
"3976";"360610189003";468;40;8;1;14;531
"3977";"360610189004";119;169;11;1;24;324
"3978";"360610189005";84;57;11;1;20;173
"3979";"360610189006";231;109;7;3;12;362
"3980";"360610190001";320;152;61;4;29;566
"3981";"360610191001";37;9;7;1;8;62
"3982";"360610191002";17;11;8;1;15;52
"3983";"360610191003";23;21;4;0;1;49
"3984";"360610191004";57;9;12;4;26;108
"3985";"360610191005";42;125;10;2;31;210
"3986";"360610191006";117;51;7;5;45;225
"3987";"360610192001";251;108;49;4;11;423
"3988";"360610192002";140;21;4;0;3;168
"3989";"360610193001";95;24;4;1;13;137
"3990";"360610193002";137;58;15;3;17;230
"3991";"360610193003";129;72;9;3;12;225
"3992";"360610193004";100;60;6;0;12;178
"3993";"360610193005";285;436;24;1;21;767
"3994";"360610193006";67;35;14;1;21;138
"3995";"360610194001";195;55;13;2;16;281
"3996";"360610194002";44;41;10;1;22;118
"3997";"360610194003";61;22;8;1;13;105
"3998";"360610194004";94;11;14;6;10;135
"3999";"360610195001";34;18;12;2;4;70
"4000";"360610195002";54;386;29;2;40;511
"4001";"360610195003";255;211;11;1;20;498
"4002";"360610195004";106;77;11;0;19;213
"4003";"360610195005";81;38;17;0;17;153
"4004";"360610196001";110;32;18;0;9;169
"4005";"360610196002";67;28;35;2;22;154
"4006";"360610196003";39;62;59;1;75;236
"4007";"360610197011";27;134;36;2;64;263
"4008";"360610197021";79;102;25;4;52;262
"4009";"360610198001";66;194;39;8;156;463
"4010";"360610198002";4;66;10;1;21;102
"4011";"360610199001";39;36;28;4;15;122
"4012";"360610199002";41;38;13;5;23;120
"4013";"360610199003";89;8;4;0;10;111
"4014";"360610199004";42;46;10;1;5;104
"4015";"360610199005";33;19;13;2;29;96
"4016";"360610199006";45;91;13;1;53;203
"4017";"360610200001";142;123;46;2;27;340
"4018";"360610200002";196;388;93;22;100;799
"4019";"360610201011";8;11;14;0;5;38
"4020";"360610201021";31;97;34;2;22;186
"4021";"360610201022";157;217;12;6;22;414
"4022";"360610201023";46;95;0;0;6;147
"4023";"360610201024";66;58;5;2;10;141
"4024";"360610203001";12;14;7;1;5;39
"4025";"360610203002";7;16;8;2;6;39
"4026";"360610205001";9;19;33;0;10;71
"4027";"360610205002";64;1;9;4;3;81
"4028";"360610205003";9;11;8;1;1;30
"4029";"360610206001";283;175;46;6;44;554
"4030";"360610206002";96;57;72;22;62;309
"4031";"360610207011";7;7;5;0;0;19
"4032";"360610207012";19;14;5;2;3;43
"4033";"360610208001";69;94;14;4;21;202
"4034";"360610208002";241;121;43;0;21;426
"4035";"360610208003";92;63;44;1;48;248
"4036";"360610209011";46;40;24;7;23;140
"4037";"360610209012";196;55;40;1;4;296
"4038";"360610210001";59;4;20;1;6;90
"4039";"360610210002";21;8;8;2;4;43
"4040";"360610210003";153;45;15;0;7;220
"4041";"360610210004";186;26;15;3;11;241
"4042";"360610211001";40;66;35;0;8;149
"4043";"360610211002";31;30;11;1;7;80
"4044";"360610211003";144;131;13;2;26;316
"4045";"360610211004";68;8;3;1;10;90
"4046";"360610211005";42;4;88;0;12;146
"4047";"360610211006";7;21;15;2;2;47
"4048";"360610211007";49;18;7;12;21;107
"4049";"360610212001";104;89;26;1;10;230
"4050";"360610212002";6;16;10;1;17;50
"4051";"360610212003";24;4;2;1;6;37
"4052";"360610212004";46;24;6;1;16;93
"4053";"360610213031";152;64;6;1;31;254
"4054";"360610213032";33;15;20;3;7;78
"4055";"360610213033";452;152;72;0;17;693
"4056";"360610213034";122;66;9;1;23;221
"4057";"360610214001";52;64;21;0;9;146
"4058";"360610214002";51;32;16;0;7;106
"4059";"360610215001";71;139;24;1;26;261
"4060";"360610215002";308;91;16;4;25;444
"4061";"360610216001";150;126;12;6;26;320
"4062";"360610216002";71;95;5;0;17;188
"4063";"360610216003";210;433;9;1;13;666
"4064";"360610216004";117;254;16;2;22;411
"4065";"360610216005";295;99;36;4;26;460
"4066";"360610217031";41;225;48;6;10;330
"4067";"360610218001";65;117;28;5;17;232
"4068";"360610218002";306;207;41;0;42;596
"4069";"360610218003";238;309;130;3;74;754
"4070";"360610218004";237;292;49;5;53;636
"4071";"360610219001";166;154;32;8;20;380
"4072";"360610219002";145;83;9;72;16;325
"4073";"360610219003";335;22;13;0;17;387
"4074";"360610219004";307;15;22;1;4;349
"4075";"360610220001";57;97;22;6;26;208
"4076";"360610220002";74;66;18;4;35;197
"4077";"360610220003";49;63;2;0;3;117
"4078";"360610220004";104;164;17;1;21;307
"4079";"360610220005";161;131;17;1;24;334
"4080";"360610221021";105;44;25;5;20;199
"4081";"360610221022";26;125;40;5;26;222
"4082";"360610222001";115;135;43;6;41;340
"4083";"360610222002";85;342;94;6;106;633
"4084";"360610223011";198;102;7;1;6;314
"4085";"360610223012";444;259;9;1;51;764
"4086";"360610223013";409;252;13;1;9;684
"4087";"360610223014";503;312;5;1;17;838
"4088";"360610223021";178;189;34;11;35;447
"4089";"360610224001";73;37;12;4;16;142
"4090";"360610224002";128;144;42;5;28;347
"4091";"360610224003";625;109;8;1;10;753
"4092";"360610224004";321;50;14;0;9;394
"4093";"360610225001";376;321;32;1;277;1007
"4094";"360610225002";169;44;12;3;28;256
"4095";"360610225003";148;157;16;2;44;367
"4096";"360610225004";215;121;4;0;9;349
"4097";"360610225005";213;239;10;0;15;477
"4098";"360610226001";208;205;31;2;37;483
"4099";"360610226002";117;55;27;2;35;236
"4100";"360610226003";151;513;92;5;32;793
"4101";"360610227001";184;105;42;7;35;373
"4102";"360610227002";157;20;37;0;29;243
"4103";"360610227003";246;44;140;9;28;467
"4104";"360610228001";179;181;22;4;33;419
"4105";"360610228002";23;14;16;2;32;87
"4106";"360610228003";134;77;14;3;25;253
"4107";"360610228004";59;21;34;6;9;129
"4108";"360610229001";16;11;1;0;6;34
"4109";"360610229002";268;103;14;0;18;403
"4110";"360610229003";522;357;59;2;42;982
"4111";"360610229004";231;207;9;2;12;461
"4112";"360610229005";237;81;12;0;23;353
"4113";"360610230001";152;41;9;0;13;215
"4114";"360610230002";253;170;22;1;31;477
"4115";"360610230003";52;99;36;3;38;228
"4116";"360610230004";284;153;15;4;18;474
"4117";"360610230005";238;77;7;2;9;333
"4118";"360610231001";205;77;32;4;29;347
"4119";"360610231002";256;217;43;2;217;735
"4120";"360610231003";280;165;51;7;78;581
"4121";"360610232001";145;12;19;7;19;202
"4122";"360610232002";832;73;10;3;9;927
"4123";"360610232003";278;48;4;1;10;341
"4124";"360610232004";503;261;19;5;47;835
"4125";"360610233001";419;304;26;2;43;794
"4126";"360610233002";201;129;10;1;26;367
"4127";"360610233003";401;140;15;4;28;588
"4128";"360610234001";455;242;48;6;22;773
"4129";"360610234002";220;97;25;9;24;375
"4130";"360610235011";57;15;17;1;9;99
"4131";"360610235012";482;144;11;1;48;686
"4132";"360610235013";95;12;40;5;7;159
"4133";"360610235014";340;56;13;1;30;440
"4134";"360610235021";183;86;19;4;14;306
"4135";"360610236001";141;20;63;4;18;246
"4136";"360610236002";582;23;9;4;5;623
"4137";"360610236003";17;10;7;1;4;39
"4138";"360610236004";62;71;9;3;8;153
"4139";"360610237001";411;454;22;1;22;910
"4140";"360610237002";282;219;10;2;27;540
"4141";"360610237003";224;94;37;3;28;386
"4142";"360610238010";0;1;0;0;0;1
"4143";"360610238011";14;12;1;0;5;32
"4144";"360610238021";1;2;1;0;2;6
"4145";"360610238022";12;3;0;0;2;17
"4146";"360610239001";53;26;6;5;12;102
"4147";"360610239002";185;81;16;2;21;305
"4148";"360610240001";12;44;2;3;12;73
"4149";"360610241001";167;39;12;5;12;235
"4150";"360610241002";84;61;17;1;22;185
"4151";"360610241003";128;306;0;1;17;452
"4152";"360610241004";433;166;5;2;18;624
"4153";"360610241005";266;43;8;0;10;327
"4154";"360610242000";0;0;1;0;0;1
"4155";"360610242001";182;28;21;9;8;248
"4156";"360610242002";30;7;16;0;35;88
"4157";"360610242003";22;10;46;8;22;108
"4158";"360610243011";139;54;9;0;29;231
"4159";"360610243012";158;79;86;6;35;364
"4160";"360610243013";31;44;2;0;10;87
"4161";"360610243021";743;42;35;16;11;847
"4162";"360610243022";2;1;1;0;0;4
"4163";"360610243023";218;7;6;1;11;243
"4164";"360610245001";241;396;11;0;24;672
"4165";"360610245002";174;176;38;1;28;417
"4166";"360610245003";259;173;13;1;21;467
"4167";"360610245004";278;94;25;0;40;437
"4168";"360610245005";142;120;30;1;51;344
"4169";"360610245006";198;135;10;2;26;371
"4170";"360610245007";225;141;2;3;38;409
"4171";"360610247001";128;112;28;3;10;281
"4172";"360610247002";124;157;14;0;21;316
"4173";"360610247003";164;224;9;2;14;413
"4174";"360610247004";174;301;255;1;21;752
"4175";"360610247005";126;169;195;2;8;500
"4176";"360610249001";114;105;39;1;15;274
"4177";"360610251001";131;131;65;1;42;370
"4178";"360610251002";71;157;29;0;20;277
"4179";"360610253001";229;149;31;0;9;418
"4180";"360610253002";300;854;58;0;21;1233
"4181";"360610253003";249;330;21;0;21;621
"4182";"360610253004";36;59;20;4;13;132
"4183";"360610253005";509;182;14;0;41;746
"4184";"360610253006";95;62;15;1;15;188
"4185";"360610255001";36;53;31;6;1;127
"4186";"360610255002";111;114;15;2;23;265
"4187";"360610255003";178;65;131;1;12;387
"4188";"360610255004";67;27;9;1;9;113
"4189";"360610257001";162;78;53;5;57;355
"4190";"360610257002";113;49;20;9;33;224
"4191";"360610257003";34;93;13;0;9;149
"4192";"360610259001";307;108;63;15;16;509
"4193";"360610259002";51;51;67;6;13;188
"4194";"360610261001";220;118;37;2;35;412
"4195";"360610261002";96;162;5;0;20;283
"4196";"360610261003";62;19;3;0;9;93
"4197";"360610261004";156;204;15;0;24;399
"4198";"360610261005";251;72;323;1;40;687
"4199";"360610261006";73;55;9;0;10;147
"4200";"360610261007";149;256;24;3;14;446
"4201";"360610263001";104;82;12;2;25;225
"4202";"360610263002";230;61;7;2;13;313
"4203";"360610263003";158;178;14;3;18;371
"4204";"360610263004";207;382;30;4;27;650
"4205";"360610263005";177;160;10;1;19;367
"4206";"360610265001";81;62;1;1;6;151
"4207";"360610265002";410;174;26;1;23;634
"4208";"360610265003";61;49;48;5;9;172
"4209";"360610265004";224;109;11;1;26;371
"4210";"360610265005";47;23;11;2;16;99
"4211";"360610267001";70;13;19;1;8;111
"4212";"360610269001";136;96;13;0;20;265
"4213";"360610269002";168;101;5;0;12;286
"4214";"360610269003";32;18;31;0;21;102
"4215";"360610269004";100;128;12;3;31;274
"4216";"360610269005";91;71;15;1;25;203
"4217";"360610269006";747;193;4;1;12;957
"4218";"360610271001";170;235;5;2;14;426
"4219";"360610271002";75;274;14;6;79;448
"4220";"360610271003";176;98;36;4;15;329
"4221";"360610271004";106;80;18;0;11;215
"4222";"360610271005";59;6;18;0;10;93
"4223";"360610273001";124;64;43;3;39;273
"4224";"360610273002";98;12;23;0;10;143
"4225";"360610273003";87;122;27;5;24;265
"4226";"360610273004";25;13;4;2;1;45
"4227";"360610275001";5;9;7;1;7;29
"4228";"360610275002";0;0;3;3;2;8
"4229";"360610277001";306;265;30;6;39;646
"4230";"360610277002";147;94;5;4;19;269
"4231";"360610277003";112;337;15;3;12;479
"4232";"360610277004";175;69;4;0;12;260
"4233";"360610279001";53;48;13;6;12;132
"4234";"360610279002";371;293;4;1;10;679
"4235";"360610279003";239;256;12;3;28;538
"4236";"360610279004";294;247;30;2;21;594
"4237";"360610279005";519;245;10;1;26;801
"4238";"360610279006";69;60;1;0;2;132
"4239";"360610279007";51;25;2;0;3;81
"4240";"360610281001";16;5;4;1;11;37
"4241";"360610281002";91;61;66;11;18;247
"4242";"360610283001";49;34;0;0;7;90
"4243";"360610283002";763;303;50;4;38;1158
"4244";"360610283003";138;382;61;0;8;589
"4245";"360610283004";250;341;22;0;19;632
"4246";"360610285001";289;498;33;0;45;865
"4247";"360610285002";239;305;9;1;13;567
"4248";"360610285003";142;211;2;1;5;361
"4249";"360610285004";567;642;13;0;19;1241
"4250";"360610287001";103;495;133;3;36;770
"4251";"360610287002";236;332;9;2;33;612
"4252";"360610287003";431;902;20;3;38;1394
"4253";"360610291001";319;80;4;1;12;416
"4254";"360610291002";73;197;14;0;29;313
"4255";"360610291003";176;46;7;0;13;242
"4256";"360610291004";207;145;11;3;14;380
"4257";"360610291005";847;248;3;0;21;1119
"4258";"360610291006";176;84;4;0;13;277
"4259";"360610291007";143;93;9;0;12;257
"4260";"360610293001";192;545;43;6;34;820
"4261";"360610293002";103;47;19;1;11;181
"4262";"360610293003";107;307;19;0;36;469
"4263";"360610293004";198;453;29;2;42;724
"4264";"360610293005";174;76;3;0;17;270
"4265";"360610295001";103;354;113;1;16;587
"4266";"360610295002";192;887;104;3;39;1225
"4267";"360610295003";269;128;56;0;24;477
"4268";"360610295004";176;59;62;2;49;348
"4269";"360610297000";0;2;0;0;0;2
"4270";"360610297001";37;184;56;2;17;296
"4271";"360610299000";0;0;1;0;0;1
"4272";"360610299001";510;121;18;2;16;667
"4273";"360610299002";171;413;79;15;21;699
"4274";"360610303001";127;230;37;3;41;438
"4275";"360610303002";55;56;20;1;13;145
"4276";"360610303003";154;461;30;0;23;668
"4277";"360610307001";72;49;99;6;17;243
"4278";"360610307002";9;7;18;0;1;35
"4279";"360610307003";78;73;19;3;10;183
"4280";"360610309001";342;67;32;1;19;461
"4281";"360610309002";116;35;87;0;30;268
"4282";"360610309003";146;6;39;1;7;199
"4283";"360610309004";216;98;185;5;47;551
"4284";"360610311001";35;78;75;5;23;216
"4285";"360610317031";13;40;32;1;5;91
"4286";"360610317032";2;18;32;2;4;58
"4287";"360610317041";36;56;13;0;7;112
"4288";"360610317042";13;7;15;1;1;37
"4289";"360610317043";17;14;36;0;3;70
"4290";"360610317044";14;61;42;3;9;129
"4291";"360610319001";0;2;8;1;9;20
"4292";"360810001001";44;135;376;59;40;654
"4293";"360810002001";60;9;183;70;42;364
"4294";"360810002002";332;15;258;16;39;660
"4295";"360810004001";82;38;114;26;39;299
"4296";"360810004002";79;11;128;41;62;321
"4297";"360810004003";76;7;131;40;38;292
"4298";"360810006001";83;43;179;18;31;354
"4299";"360810006002";50;6;91;67;20;234
"4300";"360810006003";122;153;351;131;43;800
"4301";"360810007001";53;27;79;25;27;211
"4302";"360810007002";26;80;63;10;25;204
"4303";"360810007003";124;55;260;23;24;486
"4304";"360810007004";74;138;198;51;66;527
"4305";"360810008001";71;12;145;67;35;330
"4306";"360810008002";46;13;150;51;25;285
"4307";"360810010001";29;9;93;12;27;170
"4308";"360810010002";75;13;260;40;45;433
"4309";"360810012001";144;4;69;45;24;286
"4310";"360810012002";58;13;124;51;17;263
"4311";"360810012003";55;32;117;34;24;262
"4312";"360810014001";37;5;155;36;44;277
"4313";"360810014002";100;10;68;29;37;244
"4314";"360810014003";55;11;69;22;59;216
"4315";"360810016001";83;12;88;21;24;228
"4316";"360810016002";127;58;119;55;56;415
"4317";"360810018001";123;13;80;19;61;296
"4318";"360810018002";63;22;162;43;30;320
"4319";"360810019001";63;83;563;67;111;887
"4320";"360810020001";115;8;163;32;42;360
"4321";"360810022001";55;33;101;30;30;249
"4322";"360810022002";47;64;111;39;36;297
"4323";"360810024001";68;4;68;23;20;183
"4324";"360810024002";38;17;236;37;30;358
"4325";"360810025001";47;41;5;0;5;98
"4326";"360810025002";116;12;3;0;5;136
"4327";"360810025003";109;8;7;0;1;125
"4328";"360810025004";247;6;3;0;4;260
"4329";"360810025005";166;7;3;1;10;187
"4330";"360810025006";79;11;0;2;4;96
"4331";"360810026001";27;12;69;21;18;147
"4332";"360810026002";77;26;82;11;30;226
"4333";"360810028001";181;25;175;55;44;480
"4334";"360810028002";65;36;123;41;27;292
"4335";"360810030001";38;12;84;54;27;215
"4336";"360810031001";15;28;130;19;21;213
"4337";"360810031002";32;13;187;24;20;276
"4338";"360810032001";74;9;108;65;49;305
"4339";"360810033001";35;52;114;3;12;216
"4340";"360810033002";26;12;89;6;28;161
"4341";"360810033003";28;18;248;67;23;384
"4342";"360810033004";32;3;133;51;9;228
"4343";"360810034001";28;5;117;76;57;283
"4344";"360810034002";66;47;132;57;23;325
"4345";"360810036001";88;11;112;41;61;313
"4346";"360810036002";139;14;94;54;49;350
"4347";"360810037001";289;82;42;1;7;421
"4348";"360810038001";129;15;77;18;25;264
"4349";"360810038002";55;9;129;24;37;254
"4350";"360810039001";20;6;193;158;32;409
"4351";"360810040011";44;9;136;33;22;244
"4352";"360810040012";66;13;71;27;32;209
"4353";"360810040021";106;4;122;93;34;359
"4354";"360810042001";130;29;126;41;58;384
"4355";"360810042002";39;16;66;15;31;167
"4356";"360810042003";62;2;46;26;27;163
"4357";"360810043001";227;65;45;12;21;370
"4358";"360810043002";2;0;82;57;3;144
"4359";"360810044011";32;8;110;63;44;257
"4360";"360810044012";79;6;89;39;30;243
"4361";"360810045001";26;16;79;32;52;205
"4362";"360810045002";1;4;4;2;0;11
"4363";"360810045003";3;1;14;1;4;23
"4364";"360810047001";56;10;53;15;19;153
"4365";"360810047002";278;12;6;1;19;316
"4366";"360810050001";15;2;26;8;0;51
"4367";"360810051001";43;52;78;19;40;232
"4368";"360810051002";64;38;119;68;33;322
"4369";"360810052001";62;9;63;43;37;214
"4370";"360810052002";66;20;64;28;30;208
"4371";"360810053001";87;85;103;1;15;291
"4372";"360810053002";165;7;58;1;20;251
"4373";"360810053003";19;1;38;0;2;60
"4374";"360810053004";56;5;116;1;31;209
"4375";"360810054001";11;5;41;9;35;101
"4376";"360810054002";38;4;78;14;35;169
"4377";"360810054003";78;20;179;57;53;387
"4378";"360810054004";97;34;143;47;63;384
"4379";"360810055001";147;243;261;83;69;803
"4380";"360810057001";58;61;103;8;37;267
"4381";"360810057002";26;28;54;11;7;126
"4382";"360810057003";104;259;60;3;61;487
"4383";"360810058001";69;9;211;63;55;407
"4384";"360810058002";45;9;28;12;15;109
"4385";"360810058003";51;14;54;36;38;193
"4386";"360810058004";19;37;105;69;34;264
"4387";"360810059001";35;20;88;1;31;175
"4388";"360810059002";44;49;130;2;6;231
"4389";"360810059003";33;128;86;3;35;285
"4390";"360810061001";31;84;65;2;9;191
"4391";"360810061002";59;338;30;2;11;440
"4392";"360810061003";69;92;22;0;20;203
"4393";"360810061004";51;25;44;1;21;142
"4394";"360810062011";9;3;30;7;19;68
"4395";"360810062012";115;6;143;35;77;376
"4396";"360810062021";8;20;94;17;19;158
"4397";"360810062022";17;9;100;39;27;192
"4398";"360810062023";38;5;82;24;61;210
"4399";"360810062024";68;4;65;12;21;170
"4400";"360810062025";23;5;49;17;22;116
"4401";"360810062026";45;6;82;20;17;170
"4402";"360810062027";89;6;91;32;50;268
"4403";"360810063001";49;17;79;1;48;194
"4404";"360810063002";66;62;83;3;16;230
"4405";"360810063003";65;26;40;1;27;159
"4406";"360810063004";19;69;91;5;32;216
"4407";"360810065011";83;81;26;0;11;201
"4408";"360810065012";21;10;88;2;18;139
"4409";"360810065013";31;24;34;5;10;104
"4410";"360810065021";50;210;170;3;32;465
"4411";"360810065022";31;12;61;13;13;130
"4412";"360810065023";56;14;124;8;22;224
"4413";"360810069001";36;17;199;5;21;278
"4414";"360810069002";72;21;139;17;42;291
"4415";"360810069003";27;94;85;6;49;261
"4416";"360810071001";16;11;59;2;26;114
"4417";"360810071002";34;9;11;2;16;72
"4418";"360810071003";50;6;60;0;4;120
"4419";"360810071004";35;203;153;13;52;456
"4420";"360810073001";62;43;55;3;13;176
"4421";"360810073002";46;10;41;5;9;111
"4422";"360810073003";65;21;60;2;11;159
"4423";"360810075001";38;11;127;2;9;187
"4424";"360810075002";119;177;17;1;19;333
"4425";"360810075003";24;10;19;3;6;62
"4426";"360810077001";62;17;103;19;34;235
"4427";"360810079001";121;24;256;18;33;452
"4428";"360810079002";49;8;35;8;34;134
"4429";"360810081001";69;28;204;71;28;400
"4430";"360810083001";70;52;308;49;19;498
"4431";"360810083002";86;88;136;45;30;385
"4432";"360810085001";56;12;150;71;25;314
"4433";"360810085002";12;13;181;68;31;305
"4434";"360810086001";49;12;81;27;35;204
"4435";"360810086002";25;7;68;46;60;206
"4436";"360810087001";705;40;18;4;14;781
"4437";"360810087002";55;20;39;23;9;146
"4438";"360810087003";80;35;16;1;6;138
"4439";"360810088001";59;46;180;76;81;442
"4440";"360810088002";37;101;71;24;22;255
"4441";"360810091001";23;10;47;7;16;103
"4442";"360810091002";55;18;113;14;28;228
"4443";"360810094001";64;15;126;9;59;273
"4444";"360810094002";106;9;100;22;55;292
"4445";"360810095001";43;3;37;1;12;96
"4446";"360810095002";21;12;63;9;18;123
"4447";"360810096001";152;23;194;30;97;496
"4448";"360810096002";197;20;142;25;98;482
"4449";"360810097001";14;1;26;6;26;73
"4450";"360810097002";19;29;32;12;12;104
"4451";"360810097003";16;4;35;2;14;71
"4452";"360810097004";32;29;49;2;24;136
"4453";"360810098001";52;14;114;13;79;272
"4454";"360810098002";57;33;88;4;40;222
"4455";"360810099001";4;19;4;1;7;35
"4456";"360810100001";145;14;37;20;42;258
"4457";"360810100002";183;24;82;30;123;442
"4458";"360810101001";21;22;136;17;23;219
"4459";"360810101002";32;78;120;10;47;287
"4460";"360810102001";63;10;76;47;52;248
"4461";"360810102002";80;34;91;21;67;293
"4462";"360810103001";22;27;49;10;26;134
"4463";"360810103002";25;44;71;10;37;187
"4464";"360810103003";44;10;53;6;20;133
"4465";"360810103004";34;27;36;5;21;123
"4466";"360810104001";101;171;123;10;68;473
"4467";"360810104002";168;3;193;29;68;461
"4468";"360810105001";20;2;18;1;5;46
"4469";"360810105002";56;3;19;2;6;86
"4470";"360810105003";44;13;17;0;21;95
"4471";"360810105004";42;10;33;2;18;105
"4472";"360810106001";59;7;199;41;60;366
"4473";"360810106002";276;34;218;27;80;635
"4474";"360810107011";1;11;23;30;6;71
"4475";"360810108001";178;7;216;36;714;1151
"4476";"360810108002";144;12;242;50;101;549
"4477";"360810110001";42;9;76;35;32;194
"4478";"360810110002";137;29;330;24;98;618
"4479";"360810111001";64;53;42;5;18;182
"4480";"360810111002";14;11;80;6;14;125
"4481";"360810112001";130;13;125;19;53;340
"4482";"360810112002";107;16;133;24;39;319
"4483";"360810113001";34;20;15;1;28;98
"4484";"360810113002";79;22;46;0;32;179
"4485";"360810113003";50;91;67;0;29;237
"4486";"360810114001";151;40;188;74;42;495
"4487";"360810115001";49;47;145;5;43;289
"4488";"360810115002";14;24;91;1;49;179
"4489";"360810116001";137;31;62;22;36;288
"4490";"360810116002";96;11;183;29;62;381
"4491";"360810117001";51;12;51;5;27;146
"4492";"360810117002";24;17;25;2;13;81
"4493";"360810117003";41;50;189;5;36;321
"4494";"360810117004";28;25;39;0;29;121
"4495";"360810118001";65;6;211;38;109;429
"4496";"360810118002";75;9;71;23;53;231
"4497";"360810119001";34;14;59;5;33;145
"4498";"360810119002";9;2;33;2;23;69
"4499";"360810120001";10;1;85;11;9;116
"4500";"360810120002";35;8;159;50;238;490
"4501";"360810121001";53;13;83;5;18;172
"4502";"360810121002";13;39;21;3;23;99
"4503";"360810122001";78;178;114;23;73;466
"4504";"360810122002";67;6;111;25;117;326
"4505";"360810123011";30;45;77;48;48;248
"4506";"360810123012";18;5;79;20;24;146
"4507";"360810123013";4;6;30;10;73;123
"4508";"360810124001";63;42;76;17;52;250
"4509";"360810124002";55;30;140;47;70;342
"4510";"360810125001";25;40;82;7;22;176
"4511";"360810125002";13;31;39;3;14;100
"4512";"360810126011";48;12;125;47;68;300
"4513";"360810126012";44;22;108;38;21;233
"4514";"360810126021";42;6;68;16;25;157
"4515";"360810126022";135;25;129;24;45;358
"4516";"360810128001";24;4;30;16;18;92
"4517";"360810128002";64;6;101;5;25;201
"4518";"360810130001";4;0;36;40;6;86
"4519";"360810130002";32;62;54;8;34;190
"4520";"360810132001";14;8;50;11;7;90
"4521";"360810132002";19;71;63;7;50;210
"4522";"360810134001";414;7;33;1;10;465
"4523";"360810134002";51;7;43;4;7;112
"4524";"360810134003";55;15;153;7;15;245
"4525";"360810134004";4;4;25;2;6;41
"4526";"360810135001";12;6;53;10;20;101
"4527";"360810136001";26;5;21;6;13;71
"4528";"360810136002";102;70;32;0;7;211
"4529";"360810137001";56;42;108;27;42;275
"4530";"360810138001";47;2;51;8;9;117
"4531";"360810138002";143;22;335;6;49;555
"4532";"360810140001";40;6;141;12;27;226
"4533";"360810140002";119;37;134;2;36;328
"4534";"360810141001";16;39;20;0;3;78
"4535";"360810141002";5;7;135;44;38;229
"4536";"360810142011";50;17;103;10;50;230
"4537";"360810142012";97;25;199;20;87;428
"4538";"360810142021";164;22;168;8;74;436
"4539";"360810142022";84;25;150;41;39;339
"4540";"360810143001";25;4;202;1;55;287
"4541";"360810143002";141;410;123;5;51;730
"4542";"360810144001";108;43;262;25;106;544
"4543";"360810145001";15;2;151;52;31;251
"4544";"360810145002";45;36;89;24;22;216
"4545";"360810147001";16;4;72;21;11;124
"4546";"360810147002";20;23;18;14;25;100
"4547";"360810147003";46;60;77;4;26;213
"4548";"360810148001";138;11;152;21;149;471
"4549";"360810149001";50;25;58;3;14;150
"4550";"360810149002";33;33;184;4;41;295
"4551";"360810150001";429;13;73;24;33;572
"4552";"360810150002";113;25;88;17;46;289
"4553";"360810151001";29;18;101;15;29;192
"4554";"360810151002";71;89;129;42;37;368
"4555";"360810152001";37;1;79;22;47;186
"4556";"360810152002";74;16;110;68;50;318
"4557";"360810153001";25;11;119;8;23;186
"4558";"360810153002";25;42;67;6;24;164
"4559";"360810154001";69;13;57;32;35;206
"4560";"360810154002";96;69;152;27;41;385
"4561";"360810155001";89;170;149;2;39;449
"4562";"360810155002";51;476;65;1;43;636
"4563";"360810156001";92;18;124;41;71;346
"4564";"360810156002";92;24;122;36;90;364
"4565";"360810157001";80;47;94;41;43;305
"4566";"360810158011";24;3;44;43;54;168
"4567";"360810158012";34;11;45;28;48;166
"4568";"360810158013";111;63;112;32;93;411
"4569";"360810158021";173;30;115;8;86;412
"4570";"360810158022";237;22;169;19;104;551
"4571";"360810158023";101;23;94;17;120;355
"4572";"360810159001";54;15;74;6;18;167
"4573";"360810159002";111;18;38;88;30;285
"4574";"360810159003";52;4;19;9;7;91
"4575";"360810159004";52;18;82;4;12;168
"4576";"360810161001";51;12;77;5;22;167
"4577";"360810161002";56;8;64;10;19;157
"4578";"360810163001";21;9;93;14;13;150
"4579";"360810163002";109;93;9;4;2;217
"4580";"360810163003";270;18;16;7;13;324
"4581";"360810164001";64;6;238;40;51;399
"4582";"360810164002";118;13;144;33;133;441
"4583";"360810166001";218;15;186;26;62;507
"4584";"360810166002";59;18;62;6;20;165
"4585";"360810168001";163;19;107;12;80;381
"4586";"360810168002";138;13;107;44;132;434
"4587";"360810169001";79;3;21;0;5;108
"4588";"360810169002";63;10;62;9;20;164
"4589";"360810169003";28;10;61;1;9;109
"4590";"360810169004";15;8;15;1;7;46
"4591";"360810170001";37;2;168;22;34;263
"4592";"360810170002";110;44;75;16;40;285
"4593";"360810171001";9;39;163;48;36;295
"4594";"360810172001";59;15;78;28;63;243
"4595";"360810172002";40;37;66;44;35;222
"4596";"360810174001";96;14;46;17;33;206
"4597";"360810174002";65;3;128;75;72;343
"4598";"360810176001";45;2;59;27;25;158
"4599";"360810176002";47;14;36;5;34;136
"4600";"360810178001";156;18;75;9;45;303
"4601";"360810178002";105;12;64;34;39;254
"4602";"360810179001";21;4;113;18;21;177
"4603";"360810179002";26;34;69;17;42;188
"4604";"360810180001";57;10;87;45;59;258
"4605";"360810181011";73;76;74;0;9;232
"4606";"360810181012";30;4;15;0;5;54
"4607";"360810181013";74;23;17;0;21;135
"4608";"360810181021";27;27;21;1;25;101
"4609";"360810181022";48;34;21;4;18;125
"4610";"360810181023";84;65;9;1;19;178
"4611";"360810182001";63;6;44;28;30;171
"4612";"360810182002";62;7;65;43;34;211
"4613";"360810183001";8;5;37;2;8;60
"4614";"360810183002";151;8;15;1;18;193
"4615";"360810183003";94;36;16;1;13;160
"4616";"360810183004";58;38;46;1;46;189
"4617";"360810183005";70;89;40;8;13;220
"4618";"360810184011";187;10;88;52;52;389
"4619";"360810184021";56;14;47;35;39;191
"4620";"360810184022";27;4;39;6;19;95
"4621";"360810185011";32;3;40;2;6;83
"4622";"360810185012";3;0;4;2;4;13
"4623";"360810185013";62;20;50;2;22;156
"4624";"360810185021";33;9;32;2;6;82
"4625";"360810185022";78;17;35;0;18;148
"4626";"360810185023";18;46;16;4;14;98
"4627";"360810186001";142;15;140;71;56;424
"4628";"360810187001";15;3;70;5;16;109
"4629";"360810187002";7;1;16;3;8;35
"4630";"360810187003";33;4;94;4;22;157
"4631";"360810188001";35;7;53;32;34;161
"4632";"360810189001";406;7;50;1;48;512
"4633";"360810189002";67;62;131;19;25;304
"4634";"360810189003";31;6;33;1;2;73
"4635";"360810190001";25;9;42;14;26;116
"4636";"360810190002";23;1;60;26;47;157
"4637";"360810192001";229;6;67;45;29;376
"4638";"360810192002";57;22;56;36;37;208
"4639";"360810194001";29;0;24;28;63;144
"4640";"360810194002";74;16;77;49;36;252
"4641";"360810196001";60;1;44;23;35;163
"4642";"360810196002";73;5;94;38;36;246
"4643";"360810198001";44;14;41;25;31;155
"4644";"360810198002";156;5;37;28;20;246
"4645";"360810198003";20;9;19;31;23;102
"4646";"360810199001";1;3;139;20;24;187
"4647";"360810199002";5;27;168;90;61;351
"4648";"360810202001";64;9;86;71;34;264
"4649";"360810204001";21;6;119;168;53;367
"4650";"360810204002";97;10;77;90;49;323
"4651";"360810205001";61;9;51;54;18;193
"4652";"360810205002";38;3;96;42;13;192
"4653";"360810206001";79;8;162;79;69;397
"4654";"360810208001";23;6;122;22;26;199
"4655";"360810208002";34;47;171;95;90;437
"4656";"360810212001";39;17;60;7;44;167
"4657";"360810212002";104;7;95;13;33;252
"4658";"360810214001";97;11;92;6;33;239
"4659";"360810214002";41;10;83;22;36;192
"4660";"360810214003";59;64;263;134;74;594
"4661";"360810216001";57;13;40;1;12;123
"4662";"360810216002";162;17;75;8;17;279
"4663";"360810216003";56;3;73;32;31;195
"4664";"360810219001";1;1;101;101;20;224
"4665";"360810220011";11;3;77;5;8;104
"4666";"360810220012";71;9;140;8;13;241
"4667";"360810220013";77;14;109;11;5;216
"4668";"360810220014";16;1;2;0;3;22
"4669";"360810220021";14;0;42;6;5;67
"4670";"360810220022";30;3;74;4;15;126
"4671";"360810220023";158;11;111;9;23;312
"4672";"360810220024";78;16;82;3;27;206
"4673";"360810229001";5;3;29;23;5;65
"4674";"360810230001";22;5;70;3;18;118
"4675";"360810230002";21;3;21;4;25;74
"4676";"360810232001";36;6;31;2;3;78
"4677";"360810232002";39;3;136;2;34;214
"4678";"360810232003";62;5;157;18;65;307
"4679";"360810235001";126;19;43;24;33;245
"4680";"360810235002";51;22;31;8;19;131
"4681";"360810235003";37;13;73;4;22;149
"4682";"360810235004";66;43;44;3;36;192
"4683";"360810236001";71;13;52;6;28;170
"4684";"360810236002";46;14;15;0;19;94
"4685";"360810238001";153;5;44;1;31;234
"4686";"360810238002";46;8;22;0;34;110
"4687";"360810238003";179;24;14;3;8;228
"4688";"360810238004";20;2;34;2;8;66
"4689";"360810240001";58;78;35;2;26;199
"4690";"360810240002";151;25;59;6;28;269
"4691";"360810240003";63;30;11;1;10;115
"4692";"360810243001";16;8;82;26;32;164
"4693";"360810243002";8;4;61;38;33;144
"4694";"360810243003";40;11;81;58;31;221
"4695";"360810243004";62;5;124;44;23;258
"4696";"360810245001";0;2;29;1;4;36
"4697";"360810245002";39;1;140;3;19;202
"4698";"360810245003";1;7;40;5;8;61
"4699";"360810245004";113;0;110;3;10;236
"4700";"360810246001";0;4;57;1;16;78
"4701";"360810247001";24;6;110;6;33;179
"4702";"360810249001";54;24;94;6;23;201
"4703";"360810249002";89;13;39;1;14;156
"4704";"360810249003";30;5;101;5;24;165
"4705";"360810251001";38;14;28;1;12;93
"4706";"360810251002";28;2;44;1;12;87
"4707";"360810251003";102;46;171;7;33;359
"4708";"360810251004";51;15;22;2;32;122
"4709";"360810253011";58;91;57;0;25;231
"4710";"360810253012";82;12;38;5;15;152
"4711";"360810253013";57;8;7;2;12;86
"4712";"360810253014";58;39;26;2;16;141
"4713";"360810253021";26;2;1;0;6;35
"4714";"360810253022";78;31;103;6;23;241
"4715";"360810254001";90;6;93;16;49;254
"4716";"360810254002";18;10;50;23;31;132
"4717";"360810254003";146;21;23;7;21;218
"4718";"360810254004";51;6;61;8;14;140
"4719";"360810254005";79;7;174;78;43;381
"4720";"360810254006";87;9;61;22;32;211
"4721";"360810255001";57;11;198;38;60;364
"4722";"360810257001";44;71;358;23;42;538
"4723";"360810258001";43;10;41;26;13;133
"4724";"360810258002";63;4;14;18;20;119
"4725";"360810259001";50;11;170;4;46;281
"4726";"360810259002";101;30;113;1;40;285
"4727";"360810260001";54;10;35;5;23;127
"4728";"360810260002";54;4;50;31;54;193
"4729";"360810261001";15;9;20;4;8;56
"4730";"360810261002";76;2;110;4;40;232
"4731";"360810261003";66;228;28;5;44;371
"4732";"360810261004";110;34;128;8;44;324
"4733";"360810262001";96;13;52;29;56;246
"4734";"360810263001";87;131;140;7;28;393
"4735";"360810263002";90;693;146;1;74;1004
"4736";"360810263003";26;12;112;1;27;178
"4737";"360810264001";31;10;32;28;32;133
"4738";"360810264002";113;3;40;45;34;235
"4739";"360810265001";54;90;245;7;31;427
"4740";"360810265002";44;4;113;4;21;186
"4741";"360810266001";63;28;49;9;17;166
"4742";"360810267001";35;16;87;2;17;157
"4743";"360810267002";49;22;62;3;24;160
"4744";"360810267003";64;21;227;0;64;376
"4745";"360810269011";56;25;8;4;56;149
"4746";"360810269012";62;5;9;1;11;88
"4747";"360810269013";59;1;14;0;5;79
"4748";"360810269014";11;15;47;9;15;97
"4749";"360810269021";82;4;51;0;15;152
"4750";"360810269022";72;13;56;1;28;170
"4751";"360810270001";65;12;67;43;67;254
"4752";"360810271001";132;172;141;2;17;464
"4753";"360810271002";133;3;27;1;15;179
"4754";"360810271003";60;7;103;1;7;178
"4755";"360810271004";45;3;16;3;7;74
"4756";"360810271005";57;8;28;1;14;108
"4757";"360810272001";24;3;55;31;35;148
"4758";"360810272002";16;4;31;21;20;92
"4759";"360810273001";24;16;27;1;4;72
"4760";"360810273002";113;10;4;0;12;139
"4761";"360810273003";113;44;22;3;26;208
"4762";"360810273004";96;12;34;2;23;167
"4763";"360810273005";69;30;122;1;31;253
"4764";"360810274001";53;2;63;25;17;160
"4765";"360810275001";33;6;7;2;1;49
"4766";"360810275002";108;7;104;2;53;274
"4767";"360810275003";190;24;103;11;74;402
"4768";"360810276001";88;21;76;60;8;253
"4769";"360810277001";22;0;1;0;0;23
"4770";"360810277002";75;7;62;6;32;182
"4771";"360810277003";122;3;19;3;16;163
"4772";"360810277004";120;12;14;0;16;162
"4773";"360810277005";245;19;88;3;28;383
"4774";"360810278001";49;4;13;4;21;91
"4775";"360810278002";184;18;4;4;9;219
"4776";"360810279001";33;7;95;4;15;154
"4777";"360810279002";39;6;49;3;14;111
"4778";"360810279003";40;32;12;3;13;100
"4779";"360810279004";6;10;14;1;3;34
"4780";"360810280001";70;6;41;31;56;204
"4781";"360810281001";112;168;74;1;29;384
"4782";"360810281002";109;7;53;5;6;180
"4783";"360810281003";13;31;21;10;11;86
"4784";"360810281004";37;26;26;13;18;120
"4785";"360810282001";79;14;83;21;46;243
"4786";"360810283001";36;20;19;5;11;91
"4787";"360810283002";54;15;3;1;15;88
"4788";"360810283003";9;131;12;7;18;177
"4789";"360810283004";33;42;9;10;22;116
"4790";"360810283005";214;15;13;4;18;264
"4791";"360810284001";35;22;60;24;28;169
"4792";"360810284002";50;10;38;20;23;141
"4793";"360810285001";19;17;16;1;5;58
"4794";"360810285002";23;11;33;1;5;73
"4795";"360810285003";60;12;42;6;16;136
"4796";"360810285004";72;54;22;10;21;179
"4797";"360810287001";60;21;27;0;12;120
"4798";"360810287002";12;23;14;2;10;61
"4799";"360810287003";118;120;70;4;46;358
"4800";"360810287004";132;13;5;1;5;156
"4801";"360810288001";44;4;20;22;12;102
"4802";"360810288002";31;14;40;39;19;143
"4803";"360810288003";40;4;23;19;9;95
"4804";"360810288004";25;6;47;29;17;124
"4805";"360810289001";43;4;34;2;18;101
"4806";"360810289002";14;6;85;6;11;122
"4807";"360810289003";50;41;83;3;50;227
"4808";"360810291001";26;5;58;7;18;114
"4809";"360810291002";55;6;67;2;15;145
"4810";"360810291003";85;34;31;1;21;172
"4811";"360810291004";20;28;109;3;21;181
"4812";"360810293001";31;9;170;20;34;264
"4813";"360810294001";42;6;30;18;9;105
"4814";"360810294002";30;9;77;25;40;181
"4815";"360810294003";33;5;55;17;14;124
"4816";"360810294004";19;1;23;14;19;76
"4817";"360810294005";46;13;37;48;56;200
"4818";"360810294006";11;6;53;25;14;109
"4819";"360810295001";22;4;153;25;8;212
"4820";"360810295002";38;9;237;102;25;411
"4821";"360810297001";25;53;334;51;36;499
"4822";"360810297002";43;13;240;72;81;449
"4823";"360810299001";0;1;9;5;4;19
"4824";"360810306001";31;2;85;44;18;180
"4825";"360810306002";39;6;63;34;17;159
"4826";"360810306003";106;12;60;29;24;231
"4827";"360810306004";11;27;87;24;17;166
"4828";"360810309021";16;7;57;13;45;138
"4829";"360810309022";54;5;199;16;22;296
"4830";"360810309023";29;2;107;5;24;167
"4831";"360810309024";33;5;96;6;14;154
"4832";"360810309025";44;6;252;8;18;328
"4833";"360810309031";73;25;167;5;56;326
"4834";"360810309032";42;4;241;17;68;372
"4835";"360810309033";67;10;125;2;49;253
"4836";"360810309041";59;8;159;14;63;303
"4837";"360810309042";30;8;169;7;115;329
"4838";"360810317001";35;14;193;18;34;294
"4839";"360810317002";20;2;71;8;13;114
"4840";"360810317003";57;5;134;24;18;238
"4841";"360810317004";38;5;93;31;37;204
"4842";"360810320001";46;6;37;29;43;161
"4843";"360810320002";3;4;87;32;25;151
"4844";"360810320003";61;4;66;56;35;222
"4845";"360810320004";41;1;14;12;23;91
"4846";"360810327001";58;5;171;10;30;274
"4847";"360810327002";133;77;72;1;27;310
"4848";"360810328001";78;11;34;34;33;190
"4849";"360810328002";48;3;40;34;25;150
"4850";"360810329001";42;1;65;17;30;155
"4851";"360810329002";32;6;80;17;27;162
"4852";"360810329003";34;17;85;23;42;201
"4853";"360810330001";46;13;66;57;62;244
"4854";"360810330002";8;1;14;20;19;62
"4855";"360810330003";29;8;39;50;25;151
"4856";"360810330004";18;3;46;10;11;88
"4857";"360810330005";25;3;30;14;22;94
"4858";"360810331001";1;4;9;1;3;18
"4859";"360810334011";46;5;59;25;24;159
"4860";"360810334012";56;15;91;78;27;267
"4861";"360810334021";9;2;7;0;0;18
"4862";"360810334022";1;1;4;0;1;7
"4863";"360810334023";16;21;5;0;0;42
"4864";"360810334024";16;4;7;0;5;32
"4865";"360810334025";11;8;7;5;2;33
"4866";"360810334026";12;11;96;26;25;170
"4867";"360810337001";73;9;112;8;38;240
"4868";"360810337002";31;87;174;2;97;391
"4869";"360810339001";41;15;47;17;22;142
"4870";"360810339002";44;2;1;0;4;51
"4871";"360810339003";24;87;68;4;34;217
"4872";"360810347001";98;4;89;23;42;256
"4873";"360810347002";84;14;195;21;43;357
"4874";"360810351001";66;7;56;13;19;161
"4875";"360810351002";56;8;65;2;8;139
"4876";"360810351003";49;26;57;5;30;167
"4877";"360810352001";28;18;52;18;23;139
"4878";"360810352002";20;13;35;48;36;152
"4879";"360810353001";36;28;76;17;22;179
"4880";"360810353002";102;8;136;9;22;277
"4881";"360810357001";68;12;339;10;43;472
"4882";"360810357002";73;14;160;19;35;301
"4883";"360810357003";97;7;206;17;26;353
"4884";"360810358001";30;13;17;9;22;91
"4885";"360810358002";49;3;81;34;24;191
"4886";"360810358003";41;1;32;39;22;135
"4887";"360810358004";8;0;11;16;7;42
"4888";"360810361001";180;24;75;7;40;326
"4889";"360810361002";49;9;63;12;32;165
"4890";"360810363001";49;11;113;6;42;221
"4891";"360810363002";31;5;109;3;24;172
"4892";"360810365001";48;11;134;14;33;240
"4893";"360810365002";87;15;180;20;35;337
"4894";"360810366001";70;4;94;54;23;245
"4895";"360810366002";19;131;64;35;35;284
"4896";"360810367001";11;3;31;6;13;64
"4897";"360810367002";91;18;151;39;47;346
"4898";"360810368001";55;21;23;4;24;127
"4899";"360810368002";32;4;57;18;29;140
"4900";"360810371001";34;5;164;22;21;246
"4901";"360810373001";44;2;185;23;32;286
"4902";"360810373002";403;222;249;29;23;926
"4903";"360810375001";224;20;186;2;30;462
"4904";"360810375002";116;56;95;7;35;309
"4905";"360810376001";46;11;27;10;24;118
"4906";"360810376002";45;12;26;22;13;118
"4907";"360810376003";12;3;22;12;8;57
"4908";"360810376004";22;5;24;26;17;94
"4909";"360810376005";23;6;38;22;14;103
"4910";"360810377001";115;11;290;7;30;453
"4911";"360810377002";65;5;91;3;42;206
"4912";"360810379001";108;12;364;18;36;538
"4913";"360810379002";98;32;197;5;20;352
"4914";"360810379003";62;15;111;5;33;226
"4915";"360810381001";112;12;219;5;33;381
"4916";"360810381002";265;13;217;13;33;541
"4917";"360810381003";73;20;186;12;37;328
"4918";"360810383011";6;68;40;41;11;166
"4919";"360810383021";82;354;149;48;58;691
"4920";"360810384001";32;11;36;10;19;108
"4921";"360810384002";27;3;49;31;23;133
"4922";"360810394001";31;11;44;19;34;139
"4923";"360810394002";36;5;17;15;27;100
"4924";"360810394003";21;4;25;20;13;83
"4925";"360810398001";19;16;29;16;37;117
"4926";"360810398002";8;1;8;5;8;30
"4927";"360810399001";23;1;98;17;30;169
"4928";"360810399002";40;4;65;4;20;133
"4929";"360810399003";35;5;96;9;13;158
"4930";"360810400001";12;2;54;21;18;107
"4931";"360810400002";27;3;12;8;6;56
"4932";"360810401001";170;12;170;9;37;398
"4933";"360810401002";81;48;112;8;33;282
"4934";"360810401003";47;16;102;7;20;192
"4935";"360810402001";22;21;22;11;13;89
"4936";"360810402002";15;2;12;27;10;66
"4937";"360810403001";120;23;395;11;57;606
"4938";"360810403002";33;17;64;2;17;133
"4939";"360810403003";24;1;69;2;22;118
"4940";"360810404001";32;9;16;9;8;74
"4941";"360810404002";41;8;17;30;17;113
"4942";"360810404003";38;11;11;15;22;97
"4943";"360810404004";79;6;17;16;9;127
"4944";"360810405001";23;53;86;5;18;185
"4945";"360810405002";21;53;54;13;28;169
"4946";"360810407001";43;13;88;6;27;177
"4947";"360810407002";34;6;32;8;33;113
"4948";"360810407003";46;1;91;2;15;155
"4949";"360810407004";28;9;93;2;8;140
"4950";"360810407005";19;122;27;7;4;179
"4951";"360810409001";108;11;103;2;17;241
"4952";"360810409002";45;2;58;8;6;119
"4953";"360810409003";27;7;104;10;13;161
"4954";"360810409004";25;11;58;4;18;116
"4955";"360810411001";64;21;155;15;31;286
"4956";"360810411002";89;10;162;22;14;297
"4957";"360810413001";108;14;165;18;46;351
"4958";"360810413002";74;11;186;7;23;301
"4959";"360810414001";139;3;99;75;74;390
"4960";"360810414002";102;15;7;2;15;141
"4961";"360810414003";59;2;39;21;23;144
"4962";"360810415001";98;21;141;33;45;338
"4963";"360810415002";87;12;122;13;12;246
"4964";"360810424001";23;8;44;17;21;113
"4965";"360810424002";8;4;6;7;4;29
"4966";"360810424003";21;8;4;6;6;45
"4967";"360810426001";27;9;5;9;5;55
"4968";"360810427001";68;4;166;24;33;295
"4969";"360810427002";168;18;302;18;25;531
"4970";"360810432001";34;13;30;33;22;132
"4971";"360810434001";52;11;40;28;21;152
"4972";"360810437011";73;24;129;38;45;309
"4973";"360810437012";27;7;51;10;4;99
"4974";"360810437021";188;21;32;3;19;263
"4975";"360810437022";172;11;254;6;17;460
"4976";"360810437023";126;0;203;18;30;377
"4977";"360810439001";73;11;150;14;45;293
"4978";"360810439002";140;66;289;28;42;565
"4979";"360810440001";50;6;107;81;53;297
"4980";"360810440002";75;4;39;46;25;189
"4981";"360810440003";53;3;79;30;36;201
"4982";"360810443011";46;7;220;7;20;300
"4983";"360810443012";34;17;135;11;37;234
"4984";"360810443021";56;10;180;19;28;293
"4985";"360810443022";70;2;136;25;17;250
"4986";"360810443023";125;56;207;8;31;427
"4987";"360810444001";56;40;78;2;36;212
"4988";"360810444002";37;178;137;21;82;455
"4989";"360810444003";62;12;141;27;70;312
"4990";"360810446011";35;19;27;1;33;115
"4991";"360810446012";52;32;12;4;50;150
"4992";"360810446021";36;24;46;5;45;156
"4993";"360810446022";79;11;10;2;28;130
"4994";"360810448001";48;20;74;2;70;214
"4995";"360810448002";6;2;46;7;18;79
"4996";"360810450001";11;8;68;10;58;155
"4997";"360810450002";11;72;22;9;29;143
"4998";"360810452001";43;22;24;1;19;109
"4999";"360810454001";32;14;102;1;32;181
"5000";"360810454002";69;7;104;5;53;238
"5001";"360810455001";23;4;6;1;14;48
"5002";"360810455002";17;8;5;0;2;32
"5003";"360810455003";37;2;8;1;11;59
"5004";"360810455004";44;0;5;0;11;60
"5005";"360810455005";26;0;2;0;2;30
"5006";"360810455006";0;2;13;0;1;16
"5007";"360810456001";25;2;41;9;19;96
"5008";"360810457001";98;1;151;8;11;269
"5009";"360810457002";49;2;135;7;13;206
"5010";"360810458001";47;93;123;8;45;316
"5011";"360810459001";46;7;73;7;33;166
"5012";"360810459002";43;4;103;1;30;181
"5013";"360810460001";59;10;34;2;51;156
"5014";"360810460002";31;17;18;1;44;111
"5015";"360810460003";62;21;30;3;21;137
"5016";"360810461001";55;16;216;2;43;332
"5017";"360810462001";43;12;62;2;35;154
"5018";"360810462002";79;86;135;13;46;359
"5019";"360810462003";165;64;134;6;46;415
"5020";"360810463001";111;6;116;0;12;245
"5021";"360810463002";103;35;181;7;28;354
"5022";"360810464001";21;6;45;7;8;87
"5023";"360810465001";77;24;74;11;22;208
"5024";"360810465002";67;3;68;3;19;160
"5025";"360810466001";62;28;61;1;18;170
"5026";"360810466002";14;14;17;1;4;50
"5027";"360810467001";50;0;43;1;11;105
"5028";"360810467002";135;7;200;2;28;372
"5029";"360810467003";62;4;84;1;13;164
"5030";"360810467004";123;8;27;4;15;177
"5031";"360810468001";113;3;76;4;38;234
"5032";"360810468002";96;34;223;26;63;442
"5033";"360810469001";103;16;74;7;30;230
"5034";"360810469002";67;4;38;1;5;115
"5035";"360810469003";16;3;25;4;25;73
"5036";"360810469004";44;4;20;7;12;87
"5037";"360810469005";95;4;15;0;11;125
"5038";"360810470001";55;12;52;4;25;148
"5039";"360810470002";216;164;86;27;75;568
"5040";"360810471001";156;17;42;0;59;274
"5041";"360810471002";47;15;95;4;24;185
"5042";"360810472001";49;1;34;3;14;101
"5043";"360810472002";19;4;29;24;18;94
"5044";"360810472003";83;6;12;0;4;105
"5045";"360810473001";35;1;109;10;12;167
"5046";"360810473002";34;14;55;2;48;153
"5047";"360810473003";2;0;21;1;3;27
"5048";"360810475001";41;8;156;6;25;236
"5049";"360810475002";117;12;215;10;60;414
"5050";"360810476001";7;3;9;9;11;39
"5051";"360810476002";15;3;5;14;7;44
"5052";"360810478001";50;4;33;19;19;125
"5053";"360810478002";38;6;38;18;28;128
"5054";"360810478003";90;10;100;19;50;269
"5055";"360810479001";169;26;125;17;57;394
"5056";"360810479002";25;17;68;12;101;223
"5057";"360810479003";36;2;53;16;22;129
"5058";"360810480001";83;13;98;18;39;251
"5059";"360810480002";59;23;60;20;14;176
"5060";"360810481001";30;3;75;0;12;120
"5061";"360810481002";23;2;55;2;6;88
"5062";"360810481003";90;3;35;1;12;141
"5063";"360810481004";20;37;13;2;11;83
"5064";"360810482001";74;6;49;29;44;202
"5065";"360810483001";52;5;126;0;27;210
"5066";"360810483002";93;7;168;12;27;307
"5067";"360810484001";70;6;65;30;57;228
"5068";"360810484002";93;14;69;28;41;245
"5069";"360810484003";36;1;69;28;35;169
"5070";"360810484004";52;13;54;13;18;150
"5071";"360810485001";7;17;48;6;9;87
"5072";"360810485002";23;3;44;29;39;138
"5073";"360810485003";54;11;155;7;33;260
"5074";"360810489001";22;16;156;61;78;333
"5075";"360810489002";18;3;59;16;31;127
"5076";"360810492001";188;12;63;44;16;323
"5077";"360810492002";23;2;19;5;21;70
"5078";"360810492003";111;1;50;22;29;213
"5079";"360810493011";33;3;209;49;63;357
"5080";"360810493012";25;4;95;30;29;183
"5081";"360810493021";37;45;81;28;43;234
"5082";"360810493022";22;25;179;52;29;307
"5083";"360810495001";20;1;142;20;26;209
"5084";"360810496001";51;11;44;9;42;157
"5085";"360810496002";84;30;45;27;63;249
"5086";"360810496003";7;7;39;21;31;105
"5087";"360810497001";40;1;88;29;22;180
"5088";"360810497002";12;3;97;27;21;160
"5089";"360810499001";6;3;77;18;30;134
"5090";"360810499002";40;12;129;27;28;236
"5091";"360810499003";46;11;265;38;135;495
"5092";"360810500001";46;250;52;21;27;396
"5093";"360810500002";253;24;57;15;27;376
"5094";"360810502011";50;7;44;75;19;195
"5095";"360810502021";72;7;12;16;31;138
"5096";"360810504001";50;4;36;31;35;156
"5097";"360810504002";29;7;14;8;12;70
"5098";"360810505001";61;0;214;26;18;319
"5099";"360810506001";18;4;13;16;18;69
"5100";"360810506002";47;25;9;16;23;120
"5101";"360810507001";23;2;144;85;45;299
"5102";"360810507002";27;11;84;22;25;169
"5103";"360810508001";54;15;19;35;17;140
"5104";"360810508002";15;28;21;25;7;96
"5105";"360810510001";16;2;20;22;22;82
"5106";"360810510002";19;3;13;12;15;62
"5107";"360810511001";9;20;144;32;36;241
"5108";"360810511002";18;13;52;19;39;141
"5109";"360810512001";8;1;25;22;11;67
"5110";"360810512002";19;4;15;16;12;66
"5111";"360810512003";23;3;57;15;11;109
"5112";"360810513001";47;5;209;28;37;326
"5113";"360810513002";5;3;119;24;16;167
"5114";"360810515001";40;27;129;15;51;262
"5115";"360810515002";37;2;102;14;16;171
"5116";"360810515003";85;4;120;22;21;252
"5117";"360810516001";98;10;22;20;24;174
"5118";"360810516002";89;3;26;25;23;166
"5119";"360810517001";15;5;79;31;34;164
"5120";"360810517002";24;5;145;26;17;217
"5121";"360810518001";43;8;12;9;6;78
"5122";"360810518002";34;9;22;15;21;101
"5123";"360810520001";22;9;32;18;22;103
"5124";"360810521001";7;1;45;20;15;88
"5125";"360810521002";10;7;127;13;66;223
"5126";"360810522001";58;10;28;24;25;145
"5127";"360810524001";23;3;26;9;21;82
"5128";"360810524002";42;4;17;20;14;97
"5129";"360810525001";27;3;61;44;45;180
"5130";"360810525002";26;2;84;68;15;195
"5131";"360810526001";34;1;46;14;53;148
"5132";"360810526002";5;11;13;13;23;65
"5133";"360810528001";69;16;54;10;33;182
"5134";"360810530001";26;2;17;9;12;66
"5135";"360810530002";55;8;60;21;54;198
"5136";"360810531001";13;9;201;110;34;367
"5137";"360810531002";12;4;130;9;13;168
"5138";"360810531003";11;26;89;39;28;193
"5139";"360810532001";36;4;54;17;12;123
"5140";"360810532002";14;15;11;5;6;51
"5141";"360810534011";59;13;44;18;14;148
"5142";"360810534012";12;3;23;6;23;67
"5143";"360810535001";26;13;110;34;48;231
"5144";"360810536011";17;2;12;25;18;74
"5145";"360810536012";5;3;33;9;6;56
"5146";"360810538001";69;1;9;10;16;105
"5147";"360810538002";7;5;15;9;6;42
"5148";"360810539001";55;30;106;24;39;254
"5149";"360810539002";60;21;59;7;19;166
"5150";"360810539003";120;50;62;4;23;259
"5151";"360810540001";131;5;61;56;50;303
"5152";"360810540002";32;5;77;158;28;300
"5153";"360810540003";47;6;53;29;17;152
"5154";"360810542001";28;9;55;43;37;172
"5155";"360810542002";135;8;100;43;102;388
"5156";"360810542003";104;14;83;25;65;291
"5157";"360810542004";43;3;36;17;33;132
"5158";"360810545001";53;18;64;2;22;159
"5159";"360810545002";76;9;62;8;25;180
"5160";"360810545003";101;10;45;2;32;190
"5161";"360810547001";59;42;38;3;16;158
"5162";"360810547002";71;164;51;4;10;300
"5163";"360810547003";85;5;33;2;16;141
"5164";"360810548001";41;8;29;13;44;135
"5165";"360810548002";27;1;56;7;22;113
"5166";"360810549001";72;36;43;2;24;177
"5167";"360810549002";87;26;41;3;27;184
"5168";"360810549003";62;40;39;6;13;160
"5169";"360810549004";57;28;14;2;15;116
"5170";"360810551001";8;15;43;2;26;94
"5171";"360810551002";47;17;20;0;23;107
"5172";"360810551003";25;32;20;1;22;100
"5173";"360810551004";74;21;50;3;17;165
"5174";"360810552001";31;5;25;16;13;90
"5175";"360810552002";37;5;94;26;87;249
"5176";"360810553001";31;56;115;9;19;230
"5177";"360810553002";75;83;14;4;23;199
"5178";"360810554001";16;0;45;14;95;170
"5179";"360810554002";64;2;55;9;28;158
"5180";"360810555001";53;21;18;4;19;115
"5181";"360810555002";61;48;69;10;29;217
"5182";"360810556001";42;13;185;25;84;349
"5183";"360810556002";22;2;11;13;20;68
"5184";"360810557001";57;10;76;5;35;183
"5185";"360810557002";39;36;90;14;27;206
"5186";"360810557003";20;10;6;0;11;47
"5187";"360810558001";12;2;7;11;9;41
"5188";"360810558002";52;4;29;27;28;140
"5189";"360810559001";112;33;76;22;40;283
"5190";"360810560001";24;1;27;11;11;74
"5191";"360810560002";65;1;7;8;28;109
"5192";"360810561001";2;82;19;9;10;122
"5193";"360810562001";80;13;62;15;33;203
"5194";"360810564001";65;4;38;11;26;144
"5195";"360810565001";136;41;236;65;42;520
"5196";"360810566001";29;4;14;16;10;73
"5197";"360810566002";29;4;28;13;29;103
"5198";"360810567001";7;1;353;51;11;423
"5199";"360810567002";58;8;357;83;52;558
"5200";"360810567003";60;28;156;215;34;493
"5201";"360810567004";54;12;119;34;21;240
"5202";"360810568001";53;6;30;14;32;135
"5203";"360810568002";31;3;13;24;21;92
"5204";"360810568003";14;4;24;13;19;74
"5205";"360810568004";40;35;59;65;28;227
"5206";"360810577001";25;9;72;2;16;124
"5207";"360810577002";41;22;143;17;31;254
"5208";"360810577003";37;6;161;16;15;235
"5209";"360810579001";47;32;46;2;11;138
"5210";"360810579002";10;1;96;5;12;124
"5211";"360810580001";27;2;8;12;5;54
"5212";"360810580002";33;4;29;18;16;100
"5213";"360810580003";33;6;31;23;31;124
"5214";"360810580004";25;7;5;4;9;50
"5215";"360810581001";29;2;117;10;6;164
"5216";"360810581002";25;69;274;6;8;382
"5217";"360810582001";41;6;156;23;21;247
"5218";"360810582002";52;10;70;56;36;224
"5219";"360810582003";11;2;19;15;15;62
"5220";"360810583001";48;16;47;0;15;126
"5221";"360810583002";13;9;39;5;33;99
"5222";"360810583003";30;18;6;2;15;71
"5223";"360810585001";19;17;42;4;27;109
"5224";"360810585002";16;23;145;11;21;216
"5225";"360810585003";74;53;68;8;38;241
"5226";"360810587001";40;22;211;3;20;296
"5227";"360810587002";23;2;20;0;8;53
"5228";"360810587003";69;4;75;1;14;163
"5229";"360810589001";96;16;153;3;26;294
"5230";"360810589002";30;23;25;0;17;95
"5231";"360810589003";35;98;19;5;15;172
"5232";"360810590001";20;4;6;9;16;55
"5233";"360810591001";61;2;121;4;19;207
"5234";"360810591002";37;29;135;0;8;209
"5235";"360810591003";80;10;113;3;18;224
"5236";"360810591004";34;9;69;0;7;119
"5237";"360810592001";25;7;20;71;14;137
"5238";"360810593001";73;13;106;63;13;268
"5239";"360810593002";35;30;140;19;40;264
"5240";"360810594001";10;2;27;32;3;74
"5241";"360810594002";21;2;12;9;9;53
"5242";"360810595001";77;9;124;44;21;275
"5243";"360810595002";20;1;123;7;18;169
"5244";"360810595003";17;12;78;4;25;136
"5245";"360810595004";45;15;102;9;41;212
"5246";"360810596001";6;0;9;23;6;44
"5247";"360810596002";8;1;9;28;9;55
"5248";"360810598001";13;3;25;6;14;61
"5249";"360810598002";12;10;30;25;13;90
"5250";"360810599001";14;3;133;30;13;193
"5251";"360810599002";37;80;75;35;14;241
"5252";"360810600001";9;3;21;20;22;75
"5253";"360810601001";17;4;154;40;34;249
"5254";"360810601002";75;73;90;38;14;290
"5255";"360810603001";59;10;326;68;34;497
"5256";"360810606001";44;7;24;23;21;119
"5257";"360810606002";21;3;5;6;5;40
"5258";"360810607011";2;0;94;19;17;132
"5259";"360810608001";32;232;36;31;25;356
"5260";"360810610001";22;5;41;10;10;88
"5261";"360810612001";8;0;2;8;7;25
"5262";"360810612002";9;1;29;10;10;59
"5263";"360810613011";62;14;113;18;26;233
"5264";"360810613012";50;69;242;39;63;463
"5265";"360810613013";15;8;61;2;29;115
"5266";"360810613014";124;46;27;1;11;209
"5267";"360810613021";0;0;8;1;3;12
"5268";"360810614001";11;16;31;18;20;96
"5269";"360810616011";6;2;6;20;15;49
"5270";"360810616012";8;1;13;5;6;33
"5271";"360810616013";14;3;26;7;3;53
"5272";"360810616021";10;0;18;21;11;60
"5273";"360810616022";4;2;26;36;8;76
"5274";"360810618001";11;0;5;11;7;34
"5275";"360810618002";21;13;36;11;20;101
"5276";"360810619001";69;18;210;44;44;385
"5277";"360810619002";6;18;78;10;22;134
"5278";"360810620001";32;5;35;23;37;132
"5279";"360810621001";80;37;81;24;23;245
"5280";"360810621002";19;3;63;16;5;106
"5281";"360810621003";23;3;58;11;25;120
"5282";"360810622001";5;0;37;17;8;67
"5283";"360810622002";17;10;21;19;17;84
"5284";"360810623001";16;6;48;17;9;96
"5285";"360810623002";22;2;154;38;15;231
"5286";"360810624001";0;1;1;0;0;2
"5287";"360810625001";25;6;83;7;13;134
"5288";"360810625002";71;25;123;20;41;280
"5289";"360810626001";4;2;22;37;15;80
"5290";"360810626002";37;48;18;9;17;129
"5291";"360810626003";8;1;15;10;17;51
"5292";"360810627001";25;8;160;6;22;221
"5293";"360810627002";34;5;54;3;29;125
"5294";"360810629001";23;14;101;19;26;183
"5295";"360810629002";33;4;28;5;12;82
"5296";"360810629003";28;15;148;7;7;205
"5297";"360810630001";22;13;35;14;10;94
"5298";"360810630002";19;2;15;11;6;53
"5299";"360810632001";6;11;16;10;7;50
"5300";"360810632002";36;9;63;20;20;148
"5301";"360810633011";28;13;101;40;24;206
"5302";"360810633021";9;4;61;9;20;103
"5303";"360810633022";34;9;119;16;12;190
"5304";"360810635001";6;3;36;15;11;71
"5305";"360810635002";28;17;110;25;27;207
"5306";"360810637001";2;13;67;21;18;121
"5307";"360810637002";12;11;97;48;32;200
"5308";"360810637003";32;8;56;30;23;149
"5309";"360810638001";23;14;96;29;16;178
"5310";"360810638002";19;67;97;8;14;205
"5311";"360810638003";16;3;21;12;12;64
"5312";"360810638004";16;2;20;67;11;116
"5313";"360810638005";22;13;36;39;13;123
"5314";"360810639001";23;4;106;33;13;179
"5315";"360810639002";86;9;221;27;23;366
"5316";"360810641011";20;3;51;3;7;84
"5317";"360810641021";16;21;145;31;16;229
"5318";"360810645001";4;3;54;8;8;77
"5319";"360810645002";9;6;130;34;15;194
"5320";"360810646001";17;3;27;28;11;86
"5321";"360810646002";34;0;22;26;15;97
"5322";"360810650001";18;2;16;26;13;75
"5323";"360810650002";17;2;18;28;22;87
"5324";"360810654001";12;19;70;11;28;140
"5325";"360810654002";19;14;25;18;18;94
"5326";"360810654003";19;3;25;14;18;79
"5327";"360810655011";0;17;35;6;8;66
"5328";"360810656001";55;9;61;27;97;249
"5329";"360810656002";15;4;11;20;21;71
"5330";"360810656003";70;4;110;41;27;252
"5331";"360810657021";32;14;167;31;30;274
"5332";"360810657031";11;10;135;14;50;220
"5333";"360810657032";14;1;61;23;19;118
"5334";"360810657033";11;1;63;15;9;99
"5335";"360810659001";14;6;52;17;12;101
"5336";"360810659002";16;3;116;18;44;197
"5337";"360810660001";42;2;27;28;26;125
"5338";"360810660002";38;7;37;24;25;131
"5339";"360810661001";17;2;50;33;23;125
"5340";"360810663001";3;0;71;15;14;103
"5341";"360810663002";5;1;43;30;41;120
"5342";"360810663003";12;15;50;29;10;116
"5343";"360810664001";23;7;20;14;7;71
"5344";"360810664002";73;1;26;16;16;132
"5345";"360810664003";34;2;27;16;11;90
"5346";"360810664004";37;7;19;7;6;76
"5347";"360810664005";20;3;20;16;9;68
"5348";"360810664006";39;7;30;19;14;109
"5349";"360810664007";38;4;32;26;20;120
"5350";"360810664008";30;2;51;39;17;139
"5351";"360810665011";7;0;43;20;12;82
"5352";"360810665012";8;4;43;17;7;79
"5353";"360810665013";5;1;64;15;10;95
"5354";"360810665014";4;3;12;3;4;26
"5355";"360810667011";33;4;107;44;26;214
"5356";"360810667012";5;3;120;27;14;169
"5357";"360810669001";5;0;93;17;19;134
"5358";"360810669002";18;4;174;18;22;236
"5359";"360810671001";4;9;39;43;47;142
"5360";"360810671002";4;0;137;49;14;204
"5361";"360810677001";7;0;20;10;12;49
"5362";"360810677002";5;1;52;9;16;83
"5363";"360810679001";2;3;93;13;7;118
"5364";"360810679002";93;2;32;6;16;149
"5365";"360810679003";26;15;230;48;16;335
"5366";"360810680001";28;5;23;30;23;109
"5367";"360810680002";46;4;56;36;15;157
"5368";"360810680003";35;4;31;34;16;120
"5369";"360810680004";34;5;31;14;17;101
"5370";"360810682001";5;3;22;18;12;60
"5371";"360810682002";7;1;23;11;8;50
"5372";"360810683001";76;5;29;1;13;124
"5373";"360810683002";39;3;34;1;22;99
"5374";"360810683003";9;4;30;1;10;54
"5375";"360810687001";16;0;21;2;1;40
"5376";"360810687002";66;4;117;0;10;197
"5377";"360810687003";74;5;225;16;18;338
"5378";"360810690001";19;4;44;18;33;118
"5379";"360810690002";74;8;52;47;51;232
"5380";"360810693001";134;8;104;2;31;279
"5381";"360810693002";48;2;132;2;15;199
"5382";"360810694001";17;11;42;27;31;128
"5383";"360810694002";70;16;72;32;36;226
"5384";"360810695001";15;3;94;3;20;135
"5385";"360810695002";17;11;68;9;7;112
"5386";"360810697011";32;7;38;0;15;92
"5387";"360810697012";42;3;112;1;5;163
"5388";"360810697013";40;5;52;0;3;100
"5389";"360810697021";5;3;18;15;10;51
"5390";"360810697022";3;3;31;24;14;75
"5391";"360810697023";10;5;57;14;8;94
"5392";"360810697024";26;5;42;10;9;92
"5393";"360810703001";5;3;79;26;14;127
"5394";"360810703002";15;64;334;38;24;475
"5395";"360810707001";11;2;23;1;16;53
"5396";"360810707002";18;0;28;2;13;61
"5397";"360810707003";4;4;34;1;9;52
"5398";"360810709001";7;3;88;3;17;118
"5399";"360810709002";23;8;29;5;11;76
"5400";"360810711001";41;17;55;2;9;124
"5401";"360810711002";124;49;106;1;27;307
"5402";"360810711003";20;6;31;2;13;72
"5403";"360810711004";12;25;46;1;38;122
"5404";"360810713031";71;7;48;0;9;135
"5405";"360810713032";94;36;24;0;33;187
"5406";"360810713033";67;5;17;0;10;99
"5407";"360810713041";46;23;30;2;4;105
"5408";"360810713042";6;4;37;0;3;50
"5409";"360810713043";3;1;0;0;0;4
"5410";"360810713044";69;6;41;1;6;123
"5411";"360810713051";32;5;13;1;4;55
"5412";"360810713052";12;5;22;0;7;46
"5413";"360810713053";79;20;79;1;12;191
"5414";"360810713061";118;7;47;0;9;181
"5415";"360810713062";57;11;77;3;11;159
"5416";"360810713063";18;6;38;4;22;88
"5417";"360810713064";35;14;53;2;30;134
"5418";"360810716001";0;3;16;3;11;33
"5419";"360810717011";72;7;9;0;11;99
"5420";"360810717012";17;20;67;0;18;122
"5421";"360810717013";3;5;11;1;1;21
"5422";"360810717014";6;19;17;0;4;46
"5423";"360810717021";36;27;47;3;12;125
"5424";"360810717022";12;0;49;0;5;66
"5425";"360810719001";154;8;124;2;13;301
"5426";"360810719002";44;9;264;5;40;362
"5427";"360810721001";11;2;16;0;9;38
"5428";"360810721002";13;5;6;0;4;28
"5429";"360810721003";61;3;40;0;10;114
"5430";"360810721004";6;5;28;1;4;44
"5431";"360810721005";38;14;155;2;3;212
"5432";"360810723001";2;17;5;0;2;26
"5433";"360810723002";2;0;13;5;4;24
"5434";"360810723003";7;2;35;2;11;57
"5435";"360810729001";6;1;30;5;9;51
"5436";"360810729002";10;4;144;3;9;170
"5437";"360810731001";8;12;23;8;15;66
"5438";"360810731002";16;93;25;7;16;157
"5439";"360810737001";17;99;37;0;39;192
"5440";"360810737002";4;10;14;2;21;51
"5441";"360810739001";23;2;22;3;3;53
"5442";"360810739002";23;3;26;0;1;53
"5443";"360810739003";24;5;28;4;7;68
"5444";"360810739004";9;2;19;0;5;35
"5445";"360810739005";9;3;9;1;8;30
"5446";"360810741001";1;2;18;0;1;22
"5447";"360810741002";30;16;39;4;2;91
"5448";"360810741003";1;1;13;0;0;15
"5449";"360810741004";6;3;12;1;1;23
"5450";"360810743001";3;1;29;4;21;58
"5451";"360810743002";44;1;70;0;22;137
"5452";"360810743003";53;7;23;1;11;95
"5453";"360810743004";7;4;8;1;5;25
"5454";"360810745001";43;10;50;6;6;115
"5455";"360810745002";56;15;33;4;3;111
"5456";"360810747001";25;16;135;18;36;230
"5457";"360810747002";18;4;34;6;11;73
"5458";"360810749001";1;2;7;1;18;29
"5459";"360810749002";3;1;4;3;4;15
"5460";"360810757011";49;9;77;0;16;151
"5461";"360810757012";7;5;33;3;18;66
"5462";"360810757013";6;7;38;0;10;61
"5463";"360810757021";35;2;49;7;2;95
"5464";"360810757022";11;5;133;7;15;171
"5465";"360810757023";71;4;31;0;2;108
"5466";"360810769011";25;8;31;2;15;81
"5467";"360810769012";104;21;26;2;33;186
"5468";"360810769021";38;26;103;4;44;215
"5469";"360810773001";24;7;63;4;12;110
"5470";"360810773002";111;3;34;0;20;168
"5471";"360810775001";88;10;69;3;19;189
"5472";"360810775002";9;5;48;1;8;71
"5473";"360810775003";3;259;77;2;18;359
"5474";"360810779021";4;2;15;0;10;31
"5475";"360810779022";3;2;41;13;11;70
"5476";"360810779023";6;2;17;16;10;51
"5477";"360810779024";8;5;8;3;5;29
"5478";"360810779025";9;0;20;2;7;38
"5479";"360810779031";15;2;3;0;3;23
"5480";"360810779032";21;4;1;0;6;32
"5481";"360810779033";34;3;5;1;12;55
"5482";"360810779041";13;4;13;9;9;48
"5483";"360810779042";38;4;102;2;14;160
"5484";"360810779043";42;9;56;7;14;128
"5485";"360810779044";7;4;23;5;8;47
"5486";"360810779051";15;41;17;20;9;102
"5487";"360810779052";10;0;8;4;1;23
"5488";"360810779061";50;17;51;0;13;131
"5489";"360810779062";37;9;90;18;40;194
"5490";"360810779071";12;7;79;33;13;144
"5491";"360810779072";23;2;64;4;15;108
"5492";"360810779081";24;5;16;2;8;55
"5493";"360810779082";87;21;16;3;12;139
"5494";"360810788001";131;29;41;31;48;280
"5495";"360810788002";25;4;18;23;13;83
"5496";"360810790001";40;6;19;35;56;156
"5497";"360810790002";69;9;46;37;44;205
"5498";"360810792001";95;1;35;23;24;178
"5499";"360810792002";71;3;44;29;36;183
"5500";"360810793001";2;4;6;0;12;24
"5501";"360810797011";18;5;6;0;3;32
"5502";"360810797012";18;0;0;0;10;28
"5503";"360810797013";7;0;5;1;7;20
"5504";"360810797014";3;9;10;3;12;37
"5505";"360810797021";15;16;203;4;22;260
"5506";"360810797022";24;11;110;0;24;169
"5507";"360810797023";20;1;14;0;2;37
"5508";"360810799001";46;4;145;9;41;245
"5509";"360810799002";41;6;295;7;30;379
"5510";"360810803011";17;8;68;10;21;124
"5511";"360810803012";13;1;133;10;25;182
"5512";"360810803013";13;4;98;6;58;179
"5513";"360810803021";22;7;37;45;46;157
"5514";"360810803022";46;12;48;23;41;170
"5515";"360810803023";21;0;77;36;19;153
"5516";"360810809001";23;11;22;3;1;60
"5517";"360810809002";25;2;27;0;6;60
"5518";"360810809003";9;3;39;14;3;68
"5519";"360810809004";16;15;89;6;35;161
"5520";"360810809005";5;7;29;4;4;49
"5521";"360810809006";47;3;12;2;2;66
"5522";"360810809007";51;14;50;4;7;126
"5523";"360810814001";57;5;147;40;36;285
"5524";"360810814002";65;21;27;25;62;200
"5525";"360810814003";65;12;48;43;45;213
"5526";"360810818001";87;37;46;35;71;276
"5527";"360810818002";44;4;47;15;43;153
"5528";"360810818003";90;5;60;15;47;217
"5529";"360810837001";31;48;84;25;63;251
"5530";"360810837002";22;2;121;20;65;230
"5531";"360810837003";13;0;51;11;27;102
"5532";"360810837004";18;5;57;10;26;116
"5533";"360810838001";41;1;139;72;65;318
"5534";"360810838002";29;8;35;30;56;158
"5535";"360810838003";43;5;67;19;41;175
"5536";"360810838004";62;2;69;19;39;191
"5537";"360810840001";229;84;97;39;53;502
"5538";"360810840002";95;69;81;35;54;334
"5539";"360810840003";57;12;94;13;48;224
"5540";"360810840004";52;2;48;22;32;156
"5541";"360810840005";131;1;57;16;37;242
"5542";"360810845001";7;2;2;0;2;13
"5543";"360810845002";162;17;16;1;14;210
"5544";"360810845003";22;5;154;5;31;217
"5545";"360810846011";52;4;120;41;45;262
"5546";"360810846012";40;4;123;48;27;242
"5547";"360810846021";31;5;178;56;29;299
"5548";"360810849001";22;5;127;1;42;197
"5549";"360810849002";31;8;61;1;34;135
"5550";"360810849003";35;6;38;4;32;115
"5551";"360810849004";1;22;220;18;50;311
"5552";"360810853001";25;20;34;1;53;133
"5553";"360810853002";21;8;21;0;21;71
"5554";"360810853003";16;9;38;0;10;73
"5555";"360810853004";8;3;10;0;8;29
"5556";"360810855001";26;3;2;0;8;39
"5557";"360810855002";53;15;32;0;12;112
"5558";"360810855003";29;14;39;0;7;89
"5559";"360810855004";36;14;53;0;7;110
"5560";"360810857001";49;33;18;0;19;119
"5561";"360810857002";42;4;55;0;16;117
"5562";"360810857003";71;13;53;0;40;177
"5563";"360810859001";24;4;13;0;54;95
"5564";"360810859002";34;2;111;1;119;267
"5565";"360810859003";13;12;39;0;14;78
"5566";"360810861001";62;1;26;0;7;96
"5567";"360810861002";11;7;38;0;79;135
"5568";"360810863001";32;0;17;0;10;59
"5569";"360810863002";20;4;47;1;7;79
"5570";"360810863003";29;2;6;0;14;51
"5571";"360810863004";62;3;162;3;57;287
"5572";"360810864001";58;15;144;14;67;298
"5573";"360810864002";22;7;25;15;23;92
"5574";"360810865001";54;8;37;1;25;125
"5575";"360810865002";24;23;50;0;29;126
"5576";"360810869001";14;24;203;5;77;323
"5577";"360810869002";2;4;152;15;35;208
"5578";"360810871001";70;29;58;6;48;211
"5579";"360810871002";7;20;104;0;46;177
"5580";"360810884001";7;3;46;21;50;127
"5581";"360810884002";4;1;33;8;20;66
"5582";"360810884003";6;1;16;15;23;61
"5583";"360810884004";9;1;15;12;41;78
"5584";"360810884005";12;31;10;7;17;77
"5585";"360810884006";30;3;125;49;47;254
"5586";"360810884007";0;0;24;10;14;48
"5587";"360810884008";5;6;35;27;16;89
"5588";"360810889011";9;1;107;29;19;165
"5589";"360810889012";9;7;18;11;2;47
"5590";"360810889013";40;9;20;5;9;83
"5591";"360810889014";30;2;26;1;11;70
"5592";"360810889015";11;1;52;0;3;67
"5593";"360810889016";337;16;46;7;15;421
"5594";"360810889017";35;12;58;0;13;118
"5595";"360810892001";9;6;23;15;29;82
"5596";"360810892002";10;35;17;19;26;107
"5597";"360810892003";6;1;49;35;25;116
"5598";"360810892004";5;1;21;11;7;45
"5599";"360810892005";25;2;31;13;18;89
"5600";"360810892006";5;0;3;4;16;28
"5601";"360810892007";9;6;15;15;19;64
"5602";"360810892008";15;238;32;10;22;317
"5603";"360810907001";19;13;156;81;62;331
"5604";"360810916011";0;1;4;0;4;9
"5605";"360810916012";0;0;0;0;2;2
"5606";"360810916013";1;0;2;1;0;4
"5607";"360810916014";4;7;9;4;10;34
"5608";"360810916021";0;0;12;0;0;12
"5609";"360810918001";0;0;4;0;1;5
"5610";"360810919001";10;3;69;23;27;132
"5611";"360810919002";105;23;203;36;70;437
"5612";"360810919003";43;5;108;38;29;223
"5613";"360810922001";8;0;2;1;6;17
"5614";"360810922002";4;1;11;2;12;30
"5615";"360810922003";5;4;102;3;4;118
"5616";"360810925001";90;31;118;42;47;328
"5617";"360810925002";55;21;189;29;52;346
"5618";"360810925003";46;9;132;31;40;258
"5619";"360810928001";5;7;18;0;9;39
"5620";"360810928002";12;4;4;0;15;35
"5621";"360810928003";2;1;10;3;2;18
"5622";"360810929001";99;14;203;71;52;439
"5623";"360810929002";101;23;101;50;45;320
"5624";"360810929003";31;1;42;22;10;106
"5625";"360810929004";1;16;35;4;3;59
"5626";"360810934010";2;0;1;0;0;3
"5627";"360810934011";1;4;30;5;9;49
"5628";"360810934012";22;4;26;2;9;63
"5629";"360810934013";5;7;72;3;7;94
"5630";"360810934021";58;6;70;0;26;160
"5631";"360810934022";16;1;63;2;6;88
"5632";"360810934023";8;6;29;8;12;63
"5633";"360810938001";29;7;24;1;46;107
"5634";"360810938002";31;36;126;5;19;217
"5635";"360810938003";278;393;89;9;142;911
"5636";"360810939001";50;23;180;34;41;328
"5637";"360810939002";31;1;70;32;40;174
"5638";"360810939003";67;5;55;34;33;194
"5639";"360810942011";200;117;131;21;52;521
"5640";"360810942020";0;0;0;0;1;1
"5641";"360810942021";145;45;42;19;33;284
"5642";"360810942022";128;23;80;72;51;354
"5643";"360810942031";35;34;44;3;21;137
"5644";"360810942032";64;25;18;8;14;129
"5645";"360810942033";17;15;9;0;6;47
"5646";"360810942034";17;7;3;1;6;34
"5647";"360810942035";24;44;4;0;4;76
"5648";"360810945000";0;0;0;0;2;2
"5649";"360810945001";35;14;126;40;42;257
"5650";"360810945002";28;7;111;67;33;246
"5651";"360810947001";47;266;116;93;75;597
"5652";"360810947002";80;3;114;30;28;255
"5653";"360810954001";40;7;15;21;26;109
"5654";"360810954002";24;5;16;4;17;66
"5655";"360810954003";29;4;33;35;19;120
"5656";"360810964001";57;10;47;19;32;165
"5657";"360810964002";54;27;41;51;47;220
"5658";"360810972021";95;7;4;15;97;218
"5659";"360810972031";35;0;2;32;16;85
"5660";"360810972032";63;0;1;6;9;79
"5661";"360810972033";105;8;1;21;9;144
"5662";"360810972034";108;1;0;9;12;130
"5663";"360810972041";71;1;5;0;18;95
"5664";"360810972042";80;2;56;27;25;190
"5665";"360810972043";6;0;1;6;5;18
"5666";"360810973001";6;7;13;7;14;47
"5667";"360810973002";9;1;24;15;14;63
"5668";"360810973003";6;2;1;12;13;34
"5669";"360810981000";0;1;1;0;0;2
"5670";"360810981001";26;7;50;9;16;108
"5671";"360810981002";26;17;151;9;26;229
"5672";"360810987001";23;13;96;36;42;210
"5673";"360810987002";8;5;74;33;32;152
"5674";"360810991001";36;1;24;13;3;77
"5675";"360810991002";5;0;24;5;3;37
"5676";"360810991003";9;4;17;8;9;47
"5677";"360810991004";15;0;12;2;19;48
"5678";"360810991005";31;2;48;24;21;126
"5679";"360810992001";81;18;49;50;43;241
"5680";"360810992002";129;13;35;44;7;228
"5681";"360810997011";7;9;25;9;4;54
"5682";"360810997012";4;2;15;15;10;46
"5683";"360810997013";14;1;25;19;8;67
"5684";"360810997031";26;7;73;33;33;172
"5685";"360810997032";0;1;6;3;3;13
"5686";"360810997033";3;3;35;10;20;71
"5687";"360810997041";10;1;17;20;3;51
"5688";"360810997042";20;4;36;10;4;74
"5689";"360810997043";18;1;47;3;4;73
"5690";"360810997044";5;6;46;8;6;71
"5691";"360810997051";26;3;56;18;9;112
"5692";"360810998011";51;2;25;20;20;118
"5693";"360810998012";83;4;7;3;28;125
"5694";"360810998013";25;4;43;16;14;102
"5695";"360810998014";12;2;2;1;1;18
"5696";"360810998015";46;8;24;16;16;110
"5697";"360810998021";170;32;27;10;45;284
"5698";"360810998022";39;3;0;0;3;45
"5699";"360810998023";13;7;2;1;5;28
"5700";"360811008011";35;13;9;11;5;73
"5701";"360811008012";55;6;10;15;39;125
"5702";"360811008021";274;31;56;19;58;438
"5703";"360811008022";25;3;30;9;38;105
"5704";"360811008023";36;4;41;16;21;118
"5705";"360811008024";39;6;20;18;17;100
"5706";"360811010011";104;11;38;19;24;196
"5707";"360811010012";74;6;30;15;15;140
"5708";"360811010013";119;53;45;11;19;247
"5709";"360811010014";82;9;46;4;23;164
"5710";"360811010021";9;24;32;13;8;86
"5711";"360811010022";100;34;31;11;31;207
"5712";"360811017001";25;0;20;10;16;71
"5713";"360811017002";41;1;22;11;13;88
"5714";"360811017003";11;4;13;4;9;41
"5715";"360811017004";3;3;8;9;0;23
"5716";"360811017005";8;6;13;2;5;34
"5717";"360811017006";9;5;58;18;24;114
"5718";"360811017007";2;1;21;13;5;42
"5719";"360811029001";24;13;77;57;48;219
"5720";"360811029002";21;18;50;23;8;120
"5721";"360811032011";80;8;38;44;28;198
"5722";"360811032012";65;4;22;11;21;123
"5723";"360811032013";56;9;9;37;27;138
"5724";"360811032021";29;2;32;19;21;103
"5725";"360811032022";4;0;5;12;6;27
"5726";"360811032023";119;10;51;4;16;200
"5727";"360811032024";117;8;20;9;22;176
"5728";"360811033001";25;3;47;20;15;110
"5729";"360811033002";5;0;39;22;18;84
"5730";"360811033003";9;1;19;2;8;39
"5731";"360811033004";4;2;12;11;14;43
"5732";"360811039001";24;6;70;30;35;165
"5733";"360811039002";18;0;85;52;62;217
"5734";"360811039003";28;10;54;17;28;137
"5735";"360811039004";25;2;34;26;14;101
"5736";"360811047001";13;2;59;16;51;141
"5737";"360811047002";13;4;69;19;29;134
"5738";"360811047003";29;6;88;25;15;163
"5739";"360811047004";7;7;48;8;1;71
"5740";"360811047005";20;3;110;38;38;209
"5741";"360811059001";2;4;14;5;18;43
"5742";"360811059002";3;4;23;9;6;45
"5743";"360811059003";2;3;4;4;3;16
"5744";"360811059004";3;0;5;12;47;67
"5745";"360811072011";15;19;133;44;64;275
"5746";"360811072020";0;6;0;7;1;14
"5747";"360811072021";0;0;5;0;0;5
"5748";"360811085001";0;5;30;10;31;76
"5749";"360811085002";2;2;71;9;26;110
"5750";"360811085003";2;1;98;14;22;137
"5751";"360811093001";9;2;35;13;13;72
"5752";"360811093002";3;1;30;6;17;57
"5753";"360811093003";9;0;7;8;8;32
"5754";"360811097001";2;2;10;5;20;39
"5755";"360811097002";3;4;12;1;9;29
"5756";"360811097003";5;3;12;7;7;34
"5757";"360811099001";6;0;61;15;33;115
"5758";"360811099002";19;2;37;10;24;92
"5759";"360811099003";14;62;124;14;24;238
"5760";"360811113001";6;4;37;3;14;64
"5761";"360811113002";3;1;25;4;16;49
"5762";"360811113003";15;1;15;8;11;50
"5763";"360811123001";15;13;61;5;16;110
"5764";"360811123002";20;42;129;2;27;220
"5765";"360811129001";3;3;44;10;10;70
"5766";"360811129002";8;0;8;5;12;33
"5767";"360811129003";11;3;39;10;7;70
"5768";"360811133001";10;2;15;11;6;44
"5769";"360811133002";6;1;33;15;16;71
"5770";"360811139001";8;6;37;16;5;72
"5771";"360811139002";135;8;162;23;36;364
"5772";"360811139003";3;1;37;13;13;67
"5773";"360811141001";3;27;61;12;27;130
"5774";"360811141002";17;6;40;19;17;99
"5775";"360811147001";8;13;28;6;7;62
"5776";"360811147002";9;3;30;13;15;70
"5777";"360811151001";16;16;28;12;27;99
"5778";"360811155001";23;6;69;5;21;124
"5779";"360811155002";67;10;25;0;18;120
"5780";"360811157001";15;8;66;3;20;112
"5781";"360811157002";36;8;69;0;20;133
"5782";"360811157003";32;2;47;0;12;93
"5783";"360811159001";4;3;47;2;12;68
"5784";"360811159002";8;0;96;1;18;123
"5785";"360811159003";110;1;78;1;23;213
"5786";"360811161001";41;5;169;0;39;254
"5787";"360811161002";14;6;38;2;7;67
"5788";"360811163001";24;3;7;0;10;44
"5789";"360811163002";22;2;38;1;12;75
"5790";"360811163003";35;8;27;0;13;83
"5791";"360811163004";57;2;18;0;10;87
"5792";"360811163005";20;5;84;1;25;135
"5793";"360811167001";51;22;327;13;54;467
"5794";"360811171001";9;14;88;18;30;159
"5795";"360811171002";17;8;75;7;14;121
"5796";"360811171003";48;13;51;7;40;159
"5797";"360811175001";12;3;61;6;28;110
"5798";"360811175002";25;9;124;1;19;178
"5799";"360811175003";11;18;72;15;13;129
"5800";"360811175004";25;24;105;23;30;207
"5801";"360811181001";3;2;122;9;18;154
"5802";"360811181002";12;2;105;11;28;158
"5803";"360811185001";24;7;129;10;25;195
"5804";"360811185002";20;3;162;16;17;218
"5805";"360811187001";19;0;38;10;10;77
"5806";"360811187002";19;3;101;8;44;175
"5807";"360811189001";6;0;98;25;46;175
"5808";"360811189002";14;0;60;2;17;93
"5809";"360811191001";35;4;273;18;41;371
"5810";"360811191002";45;2;129;22;25;223
"5811";"360811193001";24;5;57;8;27;121
"5812";"360811193002";14;2;51;8;18;93
"5813";"360811195001";17;8;72;30;23;150
"5814";"360811199001";20;1;82;41;26;170
"5815";"360811201001";17;3;80;4;52;156
"5816";"360811203001";2;3;26;5;28;64
"5817";"360811203002";3;3;42;1;23;72
"5818";"360811205001";18;9;270;7;42;346
"5819";"360811207001";17;3;29;19;17;85
"5820";"360811207002";20;11;85;37;44;197
"5821";"360811211001";0;3;99;2;2;106
"5822";"360811215001";14;0;113;26;25;178
"5823";"360811215002";31;4;140;31;44;250
"5824";"360811215003";17;0;134;14;35;200
"5825";"360811223001";11;2;97;15;16;141
"5826";"360811223002";5;2;38;22;17;84
"5827";"360811223003";18;3;68;36;33;158
"5828";"360811227011";23;10;176;13;25;247
"5829";"360811227012";9;4;79;17;12;121
"5830";"360811227013";29;3;208;4;17;261
"5831";"360811227014";24;12;42;1;4;83
"5832";"360811227015";120;15;126;19;8;288
"5833";"360811227016";0;0;7;1;0;8
"5834";"360811227017";84;2;6;2;2;96
"5835";"360811227021";103;4;6;25;8;146
"5836";"360811227022";66;10;38;7;9;130
"5837";"360811227023";517;6;15;7;23;568
"5838";"360811227024";10;2;60;6;16;94
"5839";"360811227025";97;9;28;1;12;147
"5840";"360811241001";19;3;42;45;19;128
"5841";"360811241002";19;0;52;24;36;131
"5842";"360811241003";61;3;59;15;34;172
"5843";"360811247001";14;2;26;21;29;92
"5844";"360811247002";53;1;14;20;22;110
"5845";"360811247003";51;16;60;37;9;173
"5846";"360811257001";85;19;98;5;20;227
"5847";"360811257002";40;152;88;4;167;451
"5848";"360811257003";265;5;671;1;12;954
"5849";"360811265001";30;3;41;10;17;101
"5850";"360811265002";23;1;70;18;12;124
"5851";"360811267001";23;4;55;18;9;109
"5852";"360811267002";16;6;88;12;16;138
"5853";"360811267003";31;5;29;12;26;103
"5854";"360811277001";15;6;34;17;18;90
"5855";"360811277002";38;12;31;18;28;127
"5856";"360811277003";3;3;13;20;10;49
"5857";"360811277004";1;2;17;7;5;32
"5858";"360811283001";1;14;67;10;3;95
"5859";"360811291021";21;1;34;5;23;84
"5860";"360811291022";18;1;8;6;13;46
"5861";"360811291023";8;0;0;3;13;24
"5862";"360811291024";3;4;2;9;3;21
"5863";"360811291031";39;3;24;5;5;76
"5864";"360811291032";10;3;7;1;3;24
"5865";"360811291033";7;1;7;6;8;29
"5866";"360811291041";0;2;0;0;6;8
"5867";"360811291042";11;2;5;7;5;30
"5868";"360811291043";5;3;15;8;5;36
"5869";"360811291044";1;0;11;6;17;35
"5870";"360811291045";33;4;17;2;1;57
"5871";"360811301001";5;1;27;11;21;65
"5872";"360811301002";9;4;8;11;11;43
"5873";"360811301003";22;8;25;5;25;85
"5874";"360811301004";22;2;18;13;13;68
"5875";"360811333001";11;0;39;36;13;99
"5876";"360811333002";0;3;65;20;9;97
"5877";"360811333003";9;9;48;11;30;107
"5878";"360811333004";4;4;70;22;13;113
"5879";"360811339001";7;8;31;29;11;86
"5880";"360811341001";20;3;42;23;35;123
"5881";"360811341002";8;4;38;25;20;95
"5882";"360811341003";7;1;20;9;15;52
"5883";"360811347001";46;10;33;23;21;133
"5884";"360811347002";1;0;20;8;3;32
"5885";"360811347003";57;3;44;27;6;137
"5886";"360811347004";22;7;27;12;8;76
"5887";"360811347005";47;4;39;6;21;117
"5888";"360811367001";7;19;80;17;36;159
"5889";"360811367002";3;2;6;7;11;29
"5890";"360811367003";0;1;11;6;5;23
"5891";"360811367004";6;5;12;15;12;50
"5892";"360811367005";3;3;15;13;2;36
"5893";"360811377001";12;2;44;2;3;63
"5894";"360811377002";27;1;76;14;1;119
"5895";"360811377003";3;1;59;17;14;94
"5896";"360811377004";10;1;36;7;12;66
"5897";"360811385011";12;4;55;6;4;81
"5898";"360811385012";27;0;79;3;9;118
"5899";"360811385013";5;1;34;1;7;48
"5900";"360811385014";30;0;70;10;28;138
"5901";"360811385021";1;4;24;20;15;64
"5902";"360811399001";2;0;17;2;17;38
"5903";"360811399002";8;2;9;8;13;40
"5904";"360811403001";0;0;14;13;16;43
"5905";"360811403002";11;1;22;12;25;71
"5906";"360811409011";4;1;11;6;8;30
"5907";"360811409021";1;1;55;11;27;95
"5908";"360811409022";13;2;27;19;18;79
"5909";"360811417001";4;0;20;12;20;56
"5910";"360811417002";8;4;19;15;30;76
"5911";"360811417003";4;1;10;10;11;36
"5912";"360811417004";9;3;23;14;16;65
"5913";"360811417005";5;15;28;15;10;73
"5914";"360811429001";4;6;27;9;18;64
"5915";"360811429002";25;3;48;20;27;123
"5916";"360811429003";14;1;13;10;17;55
"5917";"360811429004";5;1;14;24;7;51
"5918";"360811435001";3;0;48;8;35;94
"5919";"360811435002";6;0;13;17;16;52
"5920";"360811441001";15;3;26;6;19;69
"5921";"360811441002";4;1;21;1;3;30
"5922";"360811441003";3;1;8;2;5;19
"5923";"360811441004";5;2;17;3;5;32
"5924";"360811447001";19;6;87;17;29;158
"5925";"360811447002";29;6;80;26;41;182
"5926";"360811451011";10;3;48;15;15;91
"5927";"360811451021";14;2;25;7;31;79
"5928";"360811451022";26;3;29;18;22;98
"5929";"360811459001";14;3;28;4;16;65
"5930";"360811459002";10;7;22;20;16;75
"5931";"360811459003";9;0;27;16;6;58
"5932";"360811463001";9;2;77;23;20;131
"5933";"360811463002";11;9;63;9;31;123
"5934";"360811467001";28;18;108;11;25;190
"5935";"360811467002";43;1;2;1;4;51
"5936";"360811467003";2;1;53;6;14;76
"5937";"360811471001";40;6;160;35;33;274
"5938";"360811471002";4;6;65;10;11;96
"5939";"360811479001";9;5;123;14;16;167
"5940";"360811479002";47;8;95;8;9;167
"5941";"360811479003";5;1;76;8;18;108
"5942";"360811483001";8;1;24;8;20;61
"5943";"360811483002";4;5;54;4;12;79
"5944";"360811483003";19;1;32;4;20;76
"5945";"360811483004";4;7;8;4;7;30
"5946";"360811507011";6;1;19;8;17;51
"5947";"360811507012";2;4;13;7;17;43
"5948";"360811507013";5;0;20;3;5;33
"5949";"360811507021";0;6;30;4;8;48
"5950";"360811507022";3;0;0;4;7;14
"5951";"360811507023";3;3;12;9;7;34
"5952";"360811507024";6;88;66;14;25;199
"5953";"360811529011";3;1;23;12;8;47
"5954";"360811529012";26;8;142;27;47;250
"5955";"360811529013";15;8;52;23;3;101
"5956";"360811529021";2;2;28;6;4;42
"5957";"360811529022";18;1;14;8;8;49
"5958";"360811529023";10;0;71;18;27;126
"5959";"360811529024";6;8;15;11;11;51
"5960";"360811551011";2;0;0;1;0;3
"5961";"360811551021";13;2;30;7;3;55
"5962";"360811551022";0;0;7;5;3;15
"5963";"360811551023";6;5;118;17;13;159
"5964";"360811551024";2;5;24;19;5;55
"5965";"360811551025";32;0;16;18;2;68
"5966";"360811551026";6;0;9;5;1;21
"5967";"360811567001";4;9;25;4;17;59
"5968";"360811571011";1;0;13;3;9;26
"5969";"360811571012";9;15;37;6;12;79
"5970";"360811571013";16;2;14;10;6;48
"5971";"360811571014";19;1;16;8;8;52
"5972";"360811571015";24;5;12;15;31;87
"5973";"360811571016";13;16;26;14;43;112
"5974";"360811571017";9;27;37;21;23;117
"5975";"360811571018";4;1;6;17;5;33
"5976";"360811571021";5;0;8;11;24;48
"5977";"360811571022";4;2;46;19;28;99
"5978";"360811579011";17;3;38;2;26;86
"5979";"360811579012";3;2;16;3;28;52
"5980";"360811579013";2;0;5;2;5;14
"5981";"360811579014";8;0;8;12;7;35
"5982";"360811579015";12;2;25;13;21;73
"5983";"360811579016";8;5;11;7;23;54
"5984";"360811579021";13;58;21;7;14;113
"5985";"360811579022";9;3;14;2;6;34
"5986";"360811579023";16;69;14;7;5;111
"5987";"360811579024";15;2;10;5;31;63
"5988";"360811579025";5;53;45;9;15;127
"5989";"360811579031";6;1;18;2;21;48
"5990";"360811579032";18;5;44;9;32;108
"5991";"360811579033";11;3;39;40;23;116
"5992";"360811579034";4;5;70;63;19;161
"5993";"360811617001";17;4;48;14;42;125
"5994";"360811617002";12;2;5;9;8;36
"5995";"360811617003";20;1;9;12;15;57
"5996";"360811617004";41;5;70;35;40;191
"5997";"360811621001";7;6;21;8;20;62
"5998";"360811621002";26;4;64;8;16;118
"5999";"360811621003";21;1;21;14;14;71
"6000";"360811621004";2;1;27;26;28;84
"6001";"360811621005";15;3;72;39;36;165
"6002";"360850003001";91;8;28;2;15;144
"6003";"360850003002";21;24;101;16;39;201
"6004";"360850006001";33;121;24;21;20;219
"6005";"360850006002";52;6;176;22;19;275
"6006";"360850007001";38;12;41;13;16;120
"6007";"360850007002";58;7;63;5;17;150
"6008";"360850007003";21;4;65;12;12;114
"6009";"360850007004";148;14;35;2;18;217
"6010";"360850008001";24;13;64;13;74;188
"6011";"360850008002";50;8;92;15;39;204
"6012";"360850008003";13;7;52;26;41;139
"6013";"360850009001";67;9;106;32;34;248
"6014";"360850009002";24;1;30;8;21;84
"6015";"360850011001";38;54;127;47;29;295
"6016";"360850011002";69;2;18;7;33;129
"6017";"360850011003";95;30;21;15;47;208
"6018";"360850017001";23;44;7;7;5;86
"6019";"360850017002";145;3;46;14;22;230
"6020";"360850018001";0;0;1;0;1;2
"6021";"360850020011";16;1;37;22;13;89
"6022";"360850020012";7;0;83;10;13;113
"6023";"360850020021";16;8;67;27;27;145
"6024";"360850020022";3;0;32;33;12;80
"6025";"360850021001";126;25;66;47;98;362
"6026";"360850021002";68;80;130;47;60;385
"6027";"360850021003";215;45;70;37;66;433
"6028";"360850027001";95;74;50;27;40;286
"6029";"360850029001";29;5;48;31;69;182
"6030";"360850029002";345;15;13;5;14;392
"6031";"360850029003";319;271;51;33;59;733
"6032";"360850029004";53;24;17;15;37;146
"6033";"360850033001";31;4;75;21;16;147
"6034";"360850033002";103;78;113;30;46;370
"6035";"360850036001";15;1;58;23;25;122
"6036";"360850036002";48;8;39;13;40;148
"6037";"360850039001";2;2;13;9;4;30
"6038";"360850039002";22;6;68;17;5;118
"6039";"360850040001";59;10;32;26;32;159
"6040";"360850040002";421;25;31;17;36;530
"6041";"360850040003";206;6;10;16;10;248
"6042";"360850040004";47;3;17;3;32;102
"6043";"360850040005";15;7;2;2;9;35
"6044";"360850040006";68;9;25;20;27;149
"6045";"360850040007";60;7;28;27;29;151
"6046";"360850047001";30;9;32;29;25;125
"6047";"360850047002";11;9;19;18;29;86
"6048";"360850050001";16;8;81;13;24;142
"6049";"360850050002";11;1;52;19;19;102
"6050";"360850050003";10;5;20;10;20;65
"6051";"360850059001";35;22;41;7;26;131
"6052";"360850059002";19;26;64;5;32;146
"6053";"360850064001";5;2;24;13;21;65
"6054";"360850064002";11;0;16;10;12;49
"6055";"360850064003";88;13;202;25;58;386
"6056";"360850067001";10;8;17;11;11;57
"6057";"360850067002";10;4;72;19;16;121
"6058";"360850067003";31;5;20;10;12;78
"6059";"360850070000";0;1;0;0;0;1
"6060";"360850070001";50;63;61;42;57;273
"6061";"360850070002";7;3;58;14;25;107
"6062";"360850070003";42;35;56;30;46;209
"6063";"360850070004";14;1;52;22;49;138
"6064";"360850074001";38;11;57;25;28;159
"6065";"360850074002";51;40;90;23;67;271
"6066";"360850075001";32;5;41;15;27;120
"6067";"360850075002";17;3;47;10;18;95
"6068";"360850075003";54;14;90;50;32;240
"6069";"360850077001";78;23;9;26;38;174
"6070";"360850081001";38;29;74;42;40;223
"6071";"360850081002";78;8;28;13;19;146
"6072";"360850081003";254;34;32;31;40;391
"6073";"360850096011";68;1;119;20;19;227
"6074";"360850096012";28;5;91;15;44;183
"6075";"360850096021";11;6;27;17;7;68
"6076";"360850096022";21;6;26;17;37;107
"6077";"360850096023";12;3;39;11;10;75
"6078";"360850097001";83;11;58;42;30;224
"6079";"360850097002";47;6;25;13;16;107
"6080";"360850097003";16;7;8;8;11;50
"6081";"360850105001";61;104;24;21;9;219
"6082";"360850105002";15;19;27;14;27;102
"6083";"360850105003";14;3;40;22;13;92
"6084";"360850105004";34;3;64;27;34;162
"6085";"360850105005";126;31;27;15;39;238
"6086";"360850112011";28;9;89;34;56;216
"6087";"360850112012";17;9;57;26;66;175
"6088";"360850112021";31;15;60;27;23;156
"6089";"360850112022";28;9;29;23;42;131
"6090";"360850112023";49;17;50;15;49;180
"6091";"360850112024";1;0;0;1;1;3
"6092";"360850114011";39;3;38;8;12;100
"6093";"360850114012";296;11;33;11;37;388
"6094";"360850114021";3;5;20;8;15;51
"6095";"360850114022";67;2;16;10;6;101
"6096";"360850114023";9;1;14;12;21;57
"6097";"360850121001";13;1;12;21;2;49
"6098";"360850121002";5;0;55;30;12;102
"6099";"360850121003";14;11;36;11;22;94
"6100";"360850122001";11;18;26;4;29;88
"6101";"360850122002";6;2;27;32;36;103
"6102";"360850122003";3;3;17;11;3;37
"6103";"360850122004";14;17;33;11;25;100
"6104";"360850125001";124;68;43;34;49;318
"6105";"360850125002";183;176;27;18;23;427
"6106";"360850125003";7;3;38;17;2;67
"6107";"360850128041";96;18;71;35;118;338
"6108";"360850128042";107;4;89;46;121;367
"6109";"360850128051";14;5;51;24;32;126
"6110";"360850128061";7;0;8;7;9;31
"6111";"360850128062";28;3;11;8;8;58
"6112";"360850128063";45;21;9;0;15;90
"6113";"360850128064";23;5;73;42;36;179
"6114";"360850132011";4;5;13;6;9;37
"6115";"360850132012";4;2;8;1;4;19
"6116";"360850132031";11;1;17;14;10;53
"6117";"360850132032";13;6;65;18;24;126
"6118";"360850132033";21;15;65;19;48;168
"6119";"360850132041";1;3;349;9;25;387
"6120";"360850132042";20;7;110;39;22;198
"6121";"360850132043";11;5;61;9;20;106
"6122";"360850133011";246;12;6;1;8;273
"6123";"360850133021";35;5;14;37;29;120
"6124";"360850133022";114;11;42;36;26;229
"6125";"360850133023";207;57;50;18;29;361
"6126";"360850134001";29;17;47;26;25;144
"6127";"360850134002";9;3;46;9;22;89
"6128";"360850134003";7;1;28;14;14;64
"6129";"360850138001";44;16;6;4;15;85
"6130";"360850138002";5;4;22;6;38;75
"6131";"360850138003";6;2;12;3;7;30
"6132";"360850138004";12;1;13;8;16;50
"6133";"360850138005";3;0;26;7;9;45
"6134";"360850141001";28;9;67;24;16;144
"6135";"360850141002";44;7;23;9;22;105
"6136";"360850146041";58;2;35;9;30;134
"6137";"360850146042";14;15;47;17;26;119
"6138";"360850146043";9;3;35;16;20;83
"6139";"360850146044";28;3;81;12;30;154
"6140";"360850146051";30;31;167;21;29;278
"6141";"360850146052";47;5;32;8;21;113
"6142";"360850146061";26;13;168;22;77;306
"6143";"360850146062";16;7;114;8;22;167
"6144";"360850146063";13;1;57;8;49;128
"6145";"360850146064";23;1;104;9;8;145
"6146";"360850146071";26;6;105;48;49;234
"6147";"360850146072";19;39;48;19;22;147
"6148";"360850146081";30;5;44;22;32;133
"6149";"360850146082";24;2;35;16;8;85
"6150";"360850147001";6;1;9;10;6;32
"6151";"360850147002";14;7;21;10;24;76
"6152";"360850147003";20;3;49;14;17;103
"6153";"360850151001";47;14;31;15;34;141
"6154";"360850151002";12;1;17;6;13;49
"6155";"360850151003";0;0;12;0;4;16
"6156";"360850151004";8;2;23;9;13;55
"6157";"360850151005";9;8;81;17;18;133
"6158";"360850154001";2;0;1;2;0;5
"6159";"360850156011";18;9;33;12;18;90
"6160";"360850156012";7;4;9;7;17;44
"6161";"360850156013";8;20;34;12;14;88
"6162";"360850156014";5;1;14;13;13;46
"6163";"360850156015";4;0;9;2;7;22
"6164";"360850156016";6;3;15;8;7;39
"6165";"360850156021";9;6;9;15;6;45
"6166";"360850156022";10;3;13;14;11;51
"6167";"360850156023";5;0;13;1;8;27
"6168";"360850156024";10;2;80;12;3;107
"6169";"360850156031";12;3;28;14;11;68
"6170";"360850156032";19;6;82;28;23;158
"6171";"360850156033";13;123;177;28;22;363
"6172";"360850169011";29;13;42;19;27;130
"6173";"360850169012";55;13;48;21;6;143
"6174";"360850170051";19;32;59;18;43;171
"6175";"360850170052";24;18;63;34;57;196
"6176";"360850170071";23;6;108;21;20;178
"6177";"360850170072";49;13;77;21;32;192
"6178";"360850170081";67;1;198;42;41;349
"6179";"360850170082";33;1;208;19;30;291
"6180";"360850170083";15;5;248;24;23;315
"6181";"360850170091";12;0;13;4;6;35
"6182";"360850170092";6;1;23;19;30;79
"6183";"360850170093";5;3;21;14;19;62
"6184";"360850170101";13;3;101;26;31;174
"6185";"360850170102";12;2;106;23;29;172
"6186";"360850170103";34;0;124;14;30;202
"6187";"360850170104";6;4;65;14;16;105
"6188";"360850170111";20;4;135;22;21;202
"6189";"360850170112";16;8;54;17;32;127
"6190";"360850170121";33;13;52;20;31;149
"6191";"360850170122";4;3;29;20;24;80
"6192";"360850170123";7;1;50;9;4;71
"6193";"360850173001";31;3;41;17;14;106
"6194";"360850173002";183;8;4;6;6;207
"6195";"360850176001";17;5;18;11;16;67
"6196";"360850176002";27;5;4;11;12;59
"6197";"360850176003";18;2;24;12;15;71
"6198";"360850176004";23;0;19;13;17;72
"6199";"360850177001";0;1;10;12;2;25
"6200";"360850177002";12;1;16;7;10;46
"6201";"360850177003";46;4;22;7;31;110
"6202";"360850177004";11;4;19;8;15;57
"6203";"360850177005";5;4;39;5;13;66
"6204";"360850177006";1;0;3;0;2;6
"6205";"360850181001";8;3;16;1;25;53
"6206";"360850181002";11;3;39;15;47;115
"6207";"360850181003";10;4;16;2;5;37
"6208";"360850187011";18;27;33;17;36;131
"6209";"360850187012";8;2;26;15;24;75
"6210";"360850187021";11;2;26;11;13;63
"6211";"360850187022";20;6;56;24;41;147
"6212";"360850187023";13;7;46;22;24;112
"6213";"360850187024";15;1;52;17;22;107
"6214";"360850189011";123;53;101;41;33;351
"6215";"360850189012";44;9;56;29;40;178
"6216";"360850189021";5;4;49;12;8;78
"6217";"360850189022";10;2;39;16;18;85
"6218";"360850189023";13;6;56;19;14;108
"6219";"360850197001";4;5;16;15;5;45
"6220";"360850197002";39;5;32;13;11;100
"6221";"360850198001";1;7;2;0;5;15
"6222";"360850198002";26;6;76;17;17;142
"6223";"360850198003";13;3;27;9;14;66
"6224";"360850198004";21;11;101;17;25;175
"6225";"360850201001";74;18;19;29;43;183
"6226";"360850201002";3;14;44;5;19;85
"6227";"360850201003";1;6;30;5;12;54
"6228";"360850207001";97;21;129;59;69;375
"6229";"360850207002";32;23;48;10;37;150
"6230";"360850207003";49;10;25;17;27;128
"6231";"360850207004";62;21;54;24;54;215
"6232";"360850208011";10;7;149;23;11;200
"6233";"360850208012";23;0;77;11;20;131
"6234";"360850208013";31;1;94;13;42;181
"6235";"360850208014";24;23;200;47;54;348
"6236";"360850208031";16;3;117;19;13;168
"6237";"360850208032";44;3;44;9;36;136
"6238";"360850208033";12;4;23;4;11;54
"6239";"360850208041";38;5;40;23;39;145
"6240";"360850208042";12;0;28;77;24;141
"6241";"360850208043";2;0;79;5;8;94
"6242";"360850213001";62;37;51;27;37;214
"6243";"360850213002";26;11;12;9;13;71
"6244";"360850213003";160;31;50;18;26;285
"6245";"360850213004";40;6;67;15;34;162
"6246";"360850213005";35;7;79;12;36;169
"6247";"360850223001";69;11;60;62;49;251
"6248";"360850223002";38;19;97;76;63;293
"6249";"360850226001";36;25;53;82;45;241
"6250";"360850226002";20;23;31;13;17;104
"6251";"360850226003";22;4;93;29;43;191
"6252";"360850226004";10;61;45;17;29;162
"6253";"360850228001";6;5;24;4;31;70
"6254";"360850231001";79;16;117;61;58;331
"6255";"360850231002";35;4;18;9;20;86
"6256";"360850239001";37;10;58;26;35;166
"6257";"360850239002";36;4;58;30;112;240
"6258";"360850244011";9;10;18;12;28;77
"6259";"360850244012";21;4;50;18;25;118
"6260";"360850244013";33;2;39;25;28;127
"6261";"360850244021";20;10;164;19;32;245
"6262";"360850244022";42;5;23;23;24;117
"6263";"360850247001";31;10;39;17;15;112
"6264";"360850247002";40;26;37;42;54;199
"6265";"360850248001";41;11;65;27;24;168
"6266";"360850248002";15;36;34;10;17;112
"6267";"360850248003";21;226;54;28;57;386
"6268";"360850251001";42;20;39;21;31;153
"6269";"360850251002";3;3;18;9;5;38
"6270";"360850251003";9;4;26;21;20;80
"6271";"360850273011";27;3;22;3;3;58
"6272";"360850273012";36;4;69;34;28;171
"6273";"360850273021";18;16;77;12;17;140
"6274";"360850273022";0;1;39;8;6;54
"6275";"360850277021";21;3;86;16;6;132
"6276";"360850277022";20;4;35;10;13;82
"6277";"360850277023";47;7;82;14;26;176
"6278";"360850277041";17;5;149;19;17;207
"6279";"360850277042";13;4;57;13;35;122
"6280";"360850277051";21;2;203;35;37;298
"6281";"360850277052";38;1;24;6;8;77
"6282";"360850277053";11;3;85;5;29;133
"6283";"360850277061";28;5;118;16;119;286
"6284";"360850277062";10;0;25;7;16;58
"6285";"360850277063";10;6;33;4;10;63
"6286";"360850279001";23;3;27;6;29;88
"6287";"360850279002";14;4;20;5;29;72
"6288";"360850291021";16;8;23;15;30;92
"6289";"360850291022";24;38;113;29;40;244
"6290";"360850291031";26;2;69;20;19;136
"6291";"360850291032";6;0;8;11;4;29
"6292";"360850291033";27;11;22;8;12;80
"6293";"360850291034";20;1;9;13;7;50
"6294";"360850291035";32;3;33;15;28;111
"6295";"360850291041";21;1;91;29;22;164
"6296";"360850291042";14;2;23;9;14;62
"6297";"360850291043";18;5;62;11;23;119
"6298";"360850291044";38;28;67;13;65;211
"6299";"360850303011";108;3;153;18;38;320
"6300";"360850303012";37;9;68;30;31;175
"6301";"360850303021";21;14;76;18;44;173
"6302";"360850303022";66;11;98;18;12;205
"6303";"360850303023";32;7;98;17;9;163
"6304";"360850303024";24;9;13;12;18;76
"6305";"360850319011";169;10;27;0;28;234
"6306";"360850319012";70;26;53;9;19;177
"6307";"360850319021";44;2;31;7;14;98
"6308";"360850319022";90;14;31;24;16;175
"6309";"360850319023";57;10;87;33;27;214
"6310";"360850323001";83;9;32;25;49;198
"6311";"361190002031";0;0;0;1;0;1
"6312";"361190013033";0;0;0;1;0;1
"6313";"361190015031";0;0;3;2;2;7
"6314";"361190026001";0;0;4;0;1;5
"6315";"361190026003";7;1;3;5;1;17
"6316";"361190029002";0;0;2;3;0;5
"6317";"361190055004";0;1;0;0;1;2
