"";"Data";"0";"1";"3";"4";"5";"sum"
"1";"360050001001";0;4;3;0;21;28
"2";"360050002001";268;191;301;52;58;870
"3";"360050002002";270;364;345;173;65;1217
"4";"360050002003";92;126;103;46;50;417
"5";"360050004000";0;2;0;0;0;2
"6";"360050004001";25;20;234;11;21;311
"7";"360050004002";80;59;340;104;43;626
"8";"360050004003";184;1251;145;30;61;1671
"9";"360050004004";82;88;55;24;17;266
"10";"360050016001";15;10;4;6;19;54
"11";"360050016002";67;35;180;20;20;322
"12";"360050016003";9;16;37;0;24;86
"13";"360050016004";56;94;210;34;35;429
"14";"360050019001";318;263;348;44;106;1079
"15";"360050019002";3;7;13;2;15;40
"16";"360050019003";50;666;323;38;49;1126
"17";"360050019004";26;513;35;18;26;618
"18";"360050020001";190;58;296;14;48;606
"19";"360050020002";164;416;215;21;69;885
"20";"360050020003";191;124;55;11;32;413
"21";"360050020004";149;336;9;0;19;513
"22";"360050020005";115;2;29;0;3;149
"23";"360050020006";84;13;198;15;25;335
"24";"360050023001";66;21;28;1;44;160
"25";"360050023002";78;11;32;4;7;132
"26";"360050023003";70;20;38;2;18;148
"27";"360050024000";13;14;14;0;9;50
"28";"360050024001";31;256;30;6;78;401
"29";"360050025001";59;135;12;3;113;322
"30";"360050025002";35;20;12;1;13;81
"31";"360050025003";44;22;8;1;21;96
"32";"360050025004";81;48;14;3;44;190
"33";"360050025005";31;24;69;3;13;140
"34";"360050027011";315;249;35;4;93;696
"35";"360050027012";146;73;23;1;47;290
"36";"360050027021";101;23;40;6;12;182
"37";"360050027022";102;50;19;0;39;210
"38";"360050027023";45;60;65;5;55;230
"39";"360050027024";251;697;39;2;31;1020
"40";"360050028000";0;0;0;0;1;1
"41";"360050028001";163;236;263;12;52;726
"42";"360050028002";72;277;83;1;34;467
"43";"360050028003";35;3;7;0;1;46
"44";"360050028004";42;57;44;0;7;150
"45";"360050031001";483;383;278;67;108;1319
"46";"360050033001";48;57;61;54;19;239
"47";"360050033002";58;146;21;4;19;248
"48";"360050033003";96;128;71;22;40;357
"49";"360050035001";76;181;214;51;36;558
"50";"360050035002";110;91;22;11;26;260
"51";"360050035003";213;509;105;9;46;882
"52";"360050037001";41;150;17;0;43;251
"53";"360050038001";156;53;164;67;35;475
"54";"360050039001";36;126;27;2;158;349
"55";"360050039002";77;60;172;20;56;385
"56";"360050039003";103;55;47;6;30;241
"57";"360050039004";44;38;90;15;33;220
"58";"360050039005";150;176;62;1;49;438
"59";"360050040011";29;46;151;12;33;271
"60";"360050041001";336;42;59;7;39;483
"61";"360050041002";286;104;218;10;42;660
"62";"360050041003";0;7;6;1;2;16
"63";"360050041004";243;168;34;6;37;488
"64";"360050042001";197;3;1;1;9;211
"65";"360050042002";93;27;5;0;10;135
"66";"360050042003";159;46;60;2;25;292
"67";"360050042004";59;22;27;6;8;122
"68";"360050042005";35;31;43;14;25;148
"69";"360050042006";0;13;10;2;27;52
"70";"360050042007";41;6;2;0;2;51
"71";"360050043001";272;160;74;12;57;575
"72";"360050043002";63;36;81;4;60;244
"73";"360050043003";217;97;97;13;39;463
"74";"360050043004";267;175;105;1;31;579
"75";"360050044001";195;46;28;2;22;293
"76";"360050044002";70;18;4;0;2;94
"77";"360050044003";105;16;62;9;30;222
"78";"360050044004";114;116;45;10;16;301
"79";"360050046001";201;121;37;59;54;472
"80";"360050048001";270;263;39;4;48;624
"81";"360050048002";89;71;208;8;54;430
"82";"360050050011";101;203;304;14;35;657
"83";"360050050012";160;211;69;4;67;511
"84";"360050050013";95;348;87;3;171;704
"85";"360050050014";72;32;34;3;17;158
"86";"360050050021";181;559;224;18;52;1034
"87";"360050050022";177;45;86;3;23;334
"88";"360050050023";63;105;75;3;24;270
"89";"360050050024";66;21;35;3;32;157
"90";"360050051001";55;184;193;8;72;512
"91";"360050051002";203;136;149;14;83;585
"92";"360050051003";478;36;13;1;35;563
"93";"360050052001";138;318;251;74;39;820
"94";"360050052002";191;262;80;11;37;581
"95";"360050053001";283;24;7;0;25;339
"96";"360050053002";72;20;9;0;6;107
"97";"360050054001";109;55;100;5;50;319
"98";"360050054002";138;75;460;10;56;739
"99";"360050054003";62;94;160;27;28;371
"100";"360050054004";87;1019;25;21;63;1215
"101";"360050056001";219;134;53;3;19;428
"102";"360050056002";36;17;69;4;12;138
"103";"360050056003";84;134;70;6;17;311
"104";"360050059021";72;69;35;4;188;368
"105";"360050059022";22;333;68;8;35;466
"106";"360050060001";242;244;661;19;32;1198
"107";"360050061001";38;16;17;0;26;97
"108";"360050061002";55;84;8;0;13;160
"109";"360050061003";7;70;53;3;14;147
"110";"360050062001";778;83;148;5;55;1069
"111";"360050062002";33;6;10;2;3;54
"112";"360050062003";102;31;97;1;19;250
"113";"360050062004";101;307;47;1;22;478
"114";"360050062005";9;19;14;0;12;54
"115";"360050063001";58;242;23;0;97;420
"116";"360050063002";206;1385;181;28;211;2011
"117";"360050063003";104;209;44;6;84;447
"118";"360050063004";112;1202;10;1;42;1367
"119";"360050063005";156;300;48;14;67;585
"120";"360050063006";433;1568;997;18;192;3208
"121";"360050064001";66;39;185;10;35;335
"122";"360050064002";120;14;28;2;15;179
"123";"360050064003";26;7;76;1;9;119
"124";"360050064004";118;112;173;8;22;433
"125";"360050065001";104;49;137;1;69;360
"126";"360050065002";412;223;63;9;59;766
"127";"360050065003";39;33;47;3;18;140
"128";"360050065004";22;23;55;4;93;197
"129";"360050067001";135;241;477;4;28;885
"130";"360050067002";202;278;45;2;38;565
"131";"360050067003";30;42;9;2;8;91
"132";"360050067004";35;58;6;1;8;108
"133";"360050067005";29;8;12;1;7;57
"134";"360050067006";100;161;68;6;21;356
"135";"360050068001";74;26;148;8;24;280
"136";"360050068002";24;18;44;17;27;130
"137";"360050068003";160;162;290;3;111;726
"138";"360050069001";183;89;107;5;49;433
"139";"360050069002";198;94;237;8;51;588
"140";"360050069003";6;5;0;0;3;14
"141";"360050069004";18;2;4;0;4;28
"142";"360050070001";93;33;340;10;41;517
"143";"360050070002";79;3198;78;2;20;3377
"144";"360050070003";912;636;124;25;30;1727
"145";"360050071001";78;392;110;23;51;654
"146";"360050071002";474;390;160;7;163;1194
"147";"360050072001";67;68;113;3;32;283
"148";"360050072002";89;27;112;8;34;270
"149";"360050072003";90;79;86;9;93;357
"150";"360050072004";49;106;90;3;26;274
"151";"360050073001";347;451;122;24;38;982
"152";"360050073002";176;54;53;7;7;297
"153";"360050073003";126;65;64;7;31;293
"154";"360050074001";52;54;261;43;17;427
"155";"360050074002";113;234;61;15;40;463
"156";"360050074003";22;62;24;17;20;145
"157";"360050075001";287;80;232;13;61;673
"158";"360050075002";265;109;144;9;31;558
"159";"360050075003";236;4;9;6;5;260
"160";"360050075004";20;17;2;1;13;53
"161";"360050076001";13;13;15;1;9;51
"162";"360050076002";1048;150;784;3;226;2211
"163";"360050076003";19;46;27;3;11;106
"164";"360050076004";152;339;193;11;65;760
"165";"360050076005";56;57;134;10;28;285
"166";"360050077001";123;54;190;10;48;425
"167";"360050078001";87;187;193;16;43;526
"168";"360050078002";256;98;236;30;466;1086
"169";"360050078003";28;57;39;10;25;159
"170";"360050078004";100;405;123;13;15;656
"171";"360050079001";58;130;32;4;52;276
"172";"360050079002";32;11;71;5;18;137
"173";"360050079003";52;18;12;1;7;90
"174";"360050079004";62;167;116;4;32;381
"175";"360050079005";13;16;1;7;9;46
"176";"360050079006";86;38;9;0;6;139
"177";"360050083001";101;370;49;6;46;572
"178";"360050083002";17;32;29;2;27;107
"179";"360050083003";65;100;55;2;15;237
"180";"360050083004";100;75;111;2;32;320
"181";"360050083005";45;87;48;5;47;232
"182";"360050083006";103;150;102;4;15;374
"183";"360050084001";67;11;128;29;8;243
"184";"360050084002";132;35;200;50;41;458
"185";"360050085001";158;500;81;7;51;797
"186";"360050085002";186;384;183;7;61;821
"187";"360050085003";18;15;38;3;43;117
"188";"360050085004";23;14;19;2;11;69
"189";"360050085005";106;22;23;1;14;166
"190";"360050086001";51;26;97;21;9;204
"191";"360050086002";122;73;4;1;60;260
"192";"360050086003";148;53;17;2;14;234
"193";"360050087001";93;432;308;4;105;942
"194";"360050087002";258;236;44;19;36;593
"195";"360050087003";95;56;57;11;63;282
"196";"360050087004";148;209;16;1;17;391
"197";"360050087005";49;245;140;1;51;486
"198";"360050089001";281;50;101;2;30;464
"199";"360050089002";61;163;162;14;59;459
"200";"360050090001";49;227;30;21;15;342
"201";"360050090002";47;409;60;9;48;573
"202";"360050090003";69;16;10;1;10;106
"203";"360050090004";57;40;80;19;19;215
"204";"360050090005";122;24;11;0;5;162
"205";"360050092001";1117;29;118;15;59;1338
"206";"360050092002";96;31;122;2;20;271
"207";"360050092003";83;56;229;10;40;418
"208";"360050092004";71;55;102;3;48;279
"209";"360050092005";116;176;171;3;35;501
"210";"360050093000";6;14;0;0;5;25
"211";"360050093001";28;30;141;37;37;273
"212";"360050093002";158;58;160;22;62;460
"213";"360050093003";122;82;113;1;43;361
"214";"360050093004";115;77;146;15;23;376
"215";"360050093005";158;109;371;53;42;733
"216";"360050093006";18;119;251;155;55;598
"217";"360050096001";98;33;159;16;34;340
"218";"360050096002";217;932;213;34;72;1468
"219";"360050098001";367;160;267;40;76;910
"220";"360050098002";54;19;101;11;25;210
"221";"360050098003";72;35;141;16;30;294
"222";"360050098004";16;4;83;5;32;140
"223";"360050098005";239;26;23;5;33;326
"224";"360050110000";0;0;0;0;1;1
"225";"360050110001";161;732;61;37;44;1035
"226";"360050115021";225;167;211;64;72;739
"227";"360050115022";171;352;49;16;182;770
"228";"360050115023";33;43;58;13;18;165
"229";"360050117000";17;47;2;0;0;66
"230";"360050117001";130;132;30;14;52;358
"231";"360050117002";8;88;27;31;40;194
"232";"360050118000";2;1;0;1;0;4
"233";"360050118001";39;35;98;17;39;228
"234";"360050118002";20;128;70;0;29;247
"235";"360050118003";105;36;150;21;29;341
"236";"360050119001";222;120;30;8;130;510
"237";"360050119002";47;42;62;0;23;174
"238";"360050119003";27;9;10;1;11;58
"239";"360050119004";24;15;12;3;6;60
"240";"360050119005";40;133;28;6;28;235
"241";"360050121011";113;73;63;9;35;293
"242";"360050121012";106;91;127;3;21;348
"243";"360050121021";64;126;37;2;64;293
"244";"360050123001";89;48;85;8;36;266
"245";"360050123002";142;38;89;17;31;317
"246";"360050123003";61;57;36;12;24;190
"247";"360050125001";126;122;219;14;40;521
"248";"360050125002";179;300;190;7;45;721
"249";"360050127011";45;25;42;12;28;152
"250";"360050127012";28;39;42;2;21;132
"251";"360050129011";136;418;125;15;53;747
"252";"360050129012";534;179;91;10;304;1118
"253";"360050130001";59;19;257;41;28;404
"254";"360050131001";61;85;44;6;26;222
"255";"360050131002";117;95;160;33;41;446
"256";"360050131003";275;272;127;19;56;749
"257";"360050132001";145;18;151;18;25;357
"258";"360050132002";247;48;86;18;22;421
"259";"360050132003";116;32;183;8;69;408
"260";"360050132004";106;71;289;33;74;573
"261";"360050132005";122;23;170;18;42;375
"262";"360050133001";591;125;16;1;44;777
"263";"360050133002";189;107;101;5;28;430
"264";"360050133003";510;67;3;0;8;588
"265";"360050133004";71;59;19;3;8;160
"266";"360050135001";127;58;209;7;36;437
"267";"360050135002";109;28;23;1;28;189
"268";"360050135003";164;56;181;12;49;462
"269";"360050138000";2;0;0;0;0;2
"270";"360050138001";37;78;120;15;48;298
"271";"360050138002";132;16;247;14;34;443
"272";"360050141001";264;206;150;11;41;672
"273";"360050141002";428;465;93;8;115;1109
"274";"360050141003";284;210;288;18;34;834
"275";"360050143001";97;388;286;99;22;892
"276";"360050144001";6;14;4;0;3;27
"277";"360050144002";32;14;12;3;8;69
"278";"360050144003";4;16;0;0;8;28
"279";"360050144004";67;42;14;1;12;136
"280";"360050144005";200;45;179;30;31;485
"281";"360050144006";122;37;115;21;57;352
"282";"360050145001";67;22;109;3;14;215
"283";"360050145002";58;33;3;5;6;105
"284";"360050145003";116;42;46;13;12;229
"285";"360050145004";126;144;184;73;31;558
"286";"360050147011";33;20;11;3;8;75
"287";"360050147012";207;60;47;2;25;341
"288";"360050147013";465;30;10;5;178;688
"289";"360050147021";1532;602;5;2;8;2149
"290";"360050147022";1182;312;46;6;27;1573
"291";"360050147023";70;14;19;0;9;112
"292";"360050147024";63;577;17;1;5;663
"293";"360050149001";143;162;175;15;28;523
"294";"360050149002";93;101;57;5;39;295
"295";"360050149003";143;1077;114;9;115;1458
"296";"360050151001";127;74;119;12;22;354
"297";"360050151002";131;192;53;1;19;396
"298";"360050151003";167;152;100;7;45;471
"299";"360050151004";170;210;280;5;34;699
"300";"360050152001";54;13;277;17;48;409
"301";"360050152002";184;34;312;13;67;610
"302";"360050153001";107;154;236;43;70;610
"303";"360050153002";44;353;31;6;20;454
"304";"360050153003";41;38;257;19;20;375
"305";"360050155001";139;373;48;5;43;608
"306";"360050155002";102;66;34;16;26;244
"307";"360050157001";403;1076;289;4;94;1866
"308";"360050157002";369;2521;376;10;49;3325
"309";"360050157003";326;213;201;8;56;804
"310";"360050158001";95;13;136;43;34;321
"311";"360050159001";229;307;26;8;50;620
"312";"360050159002";90;72;96;5;20;283
"313";"360050160001";106;40;171;18;19;354
"314";"360050160002";22;6;59;10;22;119
"315";"360050160003";34;36;85;5;16;176
"316";"360050160004";71;16;100;1;37;225
"317";"360050161001";535;857;138;20;102;1652
"318";"360050161002";155;736;110;5;45;1051
"319";"360050161003";62;29;10;2;12;115
"320";"360050161004";338;1531;54;3;114;2040
"321";"360050162001";28;2;59;3;19;111
"322";"360050162002";156;11;135;4;37;343
"323";"360050163001";36;130;88;10;42;306
"324";"360050164001";53;9;129;31;26;248
"325";"360050165001";268;337;212;82;38;937
"326";"360050166001";369;40;330;13;42;794
"327";"360050166002";80;14;83;7;38;222
"328";"360050167001";58;12;31;5;8;114
"329";"360050167002";384;1282;185;48;45;1944
"330";"360050169001";146;299;245;31;53;774
"331";"360050171001";132;1758;158;5;68;2121
"332";"360050173001";81;101;105;6;33;326
"333";"360050173002";72;102;78;69;23;344
"334";"360050173003";499;147;59;8;55;768
"335";"360050173004";74;49;29;4;43;199
"336";"360050175001";69;199;25;3;32;328
"337";"360050175002";53;82;372;19;12;538
"338";"360050175003";85;54;32;3;26;200
"339";"360050175004";513;164;40;13;23;753
"340";"360050175005";27;17;10;2;2;58
"341";"360050175006";54;32;19;2;5;112
"342";"360050177011";279;465;172;16;42;974
"343";"360050177012";29;31;27;8;16;111
"344";"360050177013";445;113;71;37;24;690
"345";"360050177021";38;8;42;5;6;99
"346";"360050177022";150;258;218;19;25;670
"347";"360050177023";112;66;174;8;34;394
"348";"360050177024";132;45;31;2;19;229
"349";"360050179011";298;2078;214;10;67;2667
"350";"360050179012";44;51;16;0;7;118
"351";"360050179013";220;226;55;20;42;563
"352";"360050179021";87;203;97;16;40;443
"353";"360050179022";103;185;47;5;31;371
"354";"360050179023";130;837;297;4;30;1298
"355";"360050181011";141;280;133;34;59;647
"356";"360050181012";75;21;28;0;13;137
"357";"360050181013";16;47;48;3;6;120
"358";"360050181021";114;218;25;2;27;386
"359";"360050181022";119;291;35;9;43;497
"360";"360050181023";47;91;36;7;11;192
"361";"360050181024";75;93;27;3;27;225
"362";"360050183011";135;299;88;0;52;574
"363";"360050183012";245;380;72;4;76;777
"364";"360050183013";165;642;51;3;75;936
"365";"360050183021";509;193;102;2;55;861
"366";"360050183022";89;154;68;6;26;343
"367";"360050183023";183;597;134;5;23;942
"368";"360050184001";47;6;67;2;20;142
"369";"360050184002";71;17;306;20;65;479
"370";"360050184003";73;29;130;11;63;306
"371";"360050184004";49;47;97;3;44;240
"372";"360050185001";405;315;367;88;76;1251
"373";"360050185002";108;138;152;1;61;460
"374";"360050185003";193;205;243;37;109;787
"375";"360050185004";78;41;50;5;14;188
"376";"360050185005";60;78;87;3;27;255
"377";"360050189001";108;425;239;9;48;829
"378";"360050189002";44;59;19;4;16;142
"379";"360050189003";1539;1908;894;124;506;4971
"380";"360050189004";453;481;312;7;50;1303
"381";"360050193001";505;261;33;16;25;840
"382";"360050193002";33;20;7;3;5;68
"383";"360050193003";15;5;16;0;5;41
"384";"360050193004";131;167;153;5;38;494
"385";"360050194001";277;168;683;30;54;1212
"386";"360050195001";239;358;34;9;54;694
"387";"360050195002";407;372;52;7;170;1008
"388";"360050195003";145;369;28;1;31;574
"389";"360050195004";206;307;14;1;36;564
"390";"360050197001";48;157;51;2;27;285
"391";"360050197002";92;334;26;2;29;483
"392";"360050197003";176;541;37;11;59;824
"393";"360050197004";110;48;15;0;3;176
"394";"360050197005";183;302;69;3;22;579
"395";"360050199001";92;390;53;1;16;552
"396";"360050199002";83;366;16;5;25;495
"397";"360050199003";14;97;19;1;14;145
"398";"360050199004";201;96;132;13;42;484
"399";"360050199005";80;447;65;5;35;632
"400";"360050199006";235;395;160;12;59;861
"401";"360050200001";107;46;143;4;60;360
"402";"360050200002";39;33;71;17;28;188
"403";"360050200003";312;14;215;20;31;592
"404";"360050200004";78;48;31;1;18;176
"405";"360050201001";304;651;282;12;55;1304
"406";"360050201002";84;291;112;27;54;568
"407";"360050201003";173;197;118;23;130;641
"408";"360050202001";66;9;81;8;23;187
"409";"360050202002";90;39;132;11;45;317
"410";"360050204001";95;48;49;1;25;218
"411";"360050204002";34;24;319;6;33;416
"412";"360050204003";209;120;157;2;66;554
"413";"360050205011";169;1113;40;3;49;1374
"414";"360050205012";237;232;144;18;53;684
"415";"360050205013";181;216;88;5;28;518
"416";"360050205014";277;319;375;5;53;1029
"417";"360050205021";51;549;139;4;35;778
"418";"360050205022";59;19;111;3;3;195
"419";"360050205023";54;16;104;9;21;204
"420";"360050206011";53;17;92;6;19;187
"421";"360050206012";68;34;260;30;41;433
"422";"360050209001";22;693;46;24;42;827
"423";"360050209002";155;758;30;10;38;991
"424";"360050209003";42;125;29;4;19;219
"425";"360050209004";217;347;75;9;47;695
"426";"360050210011";231;12;26;2;5;276
"427";"360050210012";191;5;2;6;16;220
"428";"360050210013";25;5;0;0;6;36
"429";"360050210014";64;19;13;2;5;103
"430";"360050210015";153;22;7;5;11;198
"431";"360050210016";154;0;2;7;6;169
"432";"360050210021";93;10;5;1;10;119
"433";"360050210022";176;15;9;0;23;223
"434";"360050210023";0;1;3;0;3;7
"435";"360050210024";1;0;0;0;0;1
"436";"360050210025";27;2;4;0;6;39
"437";"360050210026";1170;21;7;0;5;1203
"438";"360050210027";2;0;1;0;0;3
"439";"360050210028";0;1;0;0;0;1
"440";"360050211001";264;57;112;17;29;479
"441";"360050211002";75;242;85;18;34;454
"442";"360050211003";104;37;113;7;20;281
"443";"360050211004";10;15;12;1;1;39
"444";"360050212001";15;7;1;0;2;25
"445";"360050212002";11;4;4;0;7;26
"446";"360050212004";30;6;1;2;4;43
"447";"360050212005";5;1;0;0;3;9
"448";"360050213011";15;24;36;2;9;86
"449";"360050213012";10;38;59;2;26;135
"450";"360050213021";153;151;200;115;31;650
"451";"360050213022";45;159;158;10;23;395
"452";"360050213023";36;28;82;5;10;161
"453";"360050213024";117;71;95;10;20;313
"454";"360050215011";121;277;116;6;29;549
"455";"360050215012";274;458;98;12;42;884
"456";"360050215013";53;86;185;3;38;365
"457";"360050215021";201;299;145;10;45;700
"458";"360050215022";211;165;62;4;38;480
"459";"360050215023";160;118;174;9;19;480
"460";"360050215024";108;105;99;5;18;335
"461";"360050215025";58;78;35;3;19;193
"462";"360050216011";71;104;197;8;43;423
"463";"360050216012";68;47;195;10;38;358
"464";"360050216013";124;98;53;39;11;325
"465";"360050216014";85;59;167;13;8;332
"466";"360050216021";29;46;56;2;25;158
"467";"360050216022";52;13;10;3;15;93
"468";"360050216023";69;9;12;0;16;106
"469";"360050216024";35;2;10;0;14;61
"470";"360050216025";22;3;43;4;10;82
"471";"360050217001";291;877;214;27;65;1474
"472";"360050217002";259;229;72;21;58;639
"473";"360050217003";41;78;49;12;13;193
"474";"360050217004";99;539;116;13;19;786
"475";"360050218001";77;93;17;3;16;206
"476";"360050218002";167;91;117;8;28;411
"477";"360050218003";141;29;405;45;24;644
"478";"360050218004";50;18;144;24;9;245
"479";"360050218005";228;194;98;19;35;574
"480";"360050219001";201;692;285;126;99;1403
"481";"360050220001";150;103;246;31;42;572
"482";"360050221011";42;11;6;2;9;70
"483";"360050221012";75;156;31;0;40;302
"484";"360050221013";115;148;81;1;33;378
"485";"360050221021";144;905;146;10;93;1298
"486";"360050221022";94;247;35;3;15;394
"487";"360050221023";153;101;64;3;37;358
"488";"360050222001";107;107;115;3;64;396
"489";"360050222002";17;8;55;3;15;98
"490";"360050222003";119;24;66;5;47;261
"491";"360050222004";33;15;37;0;19;104
"492";"360050223001";63;383;43;9;29;527
"493";"360050223002";228;332;27;5;53;645
"494";"360050223003";193;857;41;17;84;1192
"495";"360050223004";54;273;9;3;26;365
"496";"360050224011";47;148;9;4;13;221
"497";"360050224012";691;277;112;14;50;1144
"498";"360050224031";76;89;72;10;90;337
"499";"360050224032";235;100;138;5;80;558
"500";"360050224041";126;12;47;5;27;217
"501";"360050224042";211;56;50;1;32;350
"502";"360050224043";241;47;40;1;18;347
"503";"360050225001";192;290;70;11;34;597
"504";"360050225002";168;390;151;20;35;764
"505";"360050225003";56;139;52;8;26;281
"506";"360050225004";51;63;31;1;35;181
"507";"360050225005";79;67;20;3;19;188
"508";"360050225006";98;159;25;1;21;304
"509";"360050227011";172;197;108;4;30;511
"510";"360050227012";408;651;69;6;51;1185
"511";"360050227013";115;181;94;37;35;462
"512";"360050227021";113;374;100;23;85;695
"513";"360050227031";93;265;91;7;22;478
"514";"360050228001";151;64;189;2;27;433
"515";"360050228002";223;79;94;0;24;420
"516";"360050228003";232;185;31;3;61;512
"517";"360050228004";95;37;9;0;18;159
"518";"360050229011";124;206;85;9;46;470
"519";"360050229012";188;265;43;19;23;538
"520";"360050229013";219;681;62;1;28;991
"521";"360050229014";208;303;142;6;31;690
"522";"360050229015";124;558;192;16;24;914
"523";"360050229021";159;2044;363;4;34;2604
"524";"360050229022";51;239;58;11;27;386
"525";"360050229023";405;2805;222;12;73;3517
"526";"360050230001";121;120;239;11;69;560
"527";"360050230002";296;109;272;10;31;718
"528";"360050231001";174;695;177;25;48;1119
"529";"360050232001";101;24;300;2;25;452
"530";"360050232002";101;46;179;7;26;359
"531";"360050233011";81;131;26;3;33;274
"532";"360050233012";165;455;113;4;53;790
"533";"360050233013";74;160;78;14;4;330
"534";"360050233014";78;82;24;3;17;204
"535";"360050233021";987;385;40;7;51;1470
"536";"360050233022";435;794;59;19;136;1443
"537";"360050235011";188;234;98;13;51;584
"538";"360050235012";166;800;45;3;18;1032
"539";"360050235013";482;1347;25;2;35;1891
"540";"360050235021";93;288;19;28;18;446
"541";"360050235022";86;271;33;1;10;401
"542";"360050235023";84;297;87;8;28;504
"543";"360050235024";163;402;179;5;34;783
"544";"360050236001";24;36;91;0;26;177
"545";"360050236002";79;26;84;3;24;216
"546";"360050237021";257;323;43;3;101;727
"547";"360050237031";233;398;57;39;127;854
"548";"360050237032";168;307;27;6;97;605
"549";"360050237033";153;610;39;5;56;863
"550";"360050237041";76;311;37;0;15;439
"551";"360050237042";395;387;69;0;35;886
"552";"360050237043";438;201;19;0;18;676
"553";"360050238001";5;22;43;8;18;96
"554";"360050238002";280;114;311;7;49;761
"555";"360050238003";112;108;367;12;30;629
"556";"360050239001";262;224;46;4;50;586
"557";"360050239002";246;274;53;3;37;613
"558";"360050239003";163;351;167;46;43;770
"559";"360050239004";579;616;83;3;56;1337
"560";"360050239005";58;340;41;7;35;481
"561";"360050239006";131;521;46;4;22;724
"562";"360050240001";182;124;778;29;56;1169
"563";"360050240002";103;17;103;3;23;249
"564";"360050240003";219;70;328;11;60;688
"565";"360050241001";127;305;158;3;34;627
"566";"360050241002";37;90;79;4;24;234
"567";"360050241003";102;81;128;23;14;348
"568";"360050241004";77;146;76;4;9;312
"569";"360050241005";148;616;40;1;77;882
"570";"360050243001";57;107;49;4;45;262
"571";"360050243002";108;197;177;10;19;511
"572";"360050243003";43;121;31;4;7;206
"573";"360050243004";283;147;211;11;47;699
"574";"360050244001";59;45;135;9;42;290
"575";"360050244002";108;56;216;46;42;468
"576";"360050245011";159;203;84;4;25;475
"577";"360050245012";60;273;112;4;23;472
"578";"360050245013";134;730;27;2;32;925
"579";"360050245014";388;676;66;4;33;1167
"580";"360050245021";113;254;104;9;25;505
"581";"360050245022";53;43;12;0;10;118
"582";"360050245023";218;713;107;2;51;1091
"583";"360050246001";210;25;586;7;39;867
"584";"360050246002";78;23;270;11;19;401
"585";"360050247001";1;36;1;2;1;41
"586";"360050247002";52;48;35;2;22;159
"587";"360050248001";37;3;77;7;37;161
"588";"360050248002";211;20;193;8;21;453
"589";"360050248003";35;5;240;19;22;321
"590";"360050249001";65;237;195;16;15;528
"591";"360050250001";73;7;133;4;25;242
"592";"360050250002";40;19;164;4;28;255
"593";"360050251001";152;356;82;7;62;659
"594";"360050251002";50;227;79;2;33;391
"595";"360050251003";104;181;117;13;57;472
"596";"360050251004";19;47;53;2;5;126
"597";"360050251005";134;290;98;5;57;584
"598";"360050251006";149;101;55;17;38;360
"599";"360050251007";24;16;51;1;6;98
"600";"360050252001";90;44;346;12;65;557
"601";"360050252002";42;3;276;33;19;373
"602";"360050253001";1137;229;27;3;43;1439
"603";"360050253002";223;129;110;11;28;501
"604";"360050253003";168;194;32;9;90;493
"605";"360050253004";275;329;119;10;27;760
"606";"360050254001";37;42;201;4;64;348
"607";"360050254002";33;20;195;4;36;288
"608";"360050255001";406;1000;183;17;183;1789
"609";"360050255002";333;994;153;15;107;1602
"610";"360050255003";146;410;94;2;72;724
"611";"360050256001";99;21;145;28;37;330
"612";"360050256002";123;104;174;43;69;513
"613";"360050257001";158;877;144;24;35;1238
"614";"360050261001";133;350;77;14;42;616
"615";"360050263001";162;663;21;0;194;1040
"616";"360050263002";156;182;7;0;23;368
"617";"360050263003";373;813;135;11;32;1364
"618";"360050263004";25;273;391;4;16;709
"619";"360050263005";158;642;181;5;134;1120
"620";"360050264001";70;12;204;13;25;324
"621";"360050264002";61;13;260;15;31;380
"622";"360050264003";182;37;226;18;50;513
"623";"360050264004";92;10;149;10;58;319
"624";"360050265001";94;223;195;26;84;622
"625";"360050265002";273;230;111;43;58;715
"626";"360050265003";254;1043;29;9;75;1410
"627";"360050265004";104;198;86;17;30;435
"628";"360050266011";39;26;56;11;22;154
"629";"360050266012";101;29;78;5;23;236
"630";"360050266013";40;6;114;6;20;186
"631";"360050266021";79;8;118;8;24;237
"632";"360050266022";97;57;134;13;52;353
"633";"360050266023";43;29;257;17;58;404
"634";"360050266024";151;17;39;4;16;227
"635";"360050266025";77;11;242;7;14;351
"636";"360050267011";116;49;225;0;19;409
"637";"360050267012";122;120;139;4;21;406
"638";"360050267013";111;48;82;4;18;263
"639";"360050267021";539;190;984;18;121;1852
"640";"360050267022";64;85;328;3;55;535
"641";"360050267023";176;208;2147;21;61;2613
"642";"360050267024";48;24;172;3;14;261
"643";"360050267025";21;25;147;3;3;199
"644";"360050267026";125;123;554;6;65;873
"645";"360050269001";374;1471;451;81;138;2515
"646";"360050269002";170;72;126;7;19;394
"647";"360050269003";34;30;37;6;24;131
"648";"360050273001";130;299;41;13;40;523
"649";"360050273002";357;567;223;4;138;1289
"650";"360050273003";122;75;257;5;38;497
"651";"360050273004";247;521;229;11;101;1109
"652";"360050274011";10;6;37;18;16;87
"653";"360050274012";30;18;163;7;34;252
"654";"360050274013";59;14;127;20;50;270
"655";"360050274014";72;11;207;35;41;366
"656";"360050274020";0;1;3;0;3;7
"657";"360050274021";32;1;37;7;28;105
"658";"360050274022";48;54;112;13;33;260
"659";"360050274023";37;225;400;6;64;732
"660";"360050276001";100;24;173;17;104;418
"661";"360050277001";100;212;47;2;43;404
"662";"360050277002";83;53;82;6;24;248
"663";"360050277003";299;168;351;3;99;920
"664";"360050277004";531;543;28;4;80;1186
"665";"360050279001";182;146;230;42;29;629
"666";"360050279002";230;33;262;14;25;564
"667";"360050279003";139;28;152;7;10;336
"668";"360050279004";82;38;130;3;20;273
"669";"360050279005";48;31;47;3;7;136
"670";"360050279006";443;117;199;9;30;798
"671";"360050281001";208;22;110;6;20;366
"672";"360050281002";67;10;84;5;6;172
"673";"360050281003";8;34;44;8;15;109
"674";"360050283001";163;80;57;4;94;398
"675";"360050283002";186;108;48;15;59;416
"676";"360050284001";44;30;81;26;62;243
"677";"360050285001";258;52;114;0;22;446
"678";"360050285002";107;20;22;0;25;174
"679";"360050285003";77;31;23;3;17;151
"680";"360050285004";127;63;152;28;54;424
"681";"360050286001";12;5;101;1;20;139
"682";"360050286002";62;34;134;1;41;272
"683";"360050287001";85;46;224;5;59;419
"684";"360050287002";52;49;9;1;16;127
"685";"360050287003";148;92;54;2;54;350
"686";"360050288001";197;78;46;13;20;354
"687";"360050288002";26;15;89;15;18;163
"688";"360050288003";197;12;51;0;16;276
"689";"360050288004";13;3;24;7;8;55
"690";"360050289001";351;209;175;4;55;794
"691";"360050289002";90;71;10;0;19;190
"692";"360050289003";35;646;149;11;61;902
"693";"360050289004";65;133;119;4;14;335
"694";"360050293011";3;3;13;6;1;26
"695";"360050293012";6;28;54;2;50;140
"696";"360050293021";57;121;25;2;8;213
"697";"360050293022";30;29;55;1;16;131
"698";"360050293023";137;35;51;2;36;261
"699";"360050293024";138;19;164;0;31;352
"700";"360050295001";90;75;108;4;67;344
"701";"360050295002";355;131;68;0;67;621
"702";"360050295003";73;25;69;1;17;185
"703";"360050295004";64;82;69;4;73;292
"704";"360050296001";379;150;298;48;64;939
"705";"360050296002";15;57;27;4;33;136
"706";"360050297001";36;68;136;8;49;297
"707";"360050297002";139;23;49;3;13;227
"708";"360050297003";36;9;37;0;6;88
"709";"360050300001";62;91;176;17;88;434
"710";"360050300002";116;24;252;23;22;437
"711";"360050300003";111;157;189;8;42;507
"712";"360050300004";83;17;68;4;36;208
"713";"360050300005";42;14;57;10;37;160
"714";"360050300006";45;25;178;18;29;295
"715";"360050301001";11;11;11;1;20;54
"716";"360050301002";0;4;24;0;1;29
"717";"360050302001";5;13;16;1;17;52
"718";"360050302002";9;2;10;1;2;24
"719";"360050302003";40;9;103;8;12;172
"720";"360050302004";5;0;0;0;1;6
"721";"360050302005";45;11;66;6;18;146
"722";"360050302006";10;4;1;0;1;16
"723";"360050307011";41;23;52;8;5;129
"724";"360050307012";49;17;20;0;19;105
"725";"360050307013";74;16;17;1;11;119
"726";"360050307014";1;14;21;4;20;60
"727";"360050309001";3;17;24;1;7;52
"728";"360050309002";13;75;15;1;78;182
"729";"360050309003";10;10;142;0;4;166
"730";"360050309004";19;67;200;5;50;341
"731";"360050310001";34;24;57;12;12;139
"732";"360050310002";53;71;112;30;71;337
"733";"360050310003";69;6;94;5;16;190
"734";"360050312001";50;3;49;5;36;143
"735";"360050312002";14;5;51;5;28;103
"736";"360050314001";45;40;50;10;27;172
"737";"360050314002";49;8;39;10;27;133
"738";"360050316001";257;41;180;9;43;530
"739";"360050316002";13;11;26;4;62;116
"740";"360050318001";26;3;74;13;27;143
"741";"360050318002";51;16;67;16;22;172
"742";"360050319001";10;6;12;0;4;32
"743";"360050323001";42;4;6;1;6;59
"744";"360050323002";17;21;24;2;3;67
"745";"360050323003";43;6;13;2;6;70
"746";"360050323004";183;17;234;4;8;446
"747";"360050324001";192;51;25;11;46;325
"748";"360050324002";75;66;125;4;23;293
"749";"360050326001";173;31;78;18;33;333
"750";"360050326002";30;18;151;15;36;250
"751";"360050326003";38;7;51;7;21;124
"752";"360050328001";32;20;56;12;30;150
"753";"360050328002";81;69;5;2;55;212
"754";"360050328003";96;64;108;10;28;306
"755";"360050328004";102;8;64;9;9;192
"756";"360050330001";166;124;88;4;30;412
"757";"360050330002";286;55;123;16;32;512
"758";"360050330003";335;48;29;0;40;452
"759";"360050330004";61;9;127;7;15;219
"760";"360050332011";109;79;39;6;36;269
"761";"360050332012";142;89;92;4;18;345
"762";"360050332013";194;38;29;0;55;316
"763";"360050332021";107;41;73;1;20;242
"764";"360050332022";87;43;21;0;30;181
"765";"360050332023";25;26;54;0;17;122
"766";"360050332024";136;10;17;5;10;178
"767";"360050334001";126;668;57;9;156;1016
"768";"360050335001";7;7;9;1;8;32
"769";"360050335002";182;70;263;13;30;558
"770";"360050335003";85;112;75;0;22;294
"771";"360050336001";60;15;87;4;16;182
"772";"360050336002";55;65;6;1;59;186
"773";"360050336003";65;9;5;1;17;97
"774";"360050336004";98;18;12;3;5;136
"775";"360050336005";42;29;3;20;32;126
"776";"360050336006";15;6;39;1;11;72
"777";"360050337001";38;7;73;1;5;124
"778";"360050337002";136;12;151;27;22;348
"779";"360050337003";28;57;99;16;51;251
"780";"360050338001";91;38;46;2;17;194
"781";"360050338002";104;75;222;4;22;427
"782";"360050338003";64;18;180;4;21;287
"783";"360050338004";201;21;165;21;52;460
"784";"360050340001";57;25;157;2;20;261
"785";"360050340002";145;43;211;15;17;431
"786";"360050340003";98;19;117;14;11;259
"787";"360050340004";38;18;32;7;10;105
"788";"360050342001";63;11;46;11;11;142
"789";"360050342002";62;37;162;6;26;293
"790";"360050343001";24;22;65;19;37;167
"791";"360050343002";308;119;134;17;17;595
"792";"360050344001";93;79;61;11;21;265
"793";"360050344002";99;30;114;38;22;303
"794";"360050345001";104;50;253;19;38;464
"795";"360050345002";65;22;306;23;31;447
"796";"360050345003";13;8;192;1;9;223
"797";"360050348001";49;402;172;45;26;694
"798";"360050348002";284;79;14;3;48;428
"799";"360050348003";97;20;176;33;15;341
"800";"360050348004";26;13;110;18;38;205
"801";"360050350001";83;18;239;24;21;385
"802";"360050350002";60;36;140;28;73;337
"803";"360050351001";10;14;80;5;6;115
"804";"360050351002";188;21;177;14;32;432
"805";"360050351003";103;54;98;5;28;288
"806";"360050356001";28;15;98;14;18;173
"807";"360050356002";43;81;219;49;29;421
"808";"360050358001";49;22;224;43;27;365
"809";"360050358002";31;27;143;25;30;256
"810";"360050358003";85;32;135;19;18;289
"811";"360050358004";36;9;89;23;16;173
"812";"360050358005";26;5;34;13;1;79
"813";"360050358006";35;12;117;22;27;213
"814";"360050358007";27;30;77;15;24;173
"815";"360050359001";434;491;296;26;87;1334
"816";"360050360001";67;34;70;26;17;214
"817";"360050360002";42;17;182;15;16;272
"818";"360050360003";31;2;73;29;8;143
"819";"360050361001";93;112;103;6;27;341
"820";"360050361002";125;48;215;2;13;403
"821";"360050361003";5;18;21;2;16;62
"822";"360050361004";33;40;5;5;2;85
"823";"360050361005";409;284;157;3;16;869
"824";"360050363001";118;151;32;10;22;333
"825";"360050363002";15;19;8;0;1;43
"826";"360050363003";104;381;57;10;45;597
"827";"360050363004";185;150;119;6;21;481
"828";"360050363005";87;156;31;6;42;322
"829";"360050363006";175;77;73;10;20;355
"830";"360050364001";47;27;128;8;22;232
"831";"360050364002";66;99;142;5;27;339
"832";"360050364003";53;49;169;19;37;327
"833";"360050365011";93;64;23;16;14;210
"834";"360050365012";212;90;48;30;28;408
"835";"360050365013";181;104;48;14;17;364
"836";"360050365021";44;45;75;4;19;187
"837";"360050365022";132;86;66;5;42;331
"838";"360050367001";43;55;76;27;25;226
"839";"360050367002";54;35;39;1;13;142
"840";"360050368001";64;19;85;4;26;198
"841";"360050368002";54;8;71;6;41;180
"842";"360050369011";180;366;42;34;53;675
"843";"360050369012";79;318;49;10;23;479
"844";"360050369021";74;16;10;15;6;121
"845";"360050369022";140;98;38;8;43;327
"846";"360050370001";85;25;168;16;7;301
"847";"360050370002";28;17;108;8;9;170
"848";"360050370003";39;16;74;12;16;157
"849";"360050371001";1119;185;127;17;62;1510
"850";"360050371002";87;46;76;23;30;262
"851";"360050371003";621;42;54;5;13;735
"852";"360050371004";31;108;42;4;21;206
"853";"360050372001";113;18;75;15;14;235
"854";"360050372002";201;106;119;32;62;520
"855";"360050373001";103;42;26;8;19;198
"856";"360050373002";148;134;104;6;49;441
"857";"360050373003";89;149;65;16;33;352
"858";"360050373004";149;91;43;19;24;326
"859";"360050374001";58;34;70;8;10;180
"860";"360050374002";240;155;191;18;74;678
"861";"360050374003";132;8;17;0;11;168
"862";"360050374004";30;2;0;0;0;32
"863";"360050375041";70;56;111;27;49;313
"864";"360050375042";141;108;32;17;52;350
"865";"360050375043";259;206;68;32;35;600
"866";"360050376001";183;43;51;5;23;305
"867";"360050376002";120;120;115;35;16;406
"868";"360050378001";105;59;125;10;34;333
"869";"360050378002";40;208;30;1;24;303
"870";"360050378003";117;300;61;4;67;549
"871";"360050379001";104;240;130;57;32;563
"872";"360050379002";98;12;16;3;16;145
"873";"360050379003";181;58;18;4;16;277
"874";"360050379004";50;116;49;2;40;257
"875";"360050379005";104;126;103;6;13;352
"876";"360050380001";41;46;27;0;31;145
"877";"360050380002";59;11;158;9;16;253
"878";"360050380003";370;65;167;21;73;696
"879";"360050380004";109;62;134;14;27;346
"880";"360050381001";53;61;14;2;13;143
"881";"360050381002";240;195;25;4;14;478
"882";"360050381003";215;87;26;1;22;351
"883";"360050381004";183;101;61;4;12;361
"884";"360050381005";38;66;120;36;14;274
"885";"360050381006";250;864;40;16;83;1253
"886";"360050382001";75;15;132;12;38;272
"887";"360050382002";109;30;110;9;30;288
"888";"360050383011";112;124;113;0;17;366
"889";"360050383012";69;101;78;14;9;271
"890";"360050383013";226;222;41;7;33;529
"891";"360050383021";83;126;44;10;51;314
"892";"360050383022";133;173;78;14;31;429
"893";"360050383023";378;146;36;6;41;607
"894";"360050385001";92;404;101;11;63;671
"895";"360050385002";96;105;59;5;27;292
"896";"360050385003";61;238;82;17;51;449
"897";"360050385004";381;317;156;45;83;982
"898";"360050386001";167;25;164;45;35;436
"899";"360050386002";59;21;160;21;16;277
"900";"360050386003";120;151;153;5;22;451
"901";"360050386004";165;42;119;19;29;374
"902";"360050386005";176;22;44;12;21;275
"903";"360050386006";48;26;15;0;27;116
"904";"360050386007";39;2;60;2;9;112
"905";"360050386008";49;112;25;0;23;209
"906";"360050387001";375;82;40;14;49;560
"907";"360050387002";80;152;58;17;24;331
"908";"360050387003";71;60;49;8;24;212
"909";"360050388001";61;9;107;2;16;195
"910";"360050388002";99;3;145;18;17;282
"911";"360050389001";114;35;92;6;13;260
"912";"360050389002";110;137;17;0;38;302
"913";"360050389003";149;218;104;8;65;544
"914";"360050389004";170;119;25;2;23;339
"915";"360050389005";130;58;25;2;28;243
"916";"360050390001";173;15;331;12;31;562
"917";"360050390002";112;31;143;6;26;318
"918";"360050391001";121;68;63;16;39;307
"919";"360050391002";203;212;172;23;50;660
"920";"360050391003";95;66;384;18;27;590
"921";"360050391004";42;202;34;1;53;332
"922";"360050391005";18;40;8;1;18;85
"923";"360050391006";49;26;5;1;23;104
"924";"360050392001";31;6;69;2;10;118
"925";"360050392002";12;6;174;1;26;219
"926";"360050393001";312;131;120;7;46;616
"927";"360050393002";310;396;47;20;72;845
"928";"360050393003";67;43;20;22;13;165
"929";"360050393004";25;26;24;10;18;103
"930";"360050393005";13;6;40;0;5;64
"931";"360050393006";63;115;53;21;40;292
"932";"360050394001";109;58;19;5;33;224
"933";"360050394002";225;22;105;17;41;410
"934";"360050394003";20;17;15;0;8;60
"935";"360050394004";87;45;123;5;27;287
"936";"360050395001";174;129;138;60;45;546
"937";"360050395002";60;74;113;45;41;333
"938";"360050395003";152;53;144;68;34;451
"939";"360050395004";309;317;163;35;83;907
"940";"360050396001";32;17;167;9;19;244
"941";"360050396002";80;19;203;24;19;345
"942";"360050396003";57;11;126;9;28;231
"943";"360050396004";25;14;371;8;22;440
"944";"360050397001";18;46;107;10;57;238
"945";"360050397002";125;351;10;4;58;548
"946";"360050398001";75;21;102;5;22;225
"947";"360050398002";83;22;127;11;32;275
"948";"360050398003";56;22;67;6;15;166
"949";"360050399011";54;59;20;9;35;177
"950";"360050399012";49;58;44;14;28;193
"951";"360050399013";127;67;36;3;30;263
"952";"360050399014";83;80;8;2;20;193
"953";"360050399015";273;330;45;11;40;699
"954";"360050399021";166;111;21;2;76;376
"955";"360050399022";173;192;9;3;28;405
"956";"360050399023";542;786;67;13;42;1450
"957";"360050399024";73;67;2;1;40;183
"958";"360050399025";125;255;50;3;32;465
"959";"360050401001";81;44;11;0;12;148
"960";"360050401002";236;293;122;36;195;882
"961";"360050401003";353;139;60;5;47;604
"962";"360050401004";128;55;5;2;9;199
"963";"360050401005";282;353;20;6;26;687
"964";"360050403021";348;428;43;6;123;948
"965";"360050403022";120;65;12;1;4;202
"966";"360050403023";56;78;9;1;11;155
"967";"360050403031";757;672;101;15;86;1631
"968";"360050403032";268;204;166;14;30;682
"969";"360050403033";264;299;49;15;47;674
"970";"360050403041";259;365;37;1;121;783
"971";"360050403042";560;199;47;6;71;883
"972";"360050403043";133;116;112;5;33;399
"973";"360050404001";171;34;240;18;17;480
"974";"360050404002";103;23;136;7;13;282
"975";"360050404003";17;3;124;3;5;152
"976";"360050405011";313;744;76;23;57;1213
"977";"360050405012";104;52;51;7;4;218
"978";"360050405013";239;113;125;12;21;510
"979";"360050405021";116;196;32;5;14;363
"980";"360050405022";93;89;44;1;13;240
"981";"360050405023";272;143;93;9;27;544
"982";"360050405024";33;24;18;4;5;84
"983";"360050405025";106;79;17;3;2;207
"984";"360050405026";112;57;218;3;17;407
"985";"360050406001";357;37;192;30;27;643
"986";"360050406002";137;36;144;14;12;343
"987";"360050406003";119;33;111;17;32;312
"988";"360050407011";120;225;76;7;45;473
"989";"360050407012";33;30;19;5;15;102
"990";"360050407013";76;249;40;37;24;426
"991";"360050407021";129;109;69;2;22;331
"992";"360050407022";253;624;145;6;46;1074
"993";"360050407023";429;276;102;10;30;847
"994";"360050407024";492;714;136;7;35;1384
"995";"360050407025";95;63;33;0;14;205
"996";"360050408001";12;7;40;4;3;66
"997";"360050408002";265;123;53;14;25;480
"998";"360050408003";124;79;48;1;27;279
"999";"360050408004";221;53;138;5;34;451
"1000";"360050409001";263;734;439;24;94;1554
"1001";"360050409002";88;713;92;15;34;942
"1002";"360050411001";109;232;51;3;22;417
"1003";"360050411002";162;70;71;9;19;331
"1004";"360050411003";646;76;83;7;27;839
"1005";"360050413001";396;432;208;13;124;1173
"1006";"360050413002";54;32;22;3;30;141
"1007";"360050413003";92;117;47;15;32;303
"1008";"360050413004";246;152;39;2;33;472
"1009";"360050413005";106;87;23;2;18;236
"1010";"360050413006";76;20;78;15;25;214
"1011";"360050413007";202;38;83;2;26;351
"1012";"360050414001";51;23;231;26;29;360
"1013";"360050414002";155;18;90;12;42;317
"1014";"360050414003";104;36;137;26;32;335
"1015";"360050414004";93;62;168;49;62;434
"1016";"360050415001";323;171;97;12;43;646
"1017";"360050415002";88;99;52;1;14;254
"1018";"360050415003";48;11;30;1;3;93
"1019";"360050415004";33;83;58;3;53;230
"1020";"360050415005";146;49;78;3;11;287
"1021";"360050415006";96;150;110;0;33;389
"1022";"360050418001";60;85;172;14;52;383
"1023";"360050418002";128;39;185;37;45;434
"1024";"360050418003";53;15;48;20;22;158
"1025";"360050418004";63;6;310;7;22;408
"1026";"360050419001";126;121;94;2;40;383
"1027";"360050419002";133;106;54;2;13;308
"1028";"360050419003";64;38;73;2;14;191
"1029";"360050419004";216;149;40;4;80;489
"1030";"360050419005";113;113;51;1;22;300
"1031";"360050419006";209;254;32;10;37;542
"1032";"360050419007";136;28;90;2;13;269
"1033";"360050420001";93;51;72;4;27;247
"1034";"360050420002";1469;3476;264;6;292;5507
"1035";"360050420003";104602;1475;487;4;40;106608
"1036";"360050421001";309;39;43;1;27;419
"1037";"360050421002";282;269;19;0;71;641
"1038";"360050421003";413;82;62;4;33;594
"1039";"360050421004";237;154;60;4;21;476
"1040";"360050421005";194;114;36;2;20;366
"1041";"360050422001";176;63;410;19;111;779
"1042";"360050422002";153;108;310;14;383;968
"1043";"360050423001";124;86;54;0;12;276
"1044";"360050423002";126;132;166;10;102;536
"1045";"360050423003";124;73;231;4;70;502
"1046";"360050424001";34;9;102;17;18;180
"1047";"360050424002";59;8;134;5;19;225
"1048";"360050425001";49;145;32;5;19;250
"1049";"360050425002";185;558;326;14;31;1114
"1050";"360050425003";116;85;194;7;90;492
"1051";"360050425004";279;17;36;0;18;350
"1052";"360050425005";135;134;65;9;51;394
"1053";"360050425006";21;42;44;4;44;155
"1054";"360050425007";352;229;174;9;67;831
"1055";"360050426001";91;45;203;32;40;411
"1056";"360050426002";95;69;527;69;27;787
"1057";"360050426003";19;10;87;39;11;166
"1058";"360050426004";21;13;65;31;18;148
"1059";"360050426005";11;9;89;20;13;142
"1060";"360050426006";50;17;91;10;20;188
"1061";"360050428001";28;17;64;47;25;181
"1062";"360050428002";61;11;134;34;18;258
"1063";"360050429011";198;94;290;10;55;647
"1064";"360050429012";120;22;274;5;36;457
"1065";"360050429013";182;71;33;3;20;309
"1066";"360050429021";315;584;229;5;77;1210
"1067";"360050429022";14;20;102;10;19;165
"1068";"360050429023";72;14;60;1;14;161
"1069";"360050430001";60;25;102;65;19;271
"1070";"360050430002";26;19;79;18;19;161
"1071";"360050430003";17;14;145;12;12;200
"1072";"360050431001";419;101;30;0;17;567
"1073";"360050431002";96;118;161;2;262;639
"1074";"360050431003";76;52;21;2;17;168
"1075";"360050431004";278;206;45;7;49;585
"1076";"360050431005";517;501;87;10;85;1200
"1077";"360050431006";112;98;29;1;48;288
"1078";"360050431007";138;38;27;2;37;242
"1079";"360050431008";113;182;67;5;43;410
"1080";"360050434001";92;32;153;33;56;366
"1081";"360050434002";33;39;61;4;13;150
"1082";"360050434003";65;169;320;20;32;606
"1083";"360050434004";202;40;81;15;36;374
"1084";"360050435001";745;1432;505;38;626;3346
"1085";"360050436001";163;53;183;14;49;462
"1086";"360050436002";73;49;242;15;16;395
"1087";"360050442001";785;115;33;7;18;958
"1088";"360050442002";150;2;115;30;14;311
"1089";"360050442003";51;10;121;38;7;227
"1090";"360050442004";70;12;163;65;26;336
"1091";"360050442005";18;10;29;16;8;81
"1092";"360050444001";47;55;146;45;48;341
"1093";"360050444002";20;13;43;32;7;115
"1094";"360050444003";97;22;110;22;14;265
"1095";"360050444004";43;9;207;42;34;335
"1096";"360050448001";50;9;78;35;23;195
"1097";"360050448002";36;4;44;19;6;109
"1098";"360050449011";23;10;90;2;12;137
"1099";"360050449012";26;12;197;10;9;254
"1100";"360050449021";57;32;172;19;38;318
"1101";"360050449022";115;53;167;12;57;404
"1102";"360050451011";31;10;299;5;59;404
"1103";"360050451012";32;40;59;16;24;171
"1104";"360050451021";27;9;107;6;22;171
"1105";"360050451022";58;24;165;13;27;287
"1106";"360050456001";97;17;128;22;35;299
"1107";"360050456002";53;52;142;38;26;311
"1108";"360050456003";44;62;41;26;18;191
"1109";"360050458001";126;28;13;31;12;210
"1110";"360050458002";209;47;11;0;14;281
"1111";"360050458003";8;3;10;0;1;22
"1112";"360050458004";264;129;41;7;54;495
"1113";"360050460001";142;32;145;36;16;371
"1114";"360050460002";7;14;41;12;12;86
"1115";"360050462011";69;70;50;14;79;282
"1116";"360050462012";11;50;3;1;23;88
"1117";"360050462013";34;23;66;0;22;145
"1118";"360050462014";186;33;113;3;19;354
"1119";"360050462015";18;10;17;2;6;53
"1120";"360050462016";37;5;16;0;5;63
"1121";"360050462017";254;1;27;0;8;290
"1122";"360050462018";15;7;123;12;9;166
"1123";"360050462019";2;6;6;0;4;18
"1124";"360050462021";206;89;458;59;34;846
"1125";"360050462022";73;17;254;58;35;437
"1126";"360050462023";78;56;161;55;23;373
"1127";"360050462024";13;11;54;39;20;137
"1128";"360050462025";47;25;69;25;21;187
"1129";"360050462026";53;9;28;29;3;122
"1130";"360050484001";89;19;87;12;12;219
"1131";"360050484002";88;224;232;101;72;717
"1132";"360050484003";7;14;31;21;10;83
"1133";"360050484004";81;34;190;27;41;373
"1134";"360050504001";7;47;19;4;129;206
"1135";"360050516000";0;3;1;0;0;4
"1136";"360050516001";174;69;212;26;111;592
"1137";"360050516002";27;26;126;9;24;212
"1138";"360050516003";49;93;158;16;119;435
"1139";"360050516004";24;48;191;11;52;326
"1140";"360050516005";0;1;0;0;1;2
"1141";"360470001001";45;55;118;5;162;385
"1142";"360470001002";34;24;65;0;22;145
"1143";"360470001003";92;346;56;4;19;517
"1144";"360470001004";14;43;31;3;19;110
"1145";"360470002001";141;268;293;53;209;964
"1146";"360470003011";20;5;46;0;5;76
"1147";"360470003012";10;17;20;0;9;56
"1148";"360470003013";38;39;24;2;34;137
"1149";"360470003014";11;142;78;0;57;288
"1150";"360470003015";15;36;52;0;17;120
"1151";"360470005011";27;45;141;4;37;254
"1152";"360470005012";8;9;7;0;13;37
"1153";"360470005013";18;8;29;2;29;86
"1154";"360470005021";22;41;47;0;19;129
"1155";"360470005022";40;26;148;2;23;239
"1156";"360470007001";59;61;267;12;119;518
"1157";"360470007002";20;7;89;2;12;130
"1158";"360470007003";62;21;67;2;40;192
"1159";"360470009001";56;223;110;9;104;502
"1160";"360470009002";75;26;82;5;35;223
"1161";"360470011001";27;108;319;9;307;770
"1162";"360470013001";37;85;356;2;88;568
"1163";"360470013002";2;3;53;0;1;59
"1164";"360470015001";141;173;276;6;60;656
"1165";"360470015002";282;88;40;0;55;465
"1166";"360470015003";153;467;528;6;203;1357
"1167";"360470018001";59;194;460;93;230;1036
"1168";"360470020001";38;43;118;10;40;249
"1169";"360470020002";53;39;123;7;27;249
"1170";"360470021001";62;446;892;9;124;1533
"1171";"360470021002";55;28;324;9;128;544
"1172";"360470021003";82;220;364;13;81;760
"1173";"360470022001";81;41;281;13;65;481
"1174";"360470022002";45;28;142;24;49;288
"1175";"360470022003";83;54;159;16;82;394
"1176";"360470023001";69;52;16;1;12;150
"1177";"360470023002";1765;47;23;0;20;1855
"1178";"360470023003";1490;43;70;3;37;1643
"1179";"360470029011";252;35;47;1;15;350
"1180";"360470029012";42;55;1149;4;36;1286
"1181";"360470030001";23;24;129;12;31;219
"1182";"360470030002";35;3;36;0;13;87
"1183";"360470031001";40;158;86;4;62;350
"1184";"360470031002";5;9;17;0;14;45
"1185";"360470031003";10;93;30;0;76;209
"1186";"360470033001";29;90;83;0;62;264
"1187";"360470033002";324;262;255;8;160;1009
"1188";"360470034001";49;195;120;8;220;592
"1189";"360470034002";18;23;203;11;50;305
"1190";"360470034003";79;5;231;3;25;343
"1191";"360470035001";30;177;131;10;89;437
"1192";"360470035002";38;106;60;5;19;228
"1193";"360470036001";29;9;199;3;19;259
"1194";"360470036002";93;30;410;1;25;559
"1195";"360470036003";37;15;198;8;21;279
"1196";"360470037001";177;195;1114;8;180;1674
"1197";"360470038001";55;65;418;10;115;663
"1198";"360470039001";83;84;453;8;76;704
"1199";"360470039002";327;107;119;17;46;616
"1200";"360470039003";25;60;156;11;83;335
"1201";"360470041001";48;93;529;8;81;759
"1202";"360470041002";17;14;97;10;21;159
"1203";"360470041003";19;9;121;6;21;176
"1204";"360470043001";1;1;6;0;0;8
"1205";"360470043002";30;31;205;4;17;287
"1206";"360470043003";13;21;107;4;37;182
"1207";"360470043004";77;76;101;17;66;337
"1208";"360470044001";6;29;188;8;113;344
"1209";"360470044002";29;18;110;6;25;188
"1210";"360470045001";56;141;193;9;39;438
"1211";"360470045002";18;19;51;1;24;113
"1212";"360470045003";4;8;23;7;14;56
"1213";"360470045004";11;22;125;1;10;169
"1214";"360470046001";25;48;113;18;84;288
"1215";"360470047001";92;98;264;8;50;512
"1216";"360470049001";31;13;187;1;16;248
"1217";"360470049002";5;7;26;2;7;47
"1218";"360470049003";14;9;30;0;5;58
"1219";"360470050001";14;11;47;3;23;98
"1220";"360470050002";25;6;97;5;14;147
"1221";"360470050003";50;16;134;3;13;216
"1222";"360470051001";5;18;93;2;15;133
"1223";"360470051002";17;7;103;5;15;147
"1224";"360470051003";16;26;117;3;11;173
"1225";"360470052011";26;17;101;4;29;177
"1226";"360470052021";42;3;29;3;5;82
"1227";"360470052022";30;13;144;9;26;222
"1228";"360470053000";0;0;0;0;2;2
"1229";"360470053001";92;153;350;31;237;863
"1230";"360470053002";49;84;125;11;33;302
"1231";"360470053003";114;49;80;8;31;282
"1232";"360470053004";15;34;79;21;27;176
"1233";"360470054001";133;19;71;2;34;259
"1234";"360470054002";26;59;43;2;18;148
"1235";"360470054003";75;7;71;8;34;195
"1236";"360470056011";53;30;135;7;92;317
"1237";"360470056012";86;47;225;6;58;422
"1238";"360470056021";87;147;366;6;96;702
"1239";"360470058001";33;61;138;9;34;275
"1240";"360470058002";104;56;230;11;66;467
"1241";"360470058003";116;6;31;1;7;161
"1242";"360470059001";209;224;73;6;66;578
"1243";"360470059002";45;68;309;94;47;563
"1244";"360470060001";67;170;104;8;81;430
"1245";"360470060002";37;33;153;9;51;283
"1246";"360470060003";61;25;66;3;27;182
"1247";"360470062001";130;29;110;4;27;300
"1248";"360470062002";62;89;40;1;50;242
"1249";"360470062003";73;258;78;3;38;450
"1250";"360470063001";20;14;59;2;26;121
"1251";"360470063002";13;7;105;0;10;135
"1252";"360470064001";72;25;90;5;68;260
"1253";"360470064002";34;22;94;3;49;202
"1254";"360470064003";21;35;79;2;39;176
"1255";"360470065001";35;8;43;6;18;110
"1256";"360470065002";14;7;22;0;13;56
"1257";"360470065003";30;10;83;2;12;137
"1258";"360470065004";9;1;71;1;7;89
"1259";"360470065005";7;8;59;0;8;82
"1260";"360470065006";90;54;52;3;24;223
"1261";"360470065007";18;26;36;3;19;102
"1262";"360470066001";63;70;176;10;63;382
"1263";"360470066002";55;32;99;2;60;248
"1264";"360470066003";132;104;200;5;67;508
"1265";"360470067001";4;18;70;4;12;108
"1266";"360470067002";1;9;39;0;8;57
"1267";"360470067003";8;12;25;0;13;58
"1268";"360470067004";22;11;43;6;1;83
"1269";"360470067005";18;3;67;1;4;93
"1270";"360470068001";78;41;55;1;41;216
"1271";"360470068002";110;26;137;9;34;316
"1272";"360470068003";11;13;148;1;25;198
"1273";"360470068004";40;23;166;3;31;263
"1274";"360470069001";23;86;46;4;35;194
"1275";"360470069002";36;45;58;3;56;198
"1276";"360470069003";15;24;54;8;37;138
"1277";"360470069004";34;19;68;13;21;155
"1278";"360470070001";35;10;321;7;74;447
"1279";"360470070002";73;33;94;3;27;230
"1280";"360470071001";24;12;41;5;9;91
"1281";"360470071002";84;62;90;14;15;265
"1282";"360470071003";124;78;11;1;11;225
"1283";"360470071004";116;116;9;0;27;268
"1284";"360470072001";96;47;247;11;69;470
"1285";"360470074001";78;41;229;7;80;435
"1286";"360470074002";81;27;40;6;84;238
"1287";"360470074003";50;64;82;5;36;237
"1288";"360470074004";30;43;33;3;26;135
"1289";"360470075001";65;37;80;15;23;220
"1290";"360470075002";20;101;33;2;22;178
"1291";"360470075003";20;31;124;3;40;218
"1292";"360470075004";13;24;51;8;19;115
"1293";"360470075005";29;47;37;2;28;143
"1294";"360470076001";72;28;49;5;77;231
"1295";"360470076002";62;17;28;12;57;176
"1296";"360470076003";80;35;100;4;55;274
"1297";"360470077001";27;27;80;2;38;174
"1298";"360470077002";12;20;304;11;40;387
"1299";"360470077003";29;102;100;7;54;292
"1300";"360470077004";25;25;43;3;75;171
"1301";"360470078001";82;66;148;8;60;364
"1302";"360470078002";142;59;28;0;96;325
"1303";"360470078003";56;27;64;4;66;217
"1304";"360470078004";20;22;71;8;43;164
"1305";"360470080001";121;73;50;4;79;327
"1306";"360470080002";89;56;23;2;54;224
"1307";"360470080003";40;16;47;6;34;143
"1308";"360470082001";77;59;178;4;73;391
"1309";"360470082002";46;195;147;1;122;511
"1310";"360470082003";62;23;149;12;38;284
"1311";"360470084001";7;39;88;6;36;176
"1312";"360470084002";127;71;55;14;42;309
"1313";"360470084003";25;32;85;15;85;242
"1314";"360470085001";167;107;13;2;38;327
"1315";"360470085002";244;121;12;2;41;420
"1316";"360470085003";416;109;110;2;43;680
"1317";"360470086001";12;61;14;0;96;183
"1318";"360470088001";84;120;139;13;68;424
"1319";"360470088002";73;73;86;5;24;261
"1320";"360470090001";41;33;205;7;22;308
"1321";"360470090002";53;31;152;6;27;269
"1322";"360470092001";268;256;54;3;38;619
"1323";"360470092002";193;194;249;0;61;697
"1324";"360470092003";117;43;48;1;39;248
"1325";"360470094001";55;21;50;2;38;166
"1326";"360470094002";382;23;179;5;121;710
"1327";"360470094003";43;53;35;1;56;188
"1328";"360470096001";119;195;36;4;22;376
"1329";"360470096002";68;26;50;4;31;179
"1330";"360470096003";84;78;97;2;33;294
"1331";"360470096004";109;59;114;3;42;327
"1332";"360470098001";80;73;129;4;36;322
"1333";"360470098002";40;39;142;7;44;272
"1334";"360470098003";53;44;44;2;34;177
"1335";"360470098004";45;66;155;3;46;315
"1336";"360470100001";17;36;388;6;36;483
"1337";"360470100002";38;13;51;4;34;140
"1338";"360470100003";52;77;9;1;47;186
"1339";"360470100004";70;77;43;0;66;256
"1340";"360470101001";36;146;261;40;68;551
"1341";"360470101002";65;51;226;17;48;407
"1342";"360470101003";79;146;253;33;42;553
"1343";"360470102001";46;29;90;3;52;220
"1344";"360470102002";31;40;80;4;32;187
"1345";"360470102003";114;46;47;3;45;255
"1346";"360470104001";94;25;217;3;59;398
"1347";"360470104002";62;37;117;9;39;264
"1348";"360470104003";11;11;90;0;63;175
"1349";"360470106001";19;10;162;5;41;237
"1350";"360470106002";23;11;112;1;51;198
"1351";"360470106003";41;11;122;1;30;205
"1352";"360470108001";42;11;136;1;34;224
"1353";"360470108002";23;9;79;2;24;137
"1354";"360470108003";11;16;153;1;38;219
"1355";"360470110001";53;70;289;15;54;481
"1356";"360470110002";129;65;538;21;44;797
"1357";"360470112001";88;69;189;2;57;405
"1358";"360470112002";28;17;43;0;44;132
"1359";"360470112003";46;7;71;0;17;141
"1360";"360470112004";45;32;44;1;37;159
"1361";"360470114001";19;21;225;2;44;311
"1362";"360470114002";11;9;97;1;24;142
"1363";"360470114003";36;6;179;0;84;305
"1364";"360470116001";13;8;96;2;23;142
"1365";"360470116002";36;17;117;3;27;200
"1366";"360470116003";29;20;118;1;10;178
"1367";"360470117001";41;31;158;14;44;288
"1368";"360470117002";22;27;105;6;20;180
"1369";"360470117003";84;169;140;7;60;460
"1370";"360470118001";37;14;132;15;54;252
"1371";"360470118002";10;16;101;9;50;186
"1372";"360470119001";47;107;396;8;92;650
"1373";"360470119002";26;135;321;9;78;569
"1374";"360470119003";47;63;330;8;64;512
"1375";"360470120001";105;76;238;12;84;515
"1376";"360470121001";41;38;213;4;55;351
"1377";"360470121002";36;59;124;9;57;285
"1378";"360470122001";130;139;83;6;63;421
"1379";"360470122002";264;282;108;0;69;723
"1380";"360470122003";97;57;241;4;72;471
"1381";"360470126001";50;27;247;12;72;408
"1382";"360470126002";33;138;138;10;79;398
"1383";"360470126003";7;5;93;6;8;119
"1384";"360470127001";104;114;85;17;84;404
"1385";"360470127002";160;331;116;11;88;706
"1386";"360470127003";73;37;8;1;22;141
"1387";"360470128011";33;30;109;6;55;233
"1388";"360470129011";64;59;174;3;126;426
"1389";"360470129012";92;88;81;3;47;311
"1390";"360470129013";21;48;123;2;43;237
"1391";"360470129021";12;57;210;2;71;352
"1392";"360470129022";56;146;134;4;45;385
"1393";"360470129023";12;17;70;2;29;130
"1394";"360470130001";34;63;96;6;59;258
"1395";"360470130002";52;10;99;7;17;185
"1396";"360470130003";52;24;246;4;62;388
"1397";"360470130004";82;27;276;6;37;428
"1398";"360470131001";364;261;41;0;36;702
"1399";"360470131002";28;47;82;2;26;185
"1400";"360470131003";31;160;49;1;59;300
"1401";"360470131004";138;110;56;3;37;344
"1402";"360470132001";45;13;43;6;10;117
"1403";"360470132002";19;16;131;0;58;224
"1404";"360470133001";37;88;46;5;37;213
"1405";"360470133002";21;30;55;3;24;133
"1406";"360470133003";27;89;52;5;41;214
"1407";"360470133004";10;12;60;2;8;92
"1408";"360470134001";25;4;467;13;32;541
"1409";"360470134002";62;12;108;10;37;229
"1410";"360470134003";44;18;148;10;38;258
"1411";"360470135001";16;11;101;1;22;151
"1412";"360470135002";17;96;139;3;79;334
"1413";"360470135003";27;30;232;3;51;343
"1414";"360470136001";57;11;159;0;71;298
"1415";"360470136002";18;26;102;5;38;189
"1416";"360470136003";35;53;55;0;30;173
"1417";"360470136004";79;20;174;10;31;314
"1418";"360470137001";21;104;29;4;30;188
"1419";"360470137002";16;17;90;1;24;148
"1420";"360470137003";30;43;166;11;107;357
"1421";"360470138001";62;127;115;7;46;357
"1422";"360470138002";42;7;53;3;27;132
"1423";"360470138003";19;20;54;0;39;132
"1424";"360470139001";11;11;119;1;25;167
"1425";"360470139002";34;29;59;3;15;140
"1426";"360470139003";12;17;20;2;21;72
"1427";"360470139004";29;17;14;3;38;101
"1428";"360470140001";23;16;213;10;24;286
"1429";"360470140002";21;11;136;7;41;216
"1430";"360470141001";34;39;79;2;30;184
"1431";"360470141002";21;38;115;8;42;224
"1432";"360470141003";54;67;109;3;55;288
"1433";"360470142001";45;18;71;5;32;171
"1434";"360470142002";24;37;91;0;41;193
"1435";"360470142003";75;125;96;0;87;383
"1436";"360470143001";69;63;85;14;125;356
"1437";"360470143002";39;92;145;19;60;355
"1438";"360470143003";60;114;87;3;42;306
"1439";"360470145001";65;83;135;5;55;343
"1440";"360470145002";107;52;114;15;24;312
"1441";"360470145003";51;57;105;11;38;262
"1442";"360470145004";79;42;95;6;36;258
"1443";"360470147001";22;26;68;6;18;140
"1444";"360470147002";71;31;168;2;30;302
"1445";"360470148001";1;1;34;3;10;49
"1446";"360470148002";32;7;65;12;26;142
"1447";"360470149001";14;26;54;0;18;112
"1448";"360470149002";19;23;64;3;28;137
"1449";"360470149003";9;8;39;0;15;71
"1450";"360470149004";28;13;43;10;49;143
"1451";"360470149005";30;7;102;2;19;160
"1452";"360470150001";6;4;42;1;31;84
"1453";"360470150002";12;17;78;7;44;158
"1454";"360470151001";17;21;100;1;32;171
"1455";"360470151002";31;34;56;2;18;141
"1456";"360470151003";43;23;67;9;29;171
"1457";"360470151004";6;2;35;3;28;74
"1458";"360470152001";9;3;111;9;12;144
"1459";"360470152002";15;41;172;8;23;259
"1460";"360470152003";35;2;136;22;24;219
"1461";"360470153001";3;13;151;1;14;182
"1462";"360470153002";12;23;60;6;28;129
"1463";"360470153003";23;19;70;6;18;136
"1464";"360470153004";7;6;72;0;7;92
"1465";"360470154001";17;75;66;10;127;295
"1466";"360470155001";4;23;67;1;11;106
"1467";"360470155002";21;8;44;3;6;82
"1468";"360470155003";21;15;65;5;15;121
"1469";"360470155004";7;7;63;3;8;88
"1470";"360470157001";12;15;73;4;33;137
"1471";"360470157002";43;24;28;2;23;120
"1472";"360470157003";9;22;63;1;20;115
"1473";"360470157004";10;23;50;5;19;107
"1474";"360470159001";23;68;159;9;75;334
"1475";"360470159002";13;14;28;1;12;68
"1476";"360470159003";24;14;47;4;12;101
"1477";"360470159004";29;15;29;1;37;111
"1478";"360470159005";21;29;53;2;13;118
"1479";"360470160001";41;8;127;9;14;199
"1480";"360470160002";51;10;66;9;32;168
"1481";"360470160003";60;23;76;2;35;196
"1482";"360470160004";39;115;107;16;101;378
"1483";"360470161001";115;268;429;5;72;889
"1484";"360470161002";22;15;203;6;12;258
"1485";"360470161003";91;71;113;20;73;368
"1486";"360470162001";17;8;76;0;24;125
"1487";"360470162002";16;9;341;6;46;418
"1488";"360470163001";202;103;409;9;52;775
"1489";"360470163002";54;55;494;2;25;630
"1490";"360470163003";165;36;742;0;39;982
"1491";"360470164001";30;11;20;1;22;84
"1492";"360470165001";10;14;79;6;13;122
"1493";"360470165002";27;23;38;3;12;103
"1494";"360470165003";14;20;85;10;20;149
"1495";"360470165004";10;10;249;2;18;289
"1496";"360470166001";15;10;67;3;26;121
"1497";"360470166002";63;6;42;5;19;135
"1498";"360470167001";13;5;282;0;7;307
"1499";"360470167002";12;56;75;7;23;173
"1500";"360470167003";23;37;99;2;23;184
"1501";"360470167004";72;48;246;8;65;439
"1502";"360470168001";26;6;187;8;41;268
"1503";"360470169001";2;25;20;4;27;78
"1504";"360470169002";29;11;82;1;32;155
"1505";"360470169003";22;60;56;6;12;156
"1506";"360470169004";58;29;58;1;25;171
"1507";"360470169005";15;9;48;0;24;96
"1508";"360470170001";6;8;34;4;23;75
"1509";"360470170002";11;38;184;7;73;313
"1510";"360470170003";45;19;119;1;26;210
"1511";"360470171001";9;11;63;2;10;95
"1512";"360470171002";4;16;25;2;15;62
"1513";"360470171003";11;9;27;2;15;64
"1514";"360470171004";5;3;43;2;9;62
"1515";"360470172001";38;23;102;11;36;210
"1516";"360470172002";27;6;81;3;20;137
"1517";"360470174001";31;10;245;16;33;335
"1518";"360470174002";30;11;143;0;17;201
"1519";"360470175001";3;17;44;2;11;77
"1520";"360470176001";4;3;52;4;31;94
"1521";"360470176002";40;17;323;7;32;419
"1522";"360470177001";110;690;208;26;548;1582
"1523";"360470178001";49;27;67;11;68;222
"1524";"360470178002";69;28;304;17;24;442
"1525";"360470179001";7;5;10;1;7;30
"1526";"360470179002";180;50;257;4;59;550
"1527";"360470179003";19;21;75;0;15;130
"1528";"360470180001";35;3;75;14;35;162
"1529";"360470180002";60;20;85;5;20;190
"1530";"360470181001";73;33;97;5;36;244
"1531";"360470181002";33;33;63;0;10;139
"1532";"360470181003";65;63;74;5;35;242
"1533";"360470181004";21;21;99;0;12;153
"1534";"360470182001";59;15;92;1;27;194
"1535";"360470182002";30;16;138;4;34;222
"1536";"360470183001";24;146;136;1;69;376
"1537";"360470183002";70;121;42;0;13;246
"1538";"360470183003";96;51;39;2;42;230
"1539";"360470184001";14;3;69;4;7;97
"1540";"360470184002";25;3;76;2;30;136
"1541";"360470185011";22;33;19;1;12;87
"1542";"360470185012";46;35;50;7;7;145
"1543";"360470185013";126;86;316;3;15;546
"1544";"360470185014";51;40;19;3;13;126
"1545";"360470186001";23;6;106;0;20;155
"1546";"360470186002";80;5;57;1;25;168
"1547";"360470187001";70;149;162;7;46;434
"1548";"360470188001";25;13;104;6;28;176
"1549";"360470188002";91;16;203;2;32;344
"1550";"360470190001";96;7;178;2;33;316
"1551";"360470190002";81;11;94;14;34;234
"1552";"360470190003";36;890;292;21;20;1259
"1553";"360470191001";247;156;221;37;70;731
"1554";"360470191002";36;40;61;5;22;164
"1555";"360470191003";63;107;114;6;55;345
"1556";"360470192001";7;5;50;10;30;102
"1557";"360470192002";14;21;276;24;47;382
"1558";"360470193001";106;44;86;6;32;274
"1559";"360470193002";56;154;105;0;23;338
"1560";"360470193003";8;11;13;0;10;42
"1561";"360470193004";25;56;15;1;39;136
"1562";"360470194001";90;108;160;9;38;405
"1563";"360470194002";39;13;160;15;17;244
"1564";"360470194003";21;18;126;10;17;192
"1565";"360470195001";33;13;59;2;36;143
"1566";"360470195002";62;19;69;4;16;170
"1567";"360470195003";11;12;20;6;9;58
"1568";"360470195004";21;32;31;2;31;117
"1569";"360470196001";95;6;94;1;36;232
"1570";"360470196002";9;31;72;8;76;196
"1571";"360470196003";61;16;143;5;24;249
"1572";"360470197001";4;5;62;0;9;80
"1573";"360470197002";38;47;60;6;20;171
"1574";"360470197003";38;27;89;3;37;194
"1575";"360470197004";24;33;43;3;27;130
"1576";"360470198001";10;3;26;9;13;61
"1577";"360470198002";30;8;95;3;35;171
"1578";"360470199001";28;27;38;3;21;117
"1579";"360470199002";73;259;161;1;26;520
"1580";"360470199003";133;273;242;6;82;736
"1581";"360470199004";52;20;43;1;11;127
"1582";"360470200001";54;8;100;4;29;195
"1583";"360470200002";7;2;204;5;36;254
"1584";"360470201001";44;105;43;7;24;223
"1585";"360470201002";48;193;102;3;33;379
"1586";"360470201003";26;22;47;4;46;145
"1587";"360470201004";78;29;64;2;19;192
"1588";"360470202001";16;1;105;1;24;147
"1589";"360470202002";6;3;111;1;22;143
"1590";"360470203001";135;409;349;78;61;1032
"1591";"360470203002";63;90;256;12;32;453
"1592";"360470204001";24;1;199;5;30;259
"1593";"360470204002";24;6;87;0;24;141
"1594";"360470205001";75;141;333;23;54;626
"1595";"360470205002";60;209;187;4;27;487
"1596";"360470205003";30;59;366;4;27;486
"1597";"360470206001";29;7;73;5;19;133
"1598";"360470206002";41;6;262;17;49;375
"1599";"360470207001";149;140;217;8;67;581
"1600";"360470207002";181;109;219;12;74;595
"1601";"360470207003";23;14;141;2;23;203
"1602";"360470208001";11;0;124;2;14;151
"1603";"360470208002";46;3;123;3;22;197
"1604";"360470208003";17;10;144;3;30;204
"1605";"360470210001";59;6;205;4;151;425
"1606";"360470210002";14;5;173;1;33;226
"1607";"360470210003";63;9;23;4;33;132
"1608";"360470211001";32;65;35;3;20;155
"1609";"360470211002";91;109;563;11;51;825
"1610";"360470212001";20;11;59;4;27;121
"1611";"360470212002";37;6;68;6;29;146
"1612";"360470212003";13;24;54;3;33;127
"1613";"360470213001";63;257;43;9;65;437
"1614";"360470213002";294;138;60;8;44;544
"1615";"360470213003";94;32;67;14;18;225
"1616";"360470214001";32;19;59;10;19;139
"1617";"360470214002";11;47;58;6;44;166
"1618";"360470215001";172;366;296;5;68;907
"1619";"360470215002";158;173;156;4;38;529
"1620";"360470215003";126;74;45;10;40;295
"1621";"360470215004";62;205;50;12;85;414
"1622";"360470216001";3;2;66;0;8;79
"1623";"360470216002";9;2;42;2;15;70
"1624";"360470216003";14;29;69;1;21;134
"1625";"360470217001";211;143;117;10;44;525
"1626";"360470217002";334;508;174;20;105;1141
"1627";"360470218001";5;15;30;14;54;118
"1628";"360470218002";3;1;19;7;6;36
"1629";"360470218003";6;4;83;18;18;129
"1630";"360470219001";70;59;58;3;47;237
"1631";"360470219002";89;26;77;1;41;234
"1632";"360470219003";95;83;153;27;71;429
"1633";"360470220001";9;2;22;0;26;59
"1634";"360470220002";37;14;39;5;48;143
"1635";"360470220003";9;9;40;0;9;67
"1636";"360470220004";4;11;62;1;19;97
"1637";"360470221001";111;44;80;4;64;303
"1638";"360470221002";283;174;298;10;182;947
"1639";"360470221003";30;28;104;2;82;246
"1640";"360470222001";11;9;28;0;18;66
"1641";"360470222002";18;10;215;9;23;275
"1642";"360470222003";37;91;143;14;57;342
"1643";"360470224001";2;12;64;2;23;103
"1644";"360470224002";6;7;29;1;20;63
"1645";"360470224003";23;14;89;3;29;158
"1646";"360470224004";27;266;376;10;39;718
"1647";"360470226001";33;35;185;16;102;371
"1648";"360470226002";33;36;181;14;49;313
"1649";"360470227001";272;49;73;14;62;470
"1650";"360470227002";83;86;58;12;106;345
"1651";"360470227003";166;185;241;27;59;678
"1652";"360470227004";88;138;80;4;47;357
"1653";"360470228001";29;20;76;4;22;151
"1654";"360470228002";10;32;60;18;25;145
"1655";"360470228003";4;11;69;12;19;115
"1656";"360470229001";78;108;78;18;45;327
"1657";"360470229002";36;18;81;6;15;156
"1658";"360470229003";39;32;65;5;27;168
"1659";"360470229004";111;25;38;10;31;215
"1660";"360470230001";16;5;38;3;7;69
"1661";"360470230002";0;4;30;1;14;49
"1662";"360470230003";22;6;48;14;38;128
"1663";"360470231001";102;156;43;1;29;331
"1664";"360470231002";118;78;249;14;70;529
"1665";"360470231003";67;90;89;2;20;268
"1666";"360470232001";1;12;181;2;21;217
"1667";"360470232002";29;5;38;1;18;91
"1668";"360470232003";19;23;23;2;19;86
"1669";"360470232004";7;1;15;1;17;41
"1670";"360470232005";19;25;38;6;24;112
"1671";"360470233001";136;63;59;10;37;305
"1672";"360470233002";731;38;33;2;63;867
"1673";"360470233003";142;138;195;34;94;603
"1674";"360470234001";4;5;24;0;24;57
"1675";"360470234002";13;19;29;7;23;91
"1676";"360470234003";15;8;48;2;22;95
"1677";"360470235001";228;200;171;10;106;715
"1678";"360470235002";68;30;90;36;99;323
"1679";"360470236001";2;2;17;0;21;42
"1680";"360470236002";27;33;29;7;11;107
"1681";"360470236003";5;12;29;1;11;58
"1682";"360470236004";18;4;43;0;38;103
"1683";"360470238001";8;1;28;0;14;51
"1684";"360470238002";6;21;62;1;28;118
"1685";"360470238003";9;20;36;5;34;104
"1686";"360470240001";11;3;26;0;15;55
"1687";"360470240002";7;1;89;8;25;130
"1688";"360470240003";8;8;30;4;16;66
"1689";"360470241001";196;251;1077;15;258;1797
"1690";"360470241002";183;54;94;10;51;392
"1691";"360470242001";9;8;78;54;45;194
"1692";"360470242002";22;4;76;5;20;127
"1693";"360470243001";162;85;69;1;129;446
"1694";"360470243002";183;55;121;8;123;490
"1695";"360470243003";134;194;138;12;55;533
"1696";"360470244001";26;4;68;7;15;120
"1697";"360470244002";19;10;94;19;27;169
"1698";"360470244003";19;8;69;14;40;150
"1699";"360470245001";50;65;143;28;52;338
"1700";"360470245002";135;60;116;7;53;371
"1701";"360470245003";57;96;29;1;8;191
"1702";"360470245004";23;35;41;5;60;164
"1703";"360470246001";7;7;122;5;22;163
"1704";"360470246002";85;40;104;8;8;245
"1705";"360470246003";35;27;76;0;27;165
"1706";"360470247001";108;220;70;16;130;544
"1707";"360470247002";100;136;112;17;153;518
"1708";"360470248001";11;9;75;9;32;136
"1709";"360470248002";166;62;303;52;49;632
"1710";"360470249001";168;136;21;30;40;395
"1711";"360470249002";70;27;32;4;27;160
"1712";"360470249003";71;192;29;3;73;368
"1713";"360470249004";47;199;8;2;76;332
"1714";"360470250001";49;18;159;46;51;323
"1715";"360470250002";17;438;62;6;26;549
"1716";"360470251001";74;156;107;29;34;400
"1717";"360470251002";138;134;68;4;21;365
"1718";"360470251003";130;122;117;15;30;414
"1719";"360470252001";32;6;53;6;19;116
"1720";"360470252002";63;5;175;8;32;283
"1721";"360470252003";12;9;335;16;24;396
"1722";"360470252004";119;14;144;23;41;341
"1723";"360470253001";119;44;74;8;61;306
"1724";"360470253002";230;45;36;1;26;338
"1725";"360470253003";111;251;76;12;29;479
"1726";"360470254001";18;2;25;7;8;60
"1727";"360470254002";23;12;153;5;26;219
"1728";"360470254003";27;14;357;12;43;453
"1729";"360470255001";254;75;12;7;23;371
"1730";"360470255002";397;151;15;3;55;621
"1731";"360470256001";21;10;173;3;37;244
"1732";"360470256002";21;4;87;10;29;151
"1733";"360470257001";120;62;160;4;43;389
"1734";"360470257002";28;53;83;17;41;222
"1735";"360470257003";43;92;94;21;69;319
"1736";"360470258001";51;15;394;5;30;495
"1737";"360470258002";12;26;217;0;18;273
"1738";"360470258003";200;14;121;1;24;360
"1739";"360470259011";254;307;398;8;92;1059
"1740";"360470259021";174;94;124;3;31;426
"1741";"360470260001";35;9;74;5;12;135
"1742";"360470260002";5;7;59;1;13;85
"1743";"360470260003";164;42;138;15;61;420
"1744";"360470261001";155;99;172;6;46;478
"1745";"360470261002";74;87;56;15;24;256
"1746";"360470261003";174;293;112;52;50;681
"1747";"360470261004";129;132;214;22;51;548
"1748";"360470261005";134;68;130;6;37;375
"1749";"360470262001";26;42;150;8;31;257
"1750";"360470262002";18;96;216;5;58;393
"1751";"360470263001";478;139;305;21;95;1038
"1752";"360470264001";34;6;107;1;16;164
"1753";"360470264002";54;7;141;10;21;233
"1754";"360470264003";51;16;262;8;65;402
"1755";"360470264004";26;21;31;3;25;106
"1756";"360470265001";273;67;113;25;46;524
"1757";"360470265002";174;371;101;16;36;698
"1758";"360470265003";134;172;184;76;26;592
"1759";"360470265004";103;155;176;130;35;599
"1760";"360470266001";12;3;143;4;26;188
"1761";"360470266002";25;8;201;3;23;260
"1762";"360470266003";49;8;85;2;25;169
"1763";"360470267001";69;88;38;4;19;218
"1764";"360470267002";85;97;64;2;27;275
"1765";"360470267003";82;372;47;4;45;550
"1766";"360470267004";164;553;70;6;40;833
"1767";"360470268001";33;3;29;1;13;79
"1768";"360470268002";20;1;33;0;26;80
"1769";"360470268003";27;0;360;2;23;412
"1770";"360470268004";29;42;33;6;16;126
"1771";"360470269001";80;155;71;3;27;336
"1772";"360470269002";38;109;80;7;39;273
"1773";"360470269003";181;188;99;7;57;532
"1774";"360470270001";31;16;66;12;17;142
"1775";"360470270002";24;7;121;3;15;170
"1776";"360470271001";248;245;593;55;84;1225
"1777";"360470271002";69;15;166;13;36;299
"1778";"360470272001";21;5;68;0;6;100
"1779";"360470272002";39;22;95;7;20;183
"1780";"360470272003";633;6;131;2;17;789
"1781";"360470273001";30;49;78;0;14;171
"1782";"360470273002";83;21;45;8;23;180
"1783";"360470273003";83;130;121;7;57;398
"1784";"360470274001";6;3;154;3;19;185
"1785";"360470274002";47;24;134;8;33;246
"1786";"360470275001";84;65;57;2;28;236
"1787";"360470275002";154;81;90;12;111;448
"1788";"360470275003";129;125;212;7;19;492
"1789";"360470275004";50;48;49;4;30;181
"1790";"360470276001";42;21;208;4;20;295
"1791";"360470276002";66;2;82;6;17;173
"1792";"360470276003";70;28;524;9;44;675
"1793";"360470277001";274;50;43;13;28;408
"1794";"360470277002";70;27;43;4;18;162
"1795";"360470277003";52;36;20;1;35;144
"1796";"360470277004";251;54;15;19;22;361
"1797";"360470278001";157;42;472;3;40;714
"1798";"360470278002";116;28;156;1;44;345
"1799";"360470279001";139;84;106;6;28;363
"1800";"360470279002";104;51;55;15;18;243
"1801";"360470279003";156;46;77;16;32;327
"1802";"360470279004";155;60;344;16;46;621
"1803";"360470280001";3;8;102;0;7;120
"1804";"360470280002";17;9;143;8;24;201
"1805";"360470281001";51;42;118;3;29;243
"1806";"360470281002";78;133;146;3;28;388
"1807";"360470281003";207;146;267;11;113;744
"1808";"360470282001";48;2;161;0;9;220
"1809";"360470282002";27;18;228;5;18;296
"1810";"360470282003";11;10;71;5;5;102
"1811";"360470283001";155;84;234;9;27;509
"1812";"360470283002";210;55;570;7;39;881
"1813";"360470283003";68;61;121;16;27;293
"1814";"360470284001";201;4;377;3;9;594
"1815";"360470284002";69;8;110;0;34;221
"1816";"360470284003";17;8;48;2;19;94
"1817";"360470285011";51;74;233;6;92;456
"1818";"360470285021";413;87;53;7;43;603
"1819";"360470286001";110;61;9;1;19;200
"1820";"360470286002";27;6;29;2;8;72
"1821";"360470286003";28;12;7;0;4;51
"1822";"360470286004";35;8;129;1;17;190
"1823";"360470286005";21;4;145;2;14;186
"1824";"360470287001";114;344;80;39;130;707
"1825";"360470287002";81;27;53;16;39;216
"1826";"360470287003";96;69;50;14;14;243
"1827";"360470288001";37;4;181;5;12;239
"1828";"360470288002";17;10;50;0;28;105
"1829";"360470288003";32;5;132;3;35;207
"1830";"360470289001";84;197;74;2;65;422
"1831";"360470289002";130;59;180;9;57;435
"1832";"360470289003";140;33;70;5;28;276
"1833";"360470289004";74;32;31;10;11;158
"1834";"360470290001";243;10;88;0;21;362
"1835";"360470290002";492;6;85;0;12;595
"1836";"360470290003";82;5;119;5;41;252
"1837";"360470291001";198;136;97;5;61;497
"1838";"360470291002";234;33;83;2;44;396
"1839";"360470291003";20;51;142;16;16;245
"1840";"360470292001";20;30;114;0;67;231
"1841";"360470292002";48;26;315;3;19;411
"1842";"360470293001";45;43;15;0;21;124
"1843";"360470293002";127;122;45;3;17;314
"1844";"360470293003";70;18;97;1;18;204
"1845";"360470293004";36;17;62;6;20;141
"1846";"360470294001";55;21;119;4;74;273
"1847";"360470295001";477;137;211;12;67;904
"1848";"360470295002";45;151;28;8;36;268
"1849";"360470295003";42;24;110;6;14;196
"1850";"360470295004";41;17;114;2;14;188
"1851";"360470296001";53;1;209;1;10;274
"1852";"360470296002";69;278;221;2;47;617
"1853";"360470296003";49;15;111;7;21;203
"1854";"360470296004";20;9;122;1;14;166
"1855";"360470297001";45;117;138;11;42;353
"1856";"360470297002";107;378;284;15;36;820
"1857";"360470297003";27;24;94;5;28;178
"1858";"360470298001";48;11;238;3;16;316
"1859";"360470298002";17;10;89;3;27;146
"1860";"360470298003";12;4;65;0;27;108
"1861";"360470299001";47;24;90;3;56;220
"1862";"360470299002";50;33;31;20;30;164
"1863";"360470300001";42;55;217;3;48;365
"1864";"360470300002";245;37;218;3;41;544
"1865";"360470301001";127;225;108;48;23;531
"1866";"360470301002";186;25;27;9;17;264
"1867";"360470301003";76;38;100;33;43;290
"1868";"360470302001";36;6;248;4;28;322
"1869";"360470302002";21;5;111;5;25;167
"1870";"360470302003";23;20;184;3;18;248
"1871";"360470303001";167;26;251;15;37;496
"1872";"360470303002";129;54;109;25;29;346
"1873";"360470303003";176;102;238;40;61;617
"1874";"360470304001";6;22;183;14;38;263
"1875";"360470304002";39;4;160;1;37;241
"1876";"360470304003";39;6;103;7;25;180
"1877";"360470305001";226;220;505;77;78;1106
"1878";"360470305002";180;173;97;34;51;535
"1879";"360470305003";66;131;109;2;56;364
"1880";"360470305004";236;188;210;10;138;782
"1881";"360470306001";40;30;159;23;41;293
"1882";"360470307001";177;7;18;1;22;225
"1883";"360470307002";60;31;26;1;16;134
"1884";"360470307003";450;212;408;78;70;1218
"1885";"360470308001";195;78;189;47;78;587
"1886";"360470309001";99;50;141;24;44;358
"1887";"360470309002";113;29;145;9;18;314
"1888";"360470311001";94;40;126;19;45;324
"1889";"360470311002";229;620;153;15;88;1105
"1890";"360470311003";61;284;47;8;46;446
"1891";"360470313001";76;136;239;22;65;538
"1892";"360470313002";42;60;53;5;7;167
"1893";"360470313003";75;38;174;3;22;312
"1894";"360470313004";17;11;213;10;22;273
"1895";"360470314001";15;3;100;5;16;139
"1896";"360470314002";30;75;110;9;55;279
"1897";"360470314003";4;15;5;0;18;42
"1898";"360470314004";98;16;193;6;55;368
"1899";"360470315001";98;88;107;5;59;357
"1900";"360470315002";178;209;53;8;31;479
"1901";"360470315003";140;224;75;5;80;524
"1902";"360470315004";223;133;47;8;76;487
"1903";"360470317011";169;364;161;6;67;767
"1904";"360470317012";99;329;90;2;48;568
"1905";"360470317013";66;55;98;8;34;261
"1906";"360470317021";213;65;23;4;28;333
"1907";"360470317022";84;22;46;11;59;222
"1908";"360470317023";213;65;132;3;41;454
"1909";"360470319001";297;116;136;5;132;686
"1910";"360470319002";49;67;40;5;24;185
"1911";"360470319003";59;41;122;8;32;262
"1912";"360470321001";89;144;118;19;96;466
"1913";"360470321002";95;66;60;2;54;277
"1914";"360470321003";247;90;76;10;49;472
"1915";"360470321004";148;138;92;13;81;472
"1916";"360470323001";161;38;94;30;148;471
"1917";"360470323002";53;29;45;18;21;166
"1918";"360470323003";192;18;144;10;30;394
"1919";"360470325001";82;226;79;3;63;453
"1920";"360470325002";288;118;69;4;40;519
"1921";"360470325003";157;80;86;6;42;371
"1922";"360470326001";103;86;112;21;54;376
"1923";"360470326002";112;71;94;8;59;344
"1924";"360470326003";84;28;20;1;18;151
"1925";"360470326004";70;8;23;4;32;137
"1926";"360470326005";91;65;139;117;29;441
"1927";"360470327001";102;144;56;7;40;349
"1928";"360470327002";128;47;143;15;25;358
"1929";"360470327003";75;116;101;27;79;398
"1930";"360470328001";28;38;32;2;22;122
"1931";"360470328002";16;17;20;12;13;78
"1932";"360470328003";170;70;11;0;44;295
"1933";"360470328004";38;15;39;10;31;133
"1934";"360470329001";221;113;97;11;68;510
"1935";"360470329002";158;49;47;13;27;294
"1936";"360470329003";248;1186;54;6;171;1665
"1937";"360470329004";111;137;33;12;60;353
"1938";"360470330001";106;29;19;0;22;176
"1939";"360470330002";9;7;15;6;17;54
"1940";"360470330003";244;78;16;13;40;391
"1941";"360470331001";59;22;85;16;20;202
"1942";"360470331002";119;222;47;16;64;468
"1943";"360470331003";20;11;34;15;18;98
"1944";"360470333001";86;22;92;11;25;236
"1945";"360470333002";86;15;171;17;36;325
"1946";"360470333003";34;11;33;11;44;133
"1947";"360470335001";50;22;392;3;10;477
"1948";"360470335002";10;10;50;4;24;98
"1949";"360470335003";57;43;131;34;34;299
"1950";"360470336001";21;2;7;1;28;59
"1951";"360470336002";332;7;2;0;20;361
"1952";"360470336003";4;4;6;0;5;19
"1953";"360470336004";6;0;13;2;10;31
"1954";"360470336005";37;69;133;8;41;288
"1955";"360470337001";115;182;91;10;49;447
"1956";"360470337002";68;61;62;20;109;320
"1957";"360470337003";116;41;138;10;47;352
"1958";"360470339001";137;177;120;16;32;482
"1959";"360470339002";61;104;55;16;64;300
"1960";"360470339003";98;277;45;2;41;463
"1961";"360470339004";49;14;27;9;11;110
"1962";"360470340001";195;144;73;12;60;484
"1963";"360470340002";125;28;3;2;24;182
"1964";"360470341001";51;38;49;5;48;191
"1965";"360470341002";230;27;90;3;19;369
"1966";"360470341003";136;31;65;12;37;281
"1967";"360470342001";85;43;46;8;47;229
"1968";"360470342002";295;104;17;4;33;453
"1969";"360470342003";195;80;31;0;87;393
"1970";"360470342004";7;4;3;1;9;24
"1971";"360470343001";254;52;93;9;37;445
"1972";"360470343002";39;20;121;11;36;227
"1973";"360470343003";472;447;277;6;61;1263
"1974";"360470345001";395;216;76;12;33;732
"1975";"360470345002";82;170;165;20;64;501
"1976";"360470347001";112;111;87;9;61;380
"1977";"360470347002";145;108;118;7;74;452
"1978";"360470347003";128;81;83;9;51;352
"1979";"360470348001";30;17;696;101;80;924
"1980";"360470348002";89;82;185;12;80;448
"1981";"360470349001";93;85;41;4;35;258
"1982";"360470349002";39;17;58;14;23;151
"1983";"360470349003";144;192;152;8;58;554
"1984";"360470349004";48;39;44;8;43;182
"1985";"360470350001";3;1;2;0;3;9
"1986";"360470350002";7;36;47;5;53;148
"1987";"360470351001";160;51;67;0;76;354
"1988";"360470351002";81;117;90;1;54;343
"1989";"360470351003";127;140;113;49;48;477
"1990";"360470352001";125;137;91;5;198;556
"1991";"360470353001";373;196;120;3;89;781
"1992";"360470353002";208;108;81;8;51;456
"1993";"360470353003";114;45;136;7;32;334
"1994";"360470354001";16;4;21;6;27;74
"1995";"360470354002";45;10;33;7;36;131
"1996";"360470354003";18;24;9;0;48;99
"1997";"360470355001";309;179;95;23;70;676
"1998";"360470355002";194;77;73;18;57;419
"1999";"360470355003";120;64;140;54;54;432
"2000";"360470356011";11;11;20;0;11;53
"2001";"360470356021";45;12;21;1;20;99
"2002";"360470356022";14;4;28;2;22;70
"2003";"360470356023";28;7;9;3;49;96
"2004";"360470357001";295;231;98;3;96;723
"2005";"360470359001";146;163;437;17;60;823
"2006";"360470359002";199;24;69;16;40;348
"2007";"360470359003";216;121;75;4;67;483
"2008";"360470359004";77;19;31;1;21;149
"2009";"360470360011";41;42;106;0;78;267
"2010";"360470360012";67;12;31;1;90;201
"2011";"360470360013";25;26;53;1;24;129
"2012";"360470360021";68;77;46;0;45;236
"2013";"360470360022";445;57;23;3;56;584
"2014";"360470361001";49;27;147;13;25;261
"2015";"360470361002";25;32;137;19;35;248
"2016";"360470361003";95;43;57;18;23;236
"2017";"360470362001";66;30;132;1;78;307
"2018";"360470362002";161;19;124;2;41;347
"2019";"360470362003";39;11;88;0;57;195
"2020";"360470363001";123;26;50;18;24;241
"2021";"360470363002";318;38;137;33;44;570
"2022";"360470363003";219;52;149;23;34;477
"2023";"360470363004";52;46;73;12;15;198
"2024";"360470364001";38;17;142;2;21;220
"2025";"360470364002";53;15;199;3;20;290
"2026";"360470365011";44;17;200;2;22;285
"2027";"360470365012";36;5;381;36;34;492
"2028";"360470365021";60;88;196;26;38;408
"2029";"360470366001";56;33;81;10;49;229
"2030";"360470366002";31;24;128;5;42;230
"2031";"360470366003";58;15;45;0;13;131
"2032";"360470367001";197;197;161;81;121;757
"2033";"360470367002";5;0;40;47;68;160
"2034";"360470369001";149;22;45;30;41;287
"2035";"360470369002";96;95;152;44;73;460
"2036";"360470369003";154;165;109;24;38;490
"2037";"360470369004";144;40;264;16;49;513
"2038";"360470370001";41;14;114;13;69;251
"2039";"360470370002";15;7;58;3;19;102
"2040";"360470370003";11;26;207;8;43;295
"2041";"360470370004";13;5;71;2;12;103
"2042";"360470371001";57;87;141;8;34;327
"2043";"360470371002";109;41;57;6;19;232
"2044";"360470371003";67;26;297;1;12;403
"2045";"360470371004";54;31;266;11;16;378
"2046";"360470371005";33;97;63;12;30;235
"2047";"360470373001";43;11;49;8;32;143
"2048";"360470373002";130;41;129;12;34;346
"2049";"360470373003";99;171;64;2;33;369
"2050";"360470373004";167;439;50;8;58;722
"2051";"360470374011";82;12;142;8;41;285
"2052";"360470374012";52;37;181;5;27;302
"2053";"360470374013";55;6;79;3;9;152
"2054";"360470374021";35;8;271;11;46;371
"2055";"360470374022";63;24;33;9;4;133
"2056";"360470374023";28;7;14;1;5;55
"2057";"360470374024";31;29;95;4;27;186
"2058";"360470375001";104;57;140;5;17;323
"2059";"360470375002";227;93;152;13;50;535
"2060";"360470375003";63;143;325;4;28;563
"2061";"360470377001";70;53;51;5;37;216
"2062";"360470377002";109;55;58;2;41;265
"2063";"360470377003";134;48;74;3;26;285
"2064";"360470377004";34;32;62;8;32;168
"2065";"360470379001";97;80;38;7;33;255
"2066";"360470379002";157;59;319;17;44;596
"2067";"360470379003";47;67;100;21;37;272
"2068";"360470381001";127;38;68;12;23;268
"2069";"360470381002";206;89;13;4;39;351
"2070";"360470381003";63;106;80;42;40;331
"2071";"360470381004";77;113;61;6;19;276
"2072";"360470382001";30;8;416;5;24;483
"2073";"360470382002";108;80;130;6;31;355
"2074";"360470382003";104;46;14;1;34;199
"2075";"360470383001";143;41;137;5;36;362
"2076";"360470383002";82;139;56;14;31;322
"2077";"360470383003";60;40;102;3;25;230
"2078";"360470383004";92;44;38;7;25;206
"2079";"360470385001";178;50;81;13;31;353
"2080";"360470385002";31;22;50;9;25;137
"2081";"360470385003";148;131;80;3;40;402
"2082";"360470385004";38;27;207;2;15;289
"2083";"360470386001";89;32;241;67;115;544
"2084";"360470386002";53;49;119;10;83;314
"2085";"360470387001";137;52;130;4;36;359
"2086";"360470387002";44;20;132;2;31;229
"2087";"360470387003";108;24;118;6;20;276
"2088";"360470387004";91;35;157;16;30;329
"2089";"360470388001";409;9;27;5;11;461
"2090";"360470388002";10;3;55;1;11;80
"2091";"360470388003";28;7;57;3;16;111
"2092";"360470388004";5;1;47;9;9;71
"2093";"360470389001";253;177;77;31;85;623
"2094";"360470389002";136;236;114;9;45;540
"2095";"360470389003";226;250;103;2;55;636
"2096";"360470390001";25;8;99;16;21;169
"2097";"360470390002";6;2;67;5;15;95
"2098";"360470391001";335;185;103;4;88;715
"2099";"360470391002";609;253;153;18;89;1122
"2100";"360470392001";34;6;273;9;25;347
"2101";"360470392002";71;18;91;9;17;206
"2102";"360470393001";467;101;171;5;49;793
"2103";"360470393002";282;46;170;8;66;572
"2104";"360470393003";254;248;97;9;61;669
"2105";"360470394001";21;20;88;2;14;145
"2106";"360470394002";9;3;30;1;14;57
"2107";"360470394003";6;2;55;4;19;86
"2108";"360470395001";214;332;86;2;53;687
"2109";"360470395002";137;132;179;19;69;536
"2110";"360470395003";221;153;133;16;37;560
"2111";"360470396001";18;1;28;9;10;66
"2112";"360470396002";21;9;51;12;13;106
"2113";"360470397001";286;88;105;7;82;568
"2114";"360470397002";172;226;100;8;58;564
"2115";"360470397003";210;85;89;2;67;453
"2116";"360470398001";106;21;228;52;80;487
"2117";"360470398002";36;43;108;22;39;248
"2118";"360470399001";379;63;138;9;48;637
"2119";"360470399002";150;35;80;6;15;286
"2120";"360470399003";240;70;47;28;20;405
"2121";"360470400001";55;18;224;37;60;394
"2122";"360470400002";16;2;66;3;19;106
"2123";"360470400003";42;51;121;5;48;267
"2124";"360470401001";58;34;86;15;10;203
"2125";"360470401002";167;74;146;16;24;427
"2126";"360470401003";170;49;331;13;36;599
"2127";"360470402001";35;43;186;10;56;330
"2128";"360470402002";35;29;296;12;33;405
"2129";"360470403001";245;463;240;55;54;1057
"2130";"360470403002";73;49;141;13;42;318
"2131";"360470403003";92;51;107;7;36;293
"2132";"360470404001";29;8;293;7;14;351
"2133";"360470404002";20;19;190;8;56;293
"2134";"360470405001";80;190;323;101;69;763
"2135";"360470405002";38;73;33;17;37;198
"2136";"360470406001";30;5;116;9;27;187
"2137";"360470406002";19;8;224;4;18;273
"2138";"360470406003";20;4;166;4;20;214
"2139";"360470407001";7;77;11;3;3;101
"2140";"360470408001";52;34;47;0;14;147
"2141";"360470408002";21;18;152;4;21;216
"2142";"360470408003";24;9;103;3;16;155
"2143";"360470409001";226;421;260;27;75;1009
"2144";"360470409002";96;79;120;13;48;356
"2145";"360470409003";105;139;266;5;25;540
"2146";"360470410001";165;177;480;12;54;888
"2147";"360470410002";10;6;326;8;11;361
"2148";"360470411001";112;325;128;8;37;610
"2149";"360470411002";209;198;172;6;22;607
"2150";"360470411003";221;97;105;5;22;450
"2151";"360470412001";53;22;148;11;33;267
"2152";"360470412002";98;32;585;3;50;768
"2153";"360470413001";154;102;357;15;49;677
"2154";"360470413002";202;75;124;7;49;457
"2155";"360470413003";80;54;212;18;18;382
"2156";"360470414011";12;18;82;15;24;151
"2157";"360470414012";6;10;43;3;72;134
"2158";"360470414021";124;9;17;7;12;169
"2159";"360470414022";12;7;24;11;18;72
"2160";"360470415001";260;170;198;12;71;711
"2161";"360470415002";230;69;128;13;40;480
"2162";"360470415003";70;16;75;15;10;186
"2163";"360470416001";25;3;63;5;19;115
"2164";"360470416002";64;5;137;2;13;221
"2165";"360470417001";98;373;25;3;21;520
"2166";"360470417002";79;34;29;8;8;158
"2167";"360470417003";130;61;85;8;62;346
"2168";"360470417004";92;69;39;11;33;244
"2169";"360470418001";14;20;29;2;28;93
"2170";"360470418002";18;4;28;8;10;68
"2171";"360470419001";207;182;211;9;59;668
"2172";"360470419002";197;146;68;9;18;438
"2173";"360470419003";170;34;24;10;27;265
"2174";"360470420001";15;18;91;5;18;147
"2175";"360470420002";25;19;33;5;35;117
"2176";"360470421001";176;135;71;5;39;426
"2177";"360470421002";97;90;100;10;67;364
"2178";"360470421003";141;65;151;8;31;396
"2179";"360470421004";106;51;264;14;40;475
"2180";"360470422001";75;7;45;5;34;166
"2181";"360470422002";14;10;111;14;20;169
"2182";"360470422003";33;3;51;5;15;107
"2183";"360470423001";153;158;136;9;70;526
"2184";"360470423002";164;430;298;4;194;1090
"2185";"360470423003";83;81;47;7;25;243
"2186";"360470424001";50;18;65;16;41;190
"2187";"360470424002";17;13;77;6;27;140
"2188";"360470424003";74;12;95;1;22;204
"2189";"360470425001";163;80;96;2;32;373
"2190";"360470425002";148;126;234;15;42;565
"2191";"360470425003";177;290;78;14;64;623
"2192";"360470426001";33;26;184;1;27;271
"2193";"360470426002";74;62;201;13;40;390
"2194";"360470426003";38;21;161;21;14;255
"2195";"360470427001";143;235;35;53;101;567
"2196";"360470427002";203;169;124;9;61;566
"2197";"360470427003";391;201;91;8;55;746
"2198";"360470427004";65;141;83;1;29;319
"2199";"360470428001";62;41;117;6;17;243
"2200";"360470428002";69;13;233;13;28;356
"2201";"360470428003";133;20;128;2;28;311
"2202";"360470429001";166;119;72;2;183;542
"2203";"360470429002";101;103;50;7;66;327
"2204";"360470429003";156;131;87;7;63;444
"2205";"360470429004";393;360;60;5;72;890
"2206";"360470430001";34;39;191;6;9;279
"2207";"360470430002";65;13;888;6;15;987
"2208";"360470430003";71;39;492;3;114;719
"2209";"360470431001";124;170;393;7;63;757
"2210";"360470431002";390;194;102;11;70;767
"2211";"360470431003";115;273;55;6;48;497
"2212";"360470431004";288;573;126;8;79;1074
"2213";"360470432001";27;34;962;5;15;1043
"2214";"360470432002";261;56;122;5;56;500
"2215";"360470432003";129;102;348;3;39;621
"2216";"360470433001";145;213;37;5;39;439
"2217";"360470433002";145;219;64;3;31;462
"2218";"360470433003";269;163;76;3;65;576
"2219";"360470434001";303;9;80;0;18;410
"2220";"360470434002";19;12;202;8;22;263
"2221";"360470434003";39;17;356;8;22;442
"2222";"360470435001";129;126;57;3;39;354
"2223";"360470435002";199;164;111;7;42;523
"2224";"360470435003";103;72;67;16;33;291
"2225";"360470436001";39;23;163;3;33;261
"2226";"360470436002";62;20;80;4;27;193
"2227";"360470436003";41;8;88;3;23;163
"2228";"360470437001";315;257;202;6;20;800
"2229";"360470437002";174;340;116;18;76;724
"2230";"360470437003";163;110;68;13;15;369
"2231";"360470437004";203;499;66;12;42;822
"2232";"360470438001";156;23;64;13;29;285
"2233";"360470438002";45;15;136;10;78;284
"2234";"360470439001";161;264;166;10;74;675
"2235";"360470439002";51;20;109;1;14;195
"2236";"360470439003";178;474;302;4;127;1085
"2237";"360470440001";32;4;97;6;15;154
"2238";"360470440002";3;6;125;9;12;155
"2239";"360470440003";42;21;171;16;61;311
"2240";"360470441001";172;218;130;5;74;599
"2241";"360470441002";197;242;243;1;61;744
"2242";"360470441003";98;58;92;2;24;274
"2243";"360470442001";33;63;89;28;34;247
"2244";"360470442002";6;2;54;4;13;79
"2245";"360470443001";50;15;60;11;18;154
"2246";"360470443002";163;169;155;9;100;596
"2247";"360470443003";233;64;49;1;39;386
"2248";"360470443004";44;17;86;1;71;219
"2249";"360470444001";5;3;71;11;5;95
"2250";"360470444002";14;12;52;8;10;96
"2251";"360470444003";64;9;80;6;14;173
"2252";"360470445001";99;62;73;6;38;278
"2253";"360470445002";137;175;190;31;62;595
"2254";"360470445003";227;658;274;4;59;1222
"2255";"360470446001";12;6;86;6;29;139
"2256";"360470446002";14;12;149;12;20;207
"2257";"360470447001";188;332;109;9;71;709
"2258";"360470447002";145;311;239;16;78;789
"2259";"360470448001";13;55;39;7;43;157
"2260";"360470448002";37;39;41;5;36;158
"2261";"360470449001";61;75;69;2;56;263
"2262";"360470449002";291;216;33;9;39;588
"2263";"360470449003";39;46;177;14;55;331
"2264";"360470449004";38;222;400;89;166;915
"2265";"360470450001";15;24;223;30;33;325
"2266";"360470452001";4;3;92;5;8;112
"2267";"360470452002";188;25;80;3;102;398
"2268";"360470453001";159;70;158;48;74;509
"2269";"360470453002";169;314;99;16;83;681
"2270";"360470454001";22;25;95;5;23;170
"2271";"360470454002";12;6;28;2;13;61
"2272";"360470456001";41;50;72;3;48;214
"2273";"360470456002";91;11;174;7;26;309
"2274";"360470458001";15;6;136;5;23;185
"2275";"360470458002";7;2;27;2;18;56
"2276";"360470460001";25;13;396;18;23;475
"2277";"360470460002";45;44;109;5;29;232
"2278";"360470460003";20;55;74;4;46;199
"2279";"360470462011";43;16;187;8;14;268
"2280";"360470462012";27;24;80;15;36;182
"2281";"360470462021";26;10;120;15;16;187
"2282";"360470462022";11;13;91;15;29;159
"2283";"360470464001";1;4;88;7;48;148
"2284";"360470464002";13;0;49;4;5;71
"2285";"360470468001";55;83;130;9;104;381
"2286";"360470470001";0;4;28;0;11;43
"2287";"360470470002";5;5;103;1;7;121
"2288";"360470472001";2;3;11;2;14;32
"2289";"360470472002";10;4;136;20;32;202
"2290";"360470472003";4;1;23;4;5;37
"2291";"360470474001";9;8;44;2;19;82
"2292";"360470474002";8;5;60;1;8;82
"2293";"360470476001";14;25;48;9;24;120
"2294";"360470476002";0;3;12;3;11;29
"2295";"360470476003";2;2;53;1;10;68
"2296";"360470477001";263;65;127;14;119;588
"2297";"360470477002";139;268;148;14;82;651
"2298";"360470478001";36;48;199;14;72;369
"2299";"360470478002";22;8;36;3;16;85
"2300";"360470478003";8;6;159;7;23;203
"2301";"360470480001";63;21;229;6;29;348
"2302";"360470480002";29;31;404;32;41;537
"2303";"360470481001";36;33;72;1;28;170
"2304";"360470481002";71;21;92;0;25;209
"2305";"360470481003";174;44;110;22;37;387
"2306";"360470482001";55;41;184;15;32;327
"2307";"360470482002";292;59;191;34;67;643
"2308";"360470482003";66;20;329;6;35;456
"2309";"360470482004";219;8;730;3;30;990
"2310";"360470484001";97;111;468;20;109;805
"2311";"360470484002";32;43;457;10;44;586
"2312";"360470484003";32;31;162;15;30;270
"2313";"360470485001";202;272;553;49;103;1179
"2314";"360470485002";297;105;337;28;49;816
"2315";"360470486001";16;80;97;5;90;288
"2316";"360470486002";38;61;133;4;34;270
"2317";"360470486003";13;91;135;12;37;288
"2318";"360470488001";110;30;114;0;54;308
"2319";"360470488002";25;10;323;4;10;372
"2320";"360470488003";24;24;115;3;40;206
"2321";"360470489001";297;56;15;2;17;387
"2322";"360470489002";76;7;1;0;8;92
"2323";"360470489003";1002;47;4;0;9;1062
"2324";"360470490001";42;52;203;6;55;358
"2325";"360470490002";141;46;190;15;48;440
"2326";"360470490003";20;13;197;16;28;274
"2327";"360470491001";7;28;17;4;29;85
"2328";"360470491002";153;271;31;3;96;554
"2329";"360470491003";249;398;63;0;65;775
"2330";"360470491004";46;23;29;2;42;142
"2331";"360470492001";19;102;146;20;27;314
"2332";"360470492002";37;92;159;54;57;399
"2333";"360470492003";41;53;203;31;40;368
"2334";"360470493001";212;108;29;1;56;406
"2335";"360470493002";212;194;49;10;68;533
"2336";"360470493003";68;73;38;0;99;278
"2337";"360470493004";61;47;32;6;31;177
"2338";"360470493005";148;216;30;1;48;443
"2339";"360470494001";101;62;111;5;52;331
"2340";"360470494002";84;27;130;10;25;276
"2341";"360470494003";47;67;82;0;17;213
"2342";"360470494004";12;18;46;1;12;89
"2343";"360470495001";60;33;83;1;31;208
"2344";"360470495002";56;20;263;8;109;456
"2345";"360470495003";124;102;132;6;41;405
"2346";"360470496001";84;49;123;2;101;359
"2347";"360470496002";19;19;101;4;51;194
"2348";"360470496003";46;19;93;4;36;198
"2349";"360470497001";101;54;241;4;37;437
"2350";"360470497002";79;80;79;2;74;314
"2351";"360470497003";84;65;71;3;41;264
"2352";"360470498001";114;91;93;11;57;366
"2353";"360470498002";97;164;282;17;56;616
"2354";"360470498003";51;21;217;23;26;338
"2355";"360470499001";60;43;263;4;36;406
"2356";"360470499002";95;41;174;13;75;398
"2357";"360470500001";14;22;18;7;14;75
"2358";"360470500002";33;35;55;6;46;175
"2359";"360470500003";57;21;164;8;23;273
"2360";"360470501001";35;26;47;8;36;152
"2361";"360470501002";51;32;38;5;32;158
"2362";"360470501003";147;142;174;8;94;565
"2363";"360470502021";26;32;36;15;28;137
"2364";"360470502022";19;57;80;11;24;191
"2365";"360470503001";114;41;82;0;55;292
"2366";"360470503002";114;57;151;8;45;375
"2367";"360470503003";154;85;41;0;45;325
"2368";"360470504001";11;29;30;1;21;92
"2369";"360470504002";148;72;118;9;42;389
"2370";"360470504003";248;34;159;46;76;563
"2371";"360470505001";100;91;10;0;44;245
"2372";"360470505002";275;128;157;4;50;614
"2373";"360470505003";196;437;109;1;65;808
"2374";"360470506001";188;257;39;13;82;579
"2375";"360470506002";239;62;76;9;32;418
"2376";"360470506003";161;128;59;5;59;412
"2377";"360470506004";58;35;65;6;20;184
"2378";"360470507001";44;48;193;27;132;444
"2379";"360470508011";158;107;10;6;75;356
"2380";"360470508012";264;388;30;23;149;854
"2381";"360470508031";298;364;151;12;191;1016
"2382";"360470508041";286;357;211;14;130;998
"2383";"360470508042";269;247;258;10;74;858
"2384";"360470508043";138;44;99;7;46;334
"2385";"360470509001";53;51;89;18;45;256
"2386";"360470509002";8;11;52;12;18;101
"2387";"360470510011";99;33;37;9;98;276
"2388";"360470510012";268;171;40;6;164;649
"2389";"360470510021";279;268;37;6;102;692
"2390";"360470510022";99;332;54;5;135;625
"2391";"360470510023";171;129;68;10;72;450
"2392";"360470511001";10;40;36;3;57;146
"2393";"360470511002";353;146;106;11;62;678
"2394";"360470511003";117;328;162;13;99;719
"2395";"360470512001";179;162;107;34;158;640
"2396";"360470512002";278;98;31;18;101;526
"2397";"360470512003";124;84;102;14;76;400
"2398";"360470512004";119;120;155;23;132;549
"2399";"360470513001";190;395;182;1;156;924
"2400";"360470513002";102;97;187;6;29;421
"2401";"360470513003";526;593;352;24;129;1624
"2402";"360470513004";77;128;62;6;45;318
"2403";"360470514001";56;46;77;16;43;238
"2404";"360470514002";184;203;29;8;154;578
"2405";"360470514003";256;229;59;3;132;679
"2406";"360470514004";144;120;96;14;80;454
"2407";"360470515001";166;284;132;18;197;797
"2408";"360470516011";111;39;70;13;37;270
"2409";"360470516012";330;180;122;8;64;704
"2410";"360470516013";555;504;268;31;193;1551
"2411";"360470516021";303;621;66;9;58;1057
"2412";"360470516022";372;489;51;12;125;1049
"2413";"360470517001";107;180;62;1;54;404
"2414";"360470517002";173;172;87;4;81;517
"2415";"360470518001";136;21;191;4;30;382
"2416";"360470518002";80;25;176;14;53;348
"2417";"360470518003";35;27;37;10;16;125
"2418";"360470519001";213;149;167;9;56;594
"2419";"360470519002";113;89;162;9;52;425
"2420";"360470519003";218;261;196;9;86;770
"2421";"360470520001";82;117;98;10;68;375
"2422";"360470520002";72;111;118;5;110;416
"2423";"360470520003";32;25;45;1;12;115
"2424";"360470523001";255;1169;75;5;72;1576
"2425";"360470523002";210;748;20;0;52;1030
"2426";"360470523003";175;234;43;5;60;517
"2427";"360470523004";108;114;28;11;33;294
"2428";"360470523005";157;601;70;0;57;885
"2429";"360470525001";164;252;64;2;102;584
"2430";"360470525002";71;100;37;15;46;269
"2431";"360470526001";94;90;106;13;66;369
"2432";"360470526002";91;61;299;8;55;514
"2433";"360470526003";3;11;74;3;13;104
"2434";"360470527001";200;249;116;1;48;614
"2435";"360470527002";79;132;75;4;13;303
"2436";"360470527003";97;120;45;7;35;304
"2437";"360470527004";57;113;25;2;28;225
"2438";"360470527005";73;180;26;2;27;308
"2439";"360470527006";134;511;58;10;44;757
"2440";"360470527007";45;76;23;0;12;156
"2441";"360470528001";149;29;161;2;30;371
"2442";"360470528002";22;19;139;3;28;211
"2443";"360470529001";1;2;231;4;10;248
"2444";"360470529002";11;18;18;5;20;72
"2445";"360470529003";14;23;31;2;56;126
"2446";"360470530001";59;12;32;5;22;130
"2447";"360470530002";58;36;55;3;27;179
"2448";"360470530003";74;15;87;14;66;256
"2449";"360470531001";28;42;37;6;135;248
"2450";"360470531002";9;30;14;5;62;120
"2451";"360470531003";2;4;5;0;10;21
"2452";"360470531004";5;1;4;1;4;15
"2453";"360470532001";51;26;72;4;39;192
"2454";"360470532002";15;17;85;18;22;157
"2455";"360470533001";0;2;3;0;17;22
"2456";"360470533002";0;1;5;0;7;13
"2457";"360470533003";0;3;9;1;11;24
"2458";"360470533004";2;4;2;2;9;19
"2459";"360470533005";2;18;10;0;18;48
"2460";"360470534001";44;14;77;8;19;162
"2461";"360470534002";16;11;62;3;18;110
"2462";"360470534003";125;5;32;3;9;174
"2463";"360470534004";71;25;38;2;21;157
"2464";"360470535001";16;3;7;19;22;67
"2465";"360470535002";2;3;5;0;17;27
"2466";"360470535003";3;13;54;8;16;94
"2467";"360470535004";38;29;46;11;49;173
"2468";"360470537001";2;1;21;3;5;32
"2469";"360470537002";3;25;89;14;45;176
"2470";"360470538001";41;42;386;8;25;502
"2471";"360470538002";149;27;204;9;27;416
"2472";"360470538003";39;31;73;4;70;217
"2473";"360470539001";1;3;28;10;13;55
"2474";"360470539002";19;3;9;0;28;59
"2475";"360470542001";112;8;199;3;30;352
"2476";"360470542002";36;51;111;19;37;254
"2477";"360470542003";32;3;113;2;8;158
"2478";"360470543001";53;46;156;1;53;309
"2479";"360470543002";74;110;163;20;61;428
"2480";"360470544001";14;7;203;5;14;243
"2481";"360470544002";55;11;168;3;18;255
"2482";"360470544003";8;4;66;9;21;108
"2483";"360470545001";3;5;23;20;7;58
"2484";"360470545002";17;15;17;2;32;83
"2485";"360470545003";213;36;13;4;26;292
"2486";"360470545004";1;1;6;1;4;13
"2487";"360470545005";57;28;20;1;22;128
"2488";"360470545006";60;26;33;6;43;168
"2489";"360470546001";40;22;193;15;36;306
"2490";"360470546002";182;50;208;9;27;476
"2491";"360470546003";143;24;144;5;13;329
"2492";"360470547001";86;56;48;13;47;250
"2493";"360470547002";11;14;34;0;23;82
"2494";"360470547003";147;108;132;10;187;584
"2495";"360470548001";39;9;86;9;7;150
"2496";"360470548002";15;2;109;26;8;160
"2497";"360470549001";77;54;90;9;122;352
"2498";"360470549002";372;273;251;6;201;1103
"2499";"360470550001";18;20;121;22;16;197
"2500";"360470550002";63;5;63;6;8;145
"2501";"360470550003";45;16;83;6;30;180
"2502";"360470551001";218;248;294;11;188;959
"2503";"360470551002";115;123;92;6;48;384
"2504";"360470551003";270;443;89;3;191;996
"2505";"360470551004";154;252;52;3;54;515
"2506";"360470552001";47;14;128;4;26;219
"2507";"360470552002";46;31;56;4;52;189
"2508";"360470552003";54;25;152;4;92;327
"2509";"360470553001";238;267;78;7;94;684
"2510";"360470553002";109;300;72;9;81;571
"2511";"360470553003";228;265;232;14;102;841
"2512";"360470554001";43;31;81;0;61;216
"2513";"360470554002";118;11;74;0;11;214
"2514";"360470554003";39;11;75;1;48;174
"2515";"360470555001";956;2432;1143;21;658;5210
"2516";"360470556001";263;430;94;8;92;887
"2517";"360470556002";13;2;66;1;16;98
"2518";"360470556003";64;5;66;4;29;168
"2519";"360470557001";69;172;72;1;86;400
"2520";"360470557002";125;687;128;7;97;1044
"2521";"360470558001";37;3;110;8;11;169
"2522";"360470558002";52;436;241;4;33;766
"2523";"360470560001";18;3;120;15;10;166
"2524";"360470560002";38;10;101;11;20;180
"2525";"360470560003";35;3;57;8;10;113
"2526";"360470561001";84;103;159;11;57;414
"2527";"360470561002";5;14;43;2;37;101
"2528";"360470561003";38;116;58;4;87;303
"2529";"360470561004";43;19;160;4;23;249
"2530";"360470562001";0;0;62;9;14;85
"2531";"360470562002";7;0;93;10;12;122
"2532";"360470563001";259;539;406;12;114;1330
"2533";"360470563002";174;303;196;6;107;786
"2534";"360470563003";58;40;164;8;24;294
"2535";"360470563004";105;91;122;9;34;361
"2536";"360470564001";11;1;28;2;13;55
"2537";"360470564002";46;4;52;7;12;121
"2538";"360470564003";5;1;36;10;4;56
"2539";"360470565001";192;1150;243;10;224;1819
"2540";"360470565002";40;48;102;1;26;217
"2541";"360470565003";107;113;44;6;56;326
"2542";"360470566001";50;5;45;7;16;123
"2543";"360470566002";38;28;19;2;82;169
"2544";"360470568001";18;11;43;10;12;94
"2545";"360470568002";1;2;26;5;4;38
"2546";"360470569001";88;145;88;2;57;380
"2547";"360470569002";62;107;127;8;75;379
"2548";"360470570001";3;2;55;2;15;77
"2549";"360470570002";22;14;40;9;8;93
"2550";"360470570003";10;6;19;4;29;68
"2551";"360470570004";52;22;92;40;63;269
"2552";"360470571001";66;174;119;4;35;398
"2553";"360470571002";99;35;61;5;17;217
"2554";"360470571003";37;18;71;8;30;164
"2555";"360470571004";40;17;46;8;17;128
"2556";"360470572001";866;187;50;17;60;1180
"2557";"360470572002";311;101;46;22;49;529
"2558";"360470573001";34;29;116;4;18;201
"2559";"360470573002";146;17;68;1;18;250
"2560";"360470573003";31;15;92;1;12;151
"2561";"360470574001";36;45;58;19;17;175
"2562";"360470574002";9;4;52;5;22;92
"2563";"360470575001";192;27;95;6;21;341
"2564";"360470575002";73;89;111;20;37;330
"2565";"360470575003";52;27;38;2;27;146
"2566";"360470575004";61;51;91;1;39;243
"2567";"360470576001";14;3;107;17;30;171
"2568";"360470576002";24;4;122;19;19;188
"2569";"360470578001";95;13;232;9;34;383
"2570";"360470578002";80;33;149;6;34;302
"2571";"360470579001";56;107;121;7;18;309
"2572";"360470579002";34;32;364;57;89;576
"2573";"360470580001";94;13;38;3;28;176
"2574";"360470580002";30;11;99;3;28;171
"2575";"360470582001";49;6;76;0;19;150
"2576";"360470582002";13;14;30;11;15;83
"2577";"360470582003";29;20;108;5;21;183
"2578";"360470584001";64;4;118;0;19;205
"2579";"360470584002";68;28;204;30;17;347
"2580";"360470586001";14;16;48;3;22;103
"2581";"360470586002";20;7;97;9;25;158
"2582";"360470588001";110;14;331;42;33;530
"2583";"360470588002";41;5;34;9;30;119
"2584";"360470589001";45;56;144;18;31;294
"2585";"360470589002";86;49;100;1;49;285
"2586";"360470590001";43;17;294;42;39;435
"2587";"360470591001";74;12;50;10;22;168
"2588";"360470591002";33;41;28;5;27;134
"2589";"360470591003";36;13;80;6;53;188
"2590";"360470591004";59;148;42;6;64;319
"2591";"360470592001";27;6;70;5;11;119
"2592";"360470592002";73;7;122;23;33;258
"2593";"360470592003";39;13;141;1;72;266
"2594";"360470593001";28;25;218;4;7;282
"2595";"360470593002";101;44;118;6;36;305
"2596";"360470594011";12;1;115;11;13;152
"2597";"360470594012";9;3;142;14;16;184
"2598";"360470594013";11;8;164;36;36;255
"2599";"360470594014";57;11;146;24;11;249
"2600";"360470594015";25;3;59;6;21;114
"2601";"360470594016";122;11;153;11;20;317
"2602";"360470594021";26;36;69;5;36;172
"2603";"360470594022";28;5;373;22;40;468
"2604";"360470594023";51;4;116;7;20;198
"2605";"360470594024";94;2;82;4;9;191
"2606";"360470596001";21;12;11;3;18;65
"2607";"360470596002";3;2;8;2;13;28
"2608";"360470596003";22;22;508;29;41;622
"2609";"360470598001";22;5;76;16;15;134
"2610";"360470598002";18;3;71;16;19;127
"2611";"360470600001";22;33;70;2;24;151
"2612";"360470600002";27;20;220;36;35;338
"2613";"360470600003";90;29;527;35;25;706
"2614";"360470600004";11;6;28;5;37;87
"2615";"360470600005";86;37;54;11;35;223
"2616";"360470606001";106;19;62;16;72;275
"2617";"360470606002";46;13;102;7;53;221
"2618";"360470608001";52;76;118;37;94;377
"2619";"360470608002";82;5;100;8;27;222
"2620";"360470608003";61;181;107;14;80;443
"2621";"360470610021";78;60;43;1;75;257
"2622";"360470610022";207;70;39;0;56;372
"2623";"360470610031";16;4;34;0;18;72
"2624";"360470610032";32;8;88;5;22;155
"2625";"360470610041";36;19;79;4;36;174
"2626";"360470610042";44;3;56;1;6;110
"2627";"360470610043";50;88;127;2;34;301
"2628";"360470610044";43;11;9;0;10;73
"2629";"360470610045";39;14;29;0;9;91
"2630";"360470612001";34;43;122;4;54;257
"2631";"360470616001";36;98;63;3;102;302
"2632";"360470620001";35;40;110;1;19;205
"2633";"360470620002";5;31;63;4;42;145
"2634";"360470622001";91;17;110;28;26;272
"2635";"360470622002";104;35;173;35;54;401
"2636";"360470626001";29;8;71;4;23;135
"2637";"360470626002";66;52;76;51;53;298
"2638";"360470628001";62;16;95;38;60;271
"2639";"360470628002";36;43;122;33;75;309
"2640";"360470628003";14;6;60;19;51;150
"2641";"360470628004";13;12;105;63;43;236
"2642";"360470632001";7;6;31;7;50;101
"2643";"360470632002";15;5;39;19;13;91
"2644";"360470636001";46;18;183;12;35;294
"2645";"360470638001";29;5;56;8;17;115
"2646";"360470638002";26;11;44;16;46;143
"2647";"360470640001";16;20;39;4;36;115
"2648";"360470640002";7;3;48;5;26;89
"2649";"360470642001";125;36;142;33;39;375
"2650";"360470642002";33;9;69;16;8;135
"2651";"360470644001";43;20;96;20;34;213
"2652";"360470644002";61;43;141;19;30;294
"2653";"360470646001";11;9;109;18;19;166
"2654";"360470646002";35;18;165;14;43;275
"2655";"360470648001";30;8;125;32;18;213
"2656";"360470648002";9;2;70;3;14;98
"2657";"360470650001";21;14;50;11;23;119
"2658";"360470650002";23;32;94;41;37;227
"2659";"360470652001";114;108;178;12;72;484
"2660";"360470654001";4;3;50;6;16;79
"2661";"360470654002";50;2;38;2;23;115
"2662";"360470656001";33;18;115;4;32;202
"2663";"360470656002";3;8;47;6;7;71
"2664";"360470658001";10;7;51;53;23;144
"2665";"360470658002";17;6;71;6;28;128
"2666";"360470660001";1;4;80;6;23;114
"2667";"360470660002";11;4;88;6;31;140
"2668";"360470662001";60;29;173;29;93;384
"2669";"360470666001";34;84;139;19;263;539
"2670";"360470670001";18;6;120;26;12;182
"2671";"360470670002";60;30;262;52;30;434
"2672";"360470672001";60;58;176;43;44;381
"2673";"360470674001";28;18;228;43;19;336
"2674";"360470674002";58;10;99;39;26;232
"2675";"360470676001";48;5;73;31;11;168
"2676";"360470676002";20;15;140;30;21;226
"2677";"360470678001";76;7;179;50;17;329
"2678";"360470678002";35;5;154;41;11;246
"2679";"360470680001";13;7;118;44;12;194
"2680";"360470680002";44;33;155;28;27;287
"2681";"360470682001";71;9;182;37;27;326
"2682";"360470682002";95;36;152;46;25;354
"2683";"360470686001";25;3;133;14;21;196
"2684";"360470686002";41;13;207;30;17;308
"2685";"360470688001";76;26;62;12;30;206
"2686";"360470688002";17;6;51;4;17;95
"2687";"360470690001";36;13;92;34;23;198
"2688";"360470690002";65;89;190;27;26;397
"2689";"360470692001";46;28;176;81;76;407
"2690";"360470692002";22;9;96;19;10;156
"2691";"360470696011";110;13;193;41;60;417
"2692";"360470696012";79;20;384;33;68;584
"2693";"360470696021";55;19;253;49;45;421
"2694";"360470696022";126;217;190;59;35;627
"2695";"360470696023";149;64;275;59;42;589
"2696";"360470698001";12;8;18;7;5;50
"2697";"360470698002";24;35;165;33;69;326
"2698";"360470700001";52;12;34;11;38;147
"2699";"360470700002";20;12;206;8;33;279
"2700";"360470702011";32;7;32;5;46;122
"2701";"360470702012";7;2;23;9;17;58
"2702";"360470702013";52;2;23;2;10;89
"2703";"360470702014";22;10;134;19;17;202
"2704";"360470702015";74;19;210;70;69;442
"2705";"360470702021";0;2;3;0;16;21
"2706";"360470702030";0;9;0;0;0;9
"2707";"360470702031";1;0;0;0;1;2
"2708";"360470706001";28;9;34;3;28;102
"2709";"360470706002";85;32;51;16;60;244
"2710";"360470720001";49;16;292;82;44;483
"2711";"360470722001";66;54;186;29;38;373
"2712";"360470722002";37;9;194;49;38;327
"2713";"360470724001";24;11;58;14;10;117
"2714";"360470724002";21;21;65;31;30;168
"2715";"360470726001";120;29;219;61;65;494
"2716";"360470728001";250;34;194;23;27;528
"2717";"360470728002";34;35;103;21;38;231
"2718";"360470730001";53;45;186;28;29;341
"2719";"360470730002";32;11;114;25;17;199
"2720";"360470732001";82;14;101;6;29;232
"2721";"360470732002";24;15;48;36;25;148
"2722";"360470734001";10;6;45;7;24;92
"2723";"360470734002";7;9;142;20;27;205
"2724";"360470736001";25;3;24;9;6;67
"2725";"360470736002";28;16;84;17;21;166
"2726";"360470736003";19;16;58;22;26;141
"2727";"360470738001";62;53;136;18;22;291
"2728";"360470738002";40;6;364;1;8;419
"2729";"360470738003";32;9;373;11;25;450
"2730";"360470740001";84;38;290;20;30;462
"2731";"360470740002";68;24;181;19;19;311
"2732";"360470742001";59;25;298;15;27;424
"2733";"360470742002";131;65;235;5;33;469
"2734";"360470744001";5;12;94;4;19;134
"2735";"360470744002";8;16;127;0;16;167
"2736";"360470746001";69;21;235;38;32;395
"2737";"360470746002";9;10;217;14;28;278
"2738";"360470748001";103;8;104;7;18;240
"2739";"360470748002";4;2;50;13;3;72
"2740";"360470750001";25;23;238;9;39;334
"2741";"360470750002";313;13;79;5;11;421
"2742";"360470752001";5;5;113;5;5;133
"2743";"360470754001";2;4;44;4;13;67
"2744";"360470754002";2;6;71;5;8;92
"2745";"360470756001";24;3;125;11;22;185
"2746";"360470756002";8;3;76;5;8;100
"2747";"360470758001";3;7;108;8;12;138
"2748";"360470758002";42;6;112;7;14;181
"2749";"360470760001";2;2;77;1;5;87
"2750";"360470760002";68;6;64;15;9;162
"2751";"360470760003";24;5;51;2;13;95
"2752";"360470762001";49;11;21;5;6;92
"2753";"360470762002";59;11;84;4;11;169
"2754";"360470762003";197;12;70;4;38;321
"2755";"360470764001";60;31;85;2;23;201
"2756";"360470764002";69;14;30;7;16;136
"2757";"360470764003";171;96;112;4;41;424
"2758";"360470766001";181;32;155;19;48;435
"2759";"360470768001";9;22;130;46;58;265
"2760";"360470768002";79;75;375;13;55;597
"2761";"360470768003";47;6;135;3;54;245
"2762";"360470770001";38;12;68;25;13;156
"2763";"360470770002";62;62;571;115;32;842
"2764";"360470772001";83;23;228;64;33;431
"2765";"360470772002";168;43;147;12;39;409
"2766";"360470774001";64;20;101;19;31;235
"2767";"360470774002";276;45;236;7;59;623
"2768";"360470776001";88;17;20;15;14;154
"2769";"360470776002";36;11;60;16;11;134
"2770";"360470776003";92;7;91;15;21;226
"2771";"360470780001";15;1;58;8;12;94
"2772";"360470780002";76;15;87;27;19;224
"2773";"360470782001";91;9;181;19;13;313
"2774";"360470782002";395;23;229;12;25;684
"2775";"360470784001";189;37;174;14;23;437
"2776";"360470784002";54;39;232;19;38;382
"2777";"360470786001";92;52;56;6;36;242
"2778";"360470786002";118;117;57;11;106;409
"2779";"360470786003";224;38;469;39;44;814
"2780";"360470788001";62;30;193;9;16;310
"2781";"360470788002";52;19;113;10;13;207
"2782";"360470788003";52;42;145;51;20;310
"2783";"360470790001";148;190;92;27;34;491
"2784";"360470790002";115;59;131;36;58;399
"2785";"360470790003";44;22;78;34;7;185
"2786";"360470790004";100;18;92;27;32;269
"2787";"360470792001";248;89;286;40;49;712
"2788";"360470792002";98;75;134;21;23;351
"2789";"360470792003";234;128;90;69;52;573
"2790";"360470794001";215;179;201;102;117;814
"2791";"360470794002";135;42;106;53;49;385
"2792";"360470796011";234;237;175;16;81;743
"2793";"360470796012";218;108;355;16;107;804
"2794";"360470796021";288;245;268;24;139;964
"2795";"360470796022";283;320;175;61;183;1022
"2796";"360470798011";109;168;82;7;50;416
"2797";"360470798012";60;85;259;3;74;481
"2798";"360470798021";174;113;214;13;93;607
"2799";"360470798022";459;1074;65;13;358;1969
"2800";"360470798023";219;1081;308;11;158;1777
"2801";"360470800001";234;484;259;14;53;1044
"2802";"360470800002";62;126;180;21;60;449
"2803";"360470800003";141;65;84;14;24;328
"2804";"360470802001";146;447;237;19;82;931
"2805";"360470802002";134;221;223;9;54;641
"2806";"360470802003";170;40;276;13;31;530
"2807";"360470804001";145;695;78;17;54;989
"2808";"360470804002";173;75;66;7;25;346
"2809";"360470804003";33;121;121;4;62;341
"2810";"360470806001";189;57;434;23;78;781
"2811";"360470806002";107;58;145;24;65;399
"2812";"360470808001";138;45;82;31;73;369
"2813";"360470810001";59;50;208;19;55;391
"2814";"360470810002";16;24;201;19;52;312
"2815";"360470814001";140;65;131;40;37;413
"2816";"360470814002";54;41;276;24;34;429
"2817";"360470816001";150;29;172;15;30;396
"2818";"360470816002";107;89;188;22;33;439
"2819";"360470818001";277;332;197;10;66;882
"2820";"360470818002";65;39;69;12;30;215
"2821";"360470818003";248;85;143;12;44;532
"2822";"360470820001";277;140;323;21;62;823
"2823";"360470820002";151;111;121;4;68;455
"2824";"360470820003";219;101;185;12;74;591
"2825";"360470822001";81;49;69;2;38;239
"2826";"360470822002";356;447;161;8;92;1064
"2827";"360470822003";571;446;348;3;130;1498
"2828";"360470822004";140;73;196;6;89;504
"2829";"360470824001";59;79;355;31;39;563
"2830";"360470824002";97;58;80;4;29;268
"2831";"360470824003";259;105;251;50;62;727
"2832";"360470824004";175;81;211;17;61;545
"2833";"360470826001";134;40;139;14;31;358
"2834";"360470826002";37;10;211;19;100;377
"2835";"360470826003";292;178;126;12;44;652
"2836";"360470826004";376;179;84;12;44;695
"2837";"360470828001";94;63;27;5;22;211
"2838";"360470828002";65;41;89;21;28;244
"2839";"360470828003";149;102;316;41;40;648
"2840";"360470830001";297;18;176;26;24;541
"2841";"360470830002";87;18;273;28;13;419
"2842";"360470830003";131;13;55;18;18;235
"2843";"360470830004";227;21;23;5;50;326
"2844";"360470832001";22;15;131;28;18;214
"2845";"360470832002";60;21;142;12;17;252
"2846";"360470834001";43;22;54;7;22;148
"2847";"360470834002";66;15;95;32;28;236
"2848";"360470836001";25;30;243;40;21;359
"2849";"360470836002";34;21;84;40;42;221
"2850";"360470838001";24;12;45;31;34;146
"2851";"360470838002";49;26;46;27;14;162
"2852";"360470840001";61;21;132;41;31;286
"2853";"360470840002";25;23;111;31;20;210
"2854";"360470846001";71;38;105;39;32;285
"2855";"360470846002";92;27;102;31;32;284
"2856";"360470848001";40;13;146;31;24;254
"2857";"360470848002";65;11;121;35;22;254
"2858";"360470850001";68;16;93;32;38;247
"2859";"360470852001";17;1;6;2;3;29
"2860";"360470854001";41;12;88;19;13;173
"2861";"360470854002";78;10;126;22;24;260
"2862";"360470856001";104;89;112;3;21;329
"2863";"360470856002";96;11;53;14;38;212
"2864";"360470856003";71;30;146;18;38;303
"2865";"360470858001";39;27;86;28;38;218
"2866";"360470858002";188;40;74;15;48;365
"2867";"360470860001";53;13;57;17;51;191
"2868";"360470860002";50;23;121;14;19;227
"2869";"360470860003";39;16;85;7;17;164
"2870";"360470862001";68;2;88;8;13;179
"2871";"360470862002";36;35;150;15;18;254
"2872";"360470862003";38;18;47;4;37;144
"2873";"360470864001";45;8;121;50;22;246
"2874";"360470864002";17;18;94;24;45;198
"2875";"360470866001";45;26;185;60;53;369
"2876";"360470866002";56;37;63;15;16;187
"2877";"360470866003";110;84;96;13;49;352
"2878";"360470868001";83;44;112;13;57;309
"2879";"360470868002";86;44;103;23;29;285
"2880";"360470868003";442;137;69;10;106;764
"2881";"360470870001";87;36;66;19;20;228
"2882";"360470870002";18;15;51;8;12;104
"2883";"360470870003";30;3;65;27;5;130
"2884";"360470872001";5;10;31;15;11;72
"2885";"360470872002";61;8;60;8;14;151
"2886";"360470872003";76;21;64;25;19;205
"2887";"360470874011";249;58;251;41;54;653
"2888";"360470874012";181;757;398;53;215;1604
"2889";"360470876001";74;37;202;14;44;371
"2890";"360470876002";18;15;71;39;11;154
"2891";"360470878001";38;121;105;28;57;349
"2892";"360470878002";1;70;12;6;25;114
"2893";"360470878003";59;26;65;14;53;217
"2894";"360470880001";98;245;212;45;74;674
"2895";"360470880002";24;81;7;6;26;144
"2896";"360470880003";43;50;135;37;35;300
"2897";"360470882001";52;32;205;19;31;339
"2898";"360470882002";73;41;151;26;53;344
"2899";"360470882003";80;34;83;15;42;254
"2900";"360470882004";88;36;163;20;29;336
"2901";"360470884001";205;64;68;21;43;401
"2902";"360470884002";52;50;112;31;42;287
"2903";"360470884003";77;38;158;32;79;384
"2904";"360470886001";290;19;124;10;12;455
"2905";"360470886002";249;34;139;31;46;499
"2906";"360470886003";76;25;121;18;27;267
"2907";"360470888001";96;69;206;9;44;424
"2908";"360470888002";36;3;113;23;23;198
"2909";"360470888003";45;23;79;25;42;214
"2910";"360470890001";81;13;72;30;20;216
"2911";"360470890002";62;55;105;22;31;275
"2912";"360470890003";18;2;32;4;19;75
"2913";"360470890004";67;114;143;11;87;422
"2914";"360470890005";43;28;94;8;13;186
"2915";"360470890006";18;3;51;4;19;95
"2916";"360470892001";56;60;39;3;41;199
"2917";"360470892002";90;27;64;5;81;267
"2918";"360470892003";81;42;64;3;54;244
"2919";"360470892004";26;12;34;5;12;89
"2920";"360470894001";80;17;51;13;20;181
"2921";"360470894002";31;49;113;19;18;230
"2922";"360470894003";109;36;91;9;79;324
"2923";"360470894004";28;9;82;13;17;149
"2924";"360470896001";70;98;93;10;23;294
"2925";"360470896002";313;60;233;21;40;667
"2926";"360470896003";206;38;94;13;27;378
"2927";"360470898001";29;21;68;8;26;152
"2928";"360470898002";169;63;125;51;32;440
"2929";"360470900001";20;4;31;25;20;100
"2930";"360470900002";9;4;14;8;9;44
"2931";"360470900003";158;31;79;5;32;305
"2932";"360470900004";63;26;53;8;16;166
"2933";"360470900005";804;81;140;5;29;1059
"2934";"360470900006";73;35;77;6;11;202
"2935";"360470900007";18;0;8;0;10;36
"2936";"360470902001";42;54;30;1;15;142
"2937";"360470902002";5;2;1;7;3;18
"2938";"360470902003";25;6;21;3;5;60
"2939";"360470902004";123;36;64;9;45;277
"2940";"360470902005";18;3;30;2;9;62
"2941";"360470906001";112;94;30;7;380;623
"2942";"360470906002";128;31;86;42;62;349
"2943";"360470906003";105;32;7;11;50;205
"2944";"360470908001";246;205;189;42;100;782
"2945";"360470908002";33;14;22;2;7;78
"2946";"360470908003";75;31;66;6;21;199
"2947";"360470910001";97;98;8;2;14;219
"2948";"360470910002";122;15;28;2;15;182
"2949";"360470910003";78;13;16;1;13;121
"2950";"360470910004";176;28;65;8;20;297
"2951";"360470912001";56;16;105;6;15;198
"2952";"360470912002";149;10;16;2;15;192
"2953";"360470912003";86;66;14;1;27;194
"2954";"360470916001";105;35;31;5;20;196
"2955";"360470916002";32;31;119;10;20;212
"2956";"360470916003";24;42;153;19;47;285
"2957";"360470916004";94;68;139;63;157;521
"2958";"360470918001";105;203;90;1;34;433
"2959";"360470918002";36;11;61;27;24;159
"2960";"360470920001";9;24;128;11;13;185
"2961";"360470920002";255;127;51;8;53;494
"2962";"360470920003";119;50;87;15;25;296
"2963";"360470922001";41;16;39;4;28;128
"2964";"360470922002";53;17;76;28;25;199
"2965";"360470924001";104;79;164;10;74;431
"2966";"360470924002";68;68;133;7;43;319
"2967";"360470924003";53;87;26;3;20;189
"2968";"360470928001";84;16;156;22;32;310
"2969";"360470928002";100;15;236;98;19;468
"2970";"360470930001";25;30;150;8;28;241
"2971";"360470930002";70;19;93;47;37;266
"2972";"360470932001";94;26;203;95;47;465
"2973";"360470934001";49;9;114;15;14;201
"2974";"360470934002";51;29;49;24;22;175
"2975";"360470936001";11;15;43;13;13;95
"2976";"360470936002";70;7;57;23;27;184
"2977";"360470938001";13;18;75;21;10;137
"2978";"360470938002";21;7;95;22;17;162
"2979";"360470944011";91;14;72;30;11;218
"2980";"360470944012";20;71;98;54;17;260
"2981";"360470944013";139;79;55;53;35;361
"2982";"360470944014";11;15;20;14;10;70
"2983";"360470944021";173;134;43;4;35;389
"2984";"360470946001";22;5;44;24;2;97
"2985";"360470946002";7;2;32;4;3;48
"2986";"360470946003";44;44;163;166;23;440
"2987";"360470950001";240;102;247;9;73;671
"2988";"360470950002";51;12;111;40;37;251
"2989";"360470954001";122;11;101;23;12;269
"2990";"360470954002";24;14;58;19;12;127
"2991";"360470954003";131;64;181;5;45;426
"2992";"360470956001";62;146;74;13;17;312
"2993";"360470956002";137;14;211;12;40;414
"2994";"360470958001";97;29;172;66;19;383
"2995";"360470958002";81;45;609;34;30;799
"2996";"360470960001";84;146;139;112;34;515
"2997";"360470962001";173;174;265;55;39;706
"2998";"360470964001";84;64;83;24;18;273
"2999";"360470964002";159;176;216;14;37;602
"3000";"360470966001";14;13;92;11;26;156
"3001";"360470966002";94;27;135;17;20;293
"3002";"360470968001";38;18;66;6;32;160
"3003";"360470968002";44;14;81;22;14;175
"3004";"360470970001";45;16;147;26;30;264
"3005";"360470970002";114;22;164;14;40;354
"3006";"360470974001";47;15;95;24;51;232
"3007";"360470974002";110;50;176;17;46;399
"3008";"360470982001";108;41;57;42;34;282
"3009";"360470982002";116;110;32;11;31;300
"3010";"360470984001";66;9;156;27;40;298
"3011";"360470986001";89;22;90;27;40;268
"3012";"360470986002";86;5;97;15;12;215
"3013";"360470988001";32;7;63;20;27;149
"3014";"360470988002";53;5;86;18;7;169
"3015";"360470990001";149;24;170;22;42;407
"3016";"360470992001";71;9;190;17;26;313
"3017";"360470994001";50;42;218;51;58;419
"3018";"360470996001";57;19;221;28;33;358
"3019";"360470996002";141;10;136;19;28;334
"3020";"360470998001";114;14;328;15;38;509
"3021";"360470998002";71;32;326;32;47;508
"3022";"360471004001";42;21;150;15;22;250
"3023";"360471006001";46;62;142;33;22;305
"3024";"360471006002";115;17;339;24;28;523
"3025";"360471008001";58;15;76;15;26;190
"3026";"360471008002";18;5;125;14;10;172
"3027";"360471010001";191;34;80;6;26;337
"3028";"360471010002";87;18;217;23;38;383
"3029";"360471012001";21;8;82;6;18;135
"3030";"360471012002";23;4;79;11;17;134
"3031";"360471014001";59;8;98;14;31;210
"3032";"360471014002";41;5;26;10;10;92
"3033";"360471016001";53;9;130;26;18;236
"3034";"360471018001";60;110;117;21;29;337
"3035";"360471020001";70;23;102;31;27;253
"3036";"360471022001";149;17;252;36;36;490
"3037";"360471024001";173;38;254;14;57;536
"3038";"360471026001";103;38;265;49;54;509
"3039";"360471028001";44;43;156;21;70;334
"3040";"360471028002";192;24;34;8;38;296
"3041";"360471034001";352;64;90;9;92;607
"3042";"360471058011";7;14;4;1;19;45
"3043";"360471058012";30;7;25;7;16;85
"3044";"360471058013";14;5;27;3;11;60
"3045";"360471058041";5;1;42;0;23;71
"3046";"360471058042";6;11;7;2;4;30
"3047";"360471058043";21;5;28;1;8;63
"3048";"360471058044";87;11;48;3;36;185
"3049";"360471070001";221;238;689;120;163;1431
"3050";"360471078001";494;337;92;16;21;960
"3051";"360471078002";38;181;31;26;17;293
"3052";"360471078003";46;4;91;4;16;161
"3053";"360471078004";80;7;7;1;11;106
"3054";"360471098001";117;77;182;37;24;437
"3055";"360471098002";55;36;210;99;42;442
"3056";"360471104001";74;190;147;37;85;533
"3057";"360471104002";121;23;151;25;68;388
"3058";"360471104003";91;7;60;6;62;226
"3059";"360471104004";32;9;104;12;30;187
"3060";"360471106001";209;7;17;3;29;265
"3061";"360471106002";165;30;6;2;19;222
"3062";"360471110001";124;39;25;1;17;206
"3063";"360471110002";292;56;2;3;10;363
"3064";"360471116001";52;53;117;29;13;264
"3065";"360471116002";222;117;189;33;41;602
"3066";"360471118001";92;77;160;31;30;390
"3067";"360471118002";407;95;343;33;42;920
"3068";"360471120001";93;164;133;8;52;450
"3069";"360471120002";328;242;257;29;28;884
"3070";"360471122001";95;85;240;35;64;519
"3071";"360471122002";142;67;258;17;36;520
"3072";"360471124001";76;23;67;19;28;213
"3073";"360471124002";89;58;80;10;35;272
"3074";"360471124003";65;41;106;55;22;289
"3075";"360471126001";52;9;54;11;32;158
"3076";"360471126002";20;33;33;6;13;105
"3077";"360471126003";122;56;87;10;27;302
"3078";"360471128001";50;36;144;12;38;280
"3079";"360471128002";83;193;42;17;58;393
"3080";"360471128003";202;213;93;7;37;552
"3081";"360471130001";19;11;34;7;12;83
"3082";"360471130002";92;22;82;30;18;244
"3083";"360471130003";160;40;124;24;28;376
"3084";"360471130004";40;39;95;42;23;239
"3085";"360471132001";67;46;320;45;37;515
"3086";"360471132002";53;23;130;31;9;246
"3087";"360471134001";43;19;26;6;9;103
"3088";"360471134002";30;26;4;10;8;78
"3089";"360471134003";43;25;28;7;25;128
"3090";"360471142011";28;33;130;33;7;231
"3091";"360471142012";44;250;188;91;39;612
"3092";"360471142021";154;253;479;25;37;948
"3093";"360471142022";34;37;173;6;22;272
"3094";"360471144001";8;11;122;276;39;456
"3095";"360471144002";38;73;33;13;16;173
"3096";"360471144003";29;114;74;24;28;269
"3097";"360471144004";35;3;29;3;21;91
"3098";"360471146001";105;90;741;28;38;1002
"3099";"360471146002";339;301;724;22;98;1484
"3100";"360471150001";72;41;146;30;46;335
"3101";"360471150002";117;17;110;36;7;287
"3102";"360471150003";45;30;248;26;18;367
"3103";"360471152001";61;33;114;73;14;295
"3104";"360471152002";236;9;110;27;21;403
"3105";"360471152003";44;27;64;13;32;180
"3106";"360471156001";33;16;184;10;31;274
"3107";"360471156002";254;55;78;1;16;404
"3108";"360471156003";340;127;26;5;22;520
"3109";"360471156004";158;249;84;5;45;541
"3110";"360471158001";79;51;135;17;17;299
"3111";"360471158002";118;124;58;18;66;384
"3112";"360471158003";103;20;54;6;26;209
"3113";"360471160001";15;20;58;7;18;118
"3114";"360471160002";81;49;9;4;19;162
"3115";"360471160003";44;12;151;15;17;239
"3116";"360471162001";64;15;19;6;12;116
"3117";"360471162002";17;7;26;4;8;62
"3118";"360471162003";33;14;81;16;7;151
"3119";"360471164001";46;186;104;5;13;354
"3120";"360471164002";52;18;109;7;15;201
"3121";"360471164003";34;18;84;8;21;165
"3122";"360471166001";33;12;80;14;13;152
"3123";"360471166002";131;52;151;25;24;383
"3124";"360471166003";183;59;190;19;30;481
"3125";"360471168001";85;35;162;102;52;436
"3126";"360471168002";186;134;196;59;69;644
"3127";"360471170001";43;75;82;22;26;248
"3128";"360471170002";203;55;164;44;51;517
"3129";"360471172011";171;33;387;36;37;664
"3130";"360471172012";97;154;262;12;53;578
"3131";"360471172021";150;41;130;19;74;414
"3132";"360471172022";269;35;403;44;33;784
"3133";"360471174001";444;524;376;56;85;1485
"3134";"360471174002";307;262;550;56;125;1300
"3135";"360471176011";263;100;1275;26;52;1716
"3136";"360471176012";400;401;324;26;56;1207
"3137";"360471176021";168;176;413;34;45;836
"3138";"360471176022";295;279;226;35;131;966
"3139";"360471178001";119;101;209;30;45;504
"3140";"360471180001";92;203;99;7;164;565
"3141";"360471182011";437;365;472;25;124;1423
"3142";"360471182012";91;175;220;28;30;544
"3143";"360471182021";127;197;226;24;57;631
"3144";"360471182022";113;298;271;17;41;740
"3145";"360471184001";116;209;264;22;39;650
"3146";"360471184002";152;134;276;35;55;652
"3147";"360471184003";74;60;106;21;53;314
"3148";"360471186001";87;12;131;18;80;328
"3149";"360471186002";209;47;207;68;25;556
"3150";"360471188001";49;55;57;10;154;325
"3151";"360471188002";136;42;108;8;44;338
"3152";"360471188003";102;42;84;10;49;287
"3153";"360471190001";74;58;156;18;50;356
"3154";"360471190002";99;85;159;12;53;408
"3155";"360471192001";178;35;226;24;44;507
"3156";"360471192002";317;296;161;26;145;945
"3157";"360471192003";24;45;99;58;15;241
"3158";"360471194001";121;28;110;17;31;307
"3159";"360471194002";51;44;270;31;29;425
"3160";"360471194003";140;38;327;17;26;548
"3161";"360471196001";93;56;188;25;50;412
"3162";"360471196002";73;102;171;47;53;446
"3163";"360471196003";73;87;361;15;32;568
"3164";"360471196004";137;49;515;26;54;781
"3165";"360471198001";35;18;175;22;49;299
"3166";"360471198002";66;58;128;40;29;321
"3167";"360471198003";169;240;256;121;174;960
"3168";"360471200001";19;9;80;12;22;142
"3169";"360471200002";44;16;266;29;31;386
"3170";"360471202001";47;96;61;17;52;273
"3171";"360471202002";69;55;53;4;34;215
"3172";"360471208001";89;47;287;17;37;477
"3173";"360471208002";138;74;1073;55;105;1445
"3174";"360471208003";42;31;24;2;22;121
"3175";"360471208004";37;6;1;0;4;48
"3176";"360471208005";88;17;169;62;27;363
"3177";"360471210001";57;36;7;0;92;192
"3178";"360471210002";72;11;8;0;17;108
"3179";"360471214001";94;15;13;2;8;132
"3180";"360471214002";52;11;8;0;8;79
"3181";"360471220001";274;262;303;58;93;990
"3182";"360471220002";279;234;418;80;82;1093
"3183";"360471237001";37;18;223;11;66;355
"3184";"360471237002";33;28;103;3;63;230
"3185";"360471237003";23;63;140;12;106;344
"3186";"360471502001";28;8;147;2;10;195
"3187";"360471502002";17;9;34;1;23;84
"3188";"360471502003";19;63;180;21;39;322
"3189";"360471522001";103;31;214;104;54;506
"3190";"360471522002";44;60;332;38;45;519
"3191";"360471522003";49;39;212;24;93;417
"3192";"360593005005";0;0;1;0;0;1
"3193";"360594043002";47;35;8;1;5;96
"3194";"360594043003";1;0;3;0;0;4
"3195";"360594103005";0;0;2;0;3;5
"3196";"360594109001";0;0;2;0;0;2
"3197";"360594113011";0;0;2;0;0;2
"3198";"360610001001";0;1;0;0;2;3
"3199";"360610002011";71;37;37;2;18;165
"3200";"360610002012";84;66;174;11;49;384
"3201";"360610002020";1;10;0;0;34;45
"3202";"360610002021";146;166;62;9;76;459
"3203";"360610002022";40;44;25;1;16;126
"3204";"360610002023";532;67;7;0;23;629
"3205";"360610002024";137;69;24;3;40;273
"3206";"360610002025";57;307;82;3;116;565
"3207";"360610005001";0;2;0;1;4;7
"3208";"360610006001";27;58;28;1;64;178
"3209";"360610006002";526;91;115;8;55;795
"3210";"360610006003";76;57;37;0;56;226
"3211";"360610006004";33;119;15;1;35;203
"3212";"360610006005";147;95;307;1;76;626
"3213";"360610006006";46;137;119;2;101;405
"3214";"360610007001";320;485;284;3;716;1808
"3215";"360610008001";33;28;35;11;32;139
"3216";"360610008002";68;24;25;4;14;135
"3217";"360610008003";84;14;28;5;20;151
"3218";"360610008004";5;5;11;0;17;38
"3219";"360610008005";21;62;9;1;69;162
"3220";"360610008006";126;196;109;5;614;1050
"3221";"360610009001";112;275;238;18;457;1100
"3222";"360610010011";31;49;73;8;84;245
"3223";"360610010021";69;24;22;2;21;138
"3224";"360610010022";33;32;4;0;23;92
"3225";"360610010023";168;70;56;12;44;350
"3226";"360610012001";123;113;244;1;46;527
"3227";"360610012002";32;35;115;4;38;224
"3228";"360610012003";26;20;110;3;43;202
"3229";"360610013001";35;58;121;7;317;538
"3230";"360610013002";81;168;379;1;373;1002
"3231";"360610014011";13;84;23;2;44;166
"3232";"360610014012";16;36;32;0;35;119
"3233";"360610014021";222;111;101;0;74;508
"3234";"360610014022";365;315;514;2;114;1310
"3235";"360610015011";69;214;199;5;524;1011
"3236";"360610015012";16;26;113;2;97;254
"3237";"360610015013";75;94;79;7;185;440
"3238";"360610015020";0;1;0;0;6;7
"3239";"360610015021";127;135;313;15;640;1230
"3240";"360610015022";172;114;69;2;138;495
"3241";"360610016001";69;65;88;8;89;319
"3242";"360610016002";14;18;15;0;41;88
"3243";"360610016003";32;38;27;0;50;147
"3244";"360610016004";236;220;9;1;83;549
"3245";"360610016005";97;525;242;4;114;982
"3246";"360610018001";349;622;60;10;129;1170
"3247";"360610018002";158;400;30;4;368;960
"3248";"360610018003";160;486;52;2;152;852
"3249";"360610018004";51;192;11;0;39;293
"3250";"360610018005";91;337;31;6;655;1120
"3251";"360610018006";55;255;33;0;45;388
"3252";"360610018007";91;178;11;8;80;368
"3253";"360610020001";203;41;16;1;52;313
"3254";"360610020002";339;183;170;8;44;744
"3255";"360610020003";66;42;114;11;21;254
"3256";"360610021001";212;231;163;2;480;1088
"3257";"360610021002";34;122;51;8;182;397
"3258";"360610022011";425;127;358;5;62;977
"3259";"360610022012";203;346;251;2;98;900
"3260";"360610022013";342;45;19;1;28;435
"3261";"360610022014";72;32;11;0;34;149
"3262";"360610022021";359;513;181;7;180;1240
"3263";"360610024001";1555;701;188;11;157;2612
"3264";"360610024002";155;177;39;2;44;417
"3265";"360610025001";223;188;37;1;69;518
"3266";"360610025002";67;20;18;4;54;163
"3267";"360610025003";123;66;6;0;55;250
"3268";"360610026011";505;778;226;7;169;1685
"3269";"360610026012";375;658;115;9;111;1268
"3270";"360610026021";341;235;178;5;83;842
"3271";"360610026022";366;222;81;6;137;812
"3272";"360610027001";76;78;48;5;64;271
"3273";"360610028001";86;100;8;2;38;234
"3274";"360610028002";117;82;117;1;60;377
"3275";"360610028003";297;152;19;3;93;564
"3276";"360610028004";98;217;38;9;74;436
"3277";"360610029001";22;65;25;6;58;176
"3278";"360610029002";83;76;8;2;31;200
"3279";"360610029003";74;159;31;2;38;304
"3280";"360610029004";6;44;84;3;102;239
"3281";"360610030011";177;812;137;0;114;1240
"3282";"360610030012";253;734;62;8;101;1158
"3283";"360610030013";191;256;290;1;45;783
"3284";"360610030014";203;143;72;2;60;480
"3285";"360610030021";429;280;44;3;181;937
"3286";"360610030022";209;237;50;0;113;609
"3287";"360610031001";69;188;394;3;577;1231
"3288";"360610032001";338;692;74;10;177;1291
"3289";"360610032002";152;243;35;2;33;465
"3290";"360610032003";43;78;80;1;36;238
"3291";"360610032004";156;64;21;3;37;281
"3292";"360610032005";59;211;25;3;68;366
"3293";"360610032006";460;114;41;9;100;724
"3294";"360610032007";108;537;93;3;179;920
"3295";"360610033001";324;245;162;2;209;942
"3296";"360610033002";70;162;117;2;52;403
"3297";"360610033003";64;41;129;1;134;369
"3298";"360610034001";373;225;87;2;145;832
"3299";"360610034002";412;970;278;0;177;1837
"3300";"360610034003";244;244;122;8;128;746
"3301";"360610034004";319;323;89;15;335;1081
"3302";"360610036011";57;303;134;1;35;530
"3303";"360610036012";156;515;207;11;113;1002
"3304";"360610036013";61;116;59;3;86;325
"3305";"360610036021";491;228;65;3;204;991
"3306";"360610036022";89;78;52;6;72;297
"3307";"360610037001";32;99;174;5;98;408
"3308";"360610037002";64;293;97;5;251;710
"3309";"360610037003";77;262;180;12;191;722
"3310";"360610038001";190;568;66;2;128;954
"3311";"360610038002";49;22;12;0;19;102
"3312";"360610038003";221;196;54;7;116;594
"3313";"360610038004";274;80;8;3;67;432
"3314";"360610038005";344;59;33;10;69;515
"3315";"360610038006";69;45;8;0;50;172
"3316";"360610038007";394;137;36;6;80;653
"3317";"360610039000";0;0;0;0;1;1
"3318";"360610039001";74;83;85;3;97;342
"3319";"360610039002";31;31;19;2;46;129
"3320";"360610039003";3;5;13;0;22;43
"3321";"360610039004";130;161;77;6;86;460
"3322";"360610040001";374;74;49;4;66;567
"3323";"360610040002";71;19;22;1;22;135
"3324";"360610040003";65;102;17;4;63;251
"3325";"360610040004";285;43;13;1;33;375
"3326";"360610040005";178;36;17;1;52;284
"3327";"360610040006";380;105;97;2;51;635
"3328";"360610041001";93;106;35;3;67;304
"3329";"360610041002";49;71;24;1;53;198
"3330";"360610041003";102;43;22;11;34;212
"3331";"360610041004";193;351;26;6;84;660
"3332";"360610041005";57;82;36;4;36;215
"3333";"360610041006";106;141;56;0;50;353
"3334";"360610042001";87;184;111;2;83;467
"3335";"360610042002";112;99;21;1;56;289
"3336";"360610043001";207;211;102;6;92;618
"3337";"360610043002";71;77;33;2;42;225
"3338";"360610043003";157;158;240;3;145;703
"3339";"360610044001";11;6;14;1;12;44
"3340";"360610044002";235;9;26;0;8;278
"3341";"360610044003";35;5;30;1;20;91
"3342";"360610044004";8;7;31;0;28;74
"3343";"360610044005";5;11;10;1;20;47
"3344";"360610044006";5;1;1;0;5;12
"3345";"360610044007";36;47;30;1;82;196
"3346";"360610044008";11;14;22;1;22;70
"3347";"360610045001";91;172;106;8;208;585
"3348";"360610047001";87;130;45;0;46;308
"3349";"360610047002";260;312;81;8;119;780
"3350";"360610048001";42;20;88;1;18;169
"3351";"360610048002";24;7;15;0;12;58
"3352";"360610048003";11;12;23;0;39;85
"3353";"360610048004";70;30;37;5;83;225
"3354";"360610048005";71;113;21;5;112;322
"3355";"360610048006";153;13;39;4;27;236
"3356";"360610048007";2;5;7;0;21;35
"3357";"360610049001";213;260;169;0;165;807
"3358";"360610049002";232;219;64;11;150;676
"3359";"360610049003";209;214;70;4;52;549
"3360";"360610050001";29;83;14;1;48;175
"3361";"360610050002";81;51;36;0;72;240
"3362";"360610050003";36;108;65;2;67;278
"3363";"360610050004";23;51;19;1;26;120
"3364";"360610050005";48;34;32;0;30;144
"3365";"360610052001";80;386;36;3;335;840
"3366";"360610052002";146;406;65;3;183;803
"3367";"360610054001";144;173;34;6;161;518
"3368";"360610054002";48;19;20;0;39;126
"3369";"360610054003";16;30;16;3;45;110
"3370";"360610055011";75;74;16;1;43;209
"3371";"360610055012";7;16;20;1;24;68
"3372";"360610055013";28;11;9;1;24;73
"3373";"360610055021";43;45;22;3;36;149
"3374";"360610055022";144;239;98;3;213;697
"3375";"360610056001";102;88;105;0;133;428
"3376";"360610056002";33;429;28;0;214;704
"3377";"360610056003";31;48;16;1;19;115
"3378";"360610057001";5;79;21;0;112;217
"3379";"360610057002";25;78;28;0;82;213
"3380";"360610058001";219;358;134;8;429;1148
"3381";"360610059001";14;23;12;3;61;113
"3382";"360610059002";8;290;4;0;110;412
"3383";"360610059003";31;193;18;4;71;317
"3384";"360610059004";72;7;9;0;12;100
"3385";"360610059005";4;15;10;0;19;48
"3386";"360610060001";130;7;42;0;21;200
"3387";"360610060002";72;22;18;1;61;174
"3388";"360610060003";3;3;3;0;7;16
"3389";"360610061001";181;136;151;3;115;586
"3390";"360610061002";54;49;78;0;46;227
"3391";"360610061003";49;200;174;3;151;577
"3392";"360610062000";0;0;2;0;0;2
"3393";"360610062001";21;22;386;4;98;531
"3394";"360610062002";9;8;62;2;19;100
"3395";"360610063001";53;67;78;0;70;268
"3396";"360610063002";53;39;32;1;36;161
"3397";"360610063003";41;50;36;7;42;176
"3398";"360610063004";102;100;11;2;80;295
"3399";"360610063005";22;122;18;0;75;237
"3400";"360610064001";53;82;41;3;68;247
"3401";"360610064002";823;85;59;4;35;1006
"3402";"360610064003";37;61;65;1;24;188
"3403";"360610064004";78;56;91;0;79;304
"3404";"360610064005";21;22;19;1;26;89
"3405";"360610064006";18;17;26;5;79;145
"3406";"360610065001";108;407;66;7;312;900
"3407";"360610065002";159;624;158;4;107;1052
"3408";"360610065003";76;414;81;1;77;649
"3409";"360610065004";66;227;15;7;104;419
"3410";"360610065005";212;234;39;10;44;539
"3411";"360610066001";70;138;12;2;42;264
"3412";"360610066002";72;100;10;0;76;258
"3413";"360610066003";99;81;58;0;85;323
"3414";"360610066004";66;28;24;0;19;137
"3415";"360610066005";67;21;10;0;30;128
"3416";"360610066006";26;8;34;1;20;89
"3417";"360610066007";40;37;36;2;27;142
"3418";"360610066008";319;246;120;2;123;810
"3419";"360610066009";20;43;34;3;38;138
"3420";"360610067001";233;330;58;7;84;712
"3421";"360610067002";119;193;54;12;91;469
"3422";"360610067003";221;173;107;7;40;548
"3423";"360610067004";107;83;83;6;73;352
"3424";"360610068001";48;49;93;4;35;229
"3425";"360610068002";19;16;10;1;37;83
"3426";"360610068003";55;53;13;0;37;158
"3427";"360610068004";173;19;8;1;18;219
"3428";"360610068005";40;18;11;0;20;89
"3429";"360610068006";282;65;38;1;71;457
"3430";"360610069001";139;188;122;7;162;618
"3431";"360610070001";166;59;28;2;72;327
"3432";"360610070002";86;46;44;0;62;238
"3433";"360610070003";138;101;70;1;75;385
"3434";"360610070004";13;22;25;2;83;145
"3435";"360610070005";5;4;18;1;11;39
"3436";"360610070006";48;6;46;0;29;129
"3437";"360610071001";45;45;27;2;33;152
"3438";"360610071002";46;14;21;1;33;115
"3439";"360610071003";88;204;38;0;87;417
"3440";"360610071004";194;105;29;4;50;382
"3441";"360610071005";71;484;53;1;270;879
"3442";"360610072001";25;15;8;0;12;60
"3443";"360610072002";80;65;267;3;215;630
"3444";"360610072003";70;50;49;1;52;222
"3445";"360610072004";111;117;38;2;93;361
"3446";"360610072005";32;108;9;1;68;218
"3447";"360610072006";68;20;9;2;99;198
"3448";"360610072007";14;23;9;0;34;80
"3449";"360610073001";156;45;36;8;34;279
"3450";"360610073002";55;47;23;3;25;153
"3451";"360610073003";150;87;24;3;30;294
"3452";"360610073004";199;672;64;7;209;1151
"3453";"360610073005";105;11;10;1;14;141
"3454";"360610073006";182;198;76;4;136;596
"3455";"360610074001";62;104;42;3;177;388
"3456";"360610074002";42;64;24;2;48;180
"3457";"360610074003";60;94;84;2;119;359
"3458";"360610075000";0;10;0;0;5;15
"3459";"360610075001";91;38;80;5;61;275
"3460";"360610075002";52;90;60;8;20;230
"3461";"360610075003";87;275;77;13;109;561
"3462";"360610076001";179;267;162;5;281;894
"3463";"360610076002";395;283;243;6;144;1071
"3464";"360610077001";105;60;51;11;81;308
"3465";"360610077002";76;80;18;1;22;197
"3466";"360610077003";147;122;42;5;145;461
"3467";"360610077004";74;90;19;9;73;265
"3468";"360610077005";56;24;30;2;31;143
"3469";"360610078001";48;22;183;1;27;281
"3470";"360610078002";61;44;78;0;39;222
"3471";"360610078003";36;7;2;0;12;57
"3472";"360610078004";88;41;12;1;44;186
"3473";"360610078005";31;10;42;0;34;117
"3474";"360610078006";53;13;66;5;31;168
"3475";"360610078007";92;20;116;3;21;252
"3476";"360610079001";50;190;61;8;118;427
"3477";"360610079002";23;17;20;0;9;69
"3478";"360610079003";91;101;49;5;31;277
"3479";"360610079004";22;29;49;2;20;122
"3480";"360610080001";43;27;53;0;119;242
"3481";"360610080002";73;114;55;1;71;314
"3482";"360610080003";20;25;22;0;15;82
"3483";"360610080004";43;37;20;1;21;122
"3484";"360610080005";95;31;9;0;53;188
"3485";"360610081001";72;53;75;0;139;339
"3486";"360610081002";82;50;59;3;69;263
"3487";"360610081003";51;29;41;1;65;187
"3488";"360610081004";37;72;25;12;260;406
"3489";"360610081005";141;62;34;2;34;273
"3490";"360610081006";154;65;38;4;46;307
"3491";"360610082001";34;91;93;1;117;336
"3492";"360610082002";32;88;21;1;401;543
"3493";"360610082003";28;25;12;0;56;121
"3494";"360610083001";149;511;63;4;52;779
"3495";"360610083002";57;58;63;1;193;372
"3496";"360610083003";292;163;77;3;92;627
"3497";"360610084001";1;29;34;2;194;260
"3498";"360610084002";46;123;170;6;170;515
"3499";"360610086010";0;9;1;0;3;13
"3500";"360610086011";5;18;67;6;63;159
"3501";"360610086012";75;22;66;2;82;247
"3502";"360610086020";1;0;0;0;1;2
"3503";"360610086021";10;21;15;0;24;70
"3504";"360610086031";11;20;4;4;16;55
"3505";"360610086032";2;9;17;3;13;44
"3506";"360610086033";4;10;38;3;25;80
"3507";"360610086034";23;61;45;2;21;152
"3508";"360610087001";93;93;50;11;94;341
"3509";"360610087002";46;59;24;15;83;227
"3510";"360610087003";51;38;25;5;57;176
"3511";"360610087004";94;75;20;5;35;229
"3512";"360610087005";79;36;10;4;32;161
"3513";"360610088001";70;76;78;3;107;334
"3514";"360610088002";53;43;57;1;49;203
"3515";"360610088003";5;6;87;0;7;105
"3516";"360610088004";11;27;75;4;8;125
"3517";"360610088005";10;20;32;0;13;75
"3518";"360610088006";57;8;46;0;20;131
"3519";"360610088007";11;14;25;0;6;56
"3520";"360610089001";80;152;11;1;38;282
"3521";"360610089002";156;88;20;6;57;327
"3522";"360610089003";173;230;43;3;71;520
"3523";"360610089004";100;15;47;1;28;191
"3524";"360610089005";86;126;15;5;46;278
"3525";"360610090001";57;148;73;0;69;347
"3526";"360610090002";207;13;30;0;10;260
"3527";"360610090003";18;39;22;0;19;98
"3528";"360610090004";104;218;179;0;44;545
"3529";"360610090005";21;32;16;3;17;89
"3530";"360610090006";25;36;5;2;21;89
"3531";"360610091001";237;236;60;20;422;975
"3532";"360610091002";76;69;30;8;67;250
"3533";"360610091003";105;24;2;16;66;213
"3534";"360610091004";50;33;10;3;58;154
"3535";"360610092001";61;143;117;2;2125;2448
"3536";"360610093001";20;33;24;3;40;120
"3537";"360610093002";133;108;117;6;419;783
"3538";"360610093003";4;43;19;1;73;140
"3539";"360610093004";8;2;6;0;9;25
"3540";"360610093005";78;92;15;10;50;245
"3541";"360610093006";205;104;17;1;98;425
"3542";"360610093007";114;18;13;4;33;182
"3543";"360610094001";13;42;98;2;190;345
"3544";"360610095001";80;218;106;9;261;674
"3545";"360610095002";96;48;45;2;64;255
"3546";"360610096001";39;111;176;6;199;531
"3547";"360610097001";10;18;53;6;37;124
"3548";"360610097002";137;37;30;2;145;351
"3549";"360610097003";3;3;4;0;0;10
"3550";"360610097004";956;33;43;2;50;1084
"3551";"360610098001";61;129;43;2;20;255
"3552";"360610098002";57;99;102;1;53;312
"3553";"360610098003";51;85;15;0;73;224
"3554";"360610098004";33;20;32;1;51;137
"3555";"360610098005";50;18;24;9;13;114
"3556";"360610098006";60;60;154;13;47;334
"3557";"360610098007";65;37;29;2;31;164
"3558";"360610099000";0;0;0;0;2;2
"3559";"360610099001";405;481;850;23;542;2301
"3560";"360610100001";18;56;315;1;72;462
"3561";"360610100002";38;53;133;7;116;347
"3562";"360610101001";64;131;166;6;750;1117
"3563";"360610102001";11;22;142;3;297;475
"3564";"360610103001";220;93;199;6;255;773
"3565";"360610104001";18;109;252;8;696;1083
"3566";"360610106011";4;8;21;1;13;47
"3567";"360610106012";36;27;67;0;17;147
"3568";"360610106013";4;21;18;0;18;61
"3569";"360610106014";17;11;15;0;10;53
"3570";"360610106015";8;11;12;0;4;35
"3571";"360610106016";3;10;32;0;14;59
"3572";"360610106020";2;2;1;0;22;27
"3573";"360610106021";13;34;13;3;14;77
"3574";"360610106022";24;23;104;6;69;226
"3575";"360610106023";3;9;21;7;28;68
"3576";"360610108001";20;10;10;1;18;59
"3577";"360610108002";20;11;17;2;13;63
"3578";"360610108003";22;27;19;1;37;106
"3579";"360610108004";0;11;11;0;5;27
"3580";"360610108005";92;14;23;0;18;147
"3581";"360610108006";20;21;14;1;50;106
"3582";"360610108007";41;38;79;3;89;250
"3583";"360610109001";58;530;118;3;597;1306
"3584";"360610110001";24;33;15;1;41;114
"3585";"360610110002";13;20;21;1;32;87
"3586";"360610110003";69;24;52;2;52;199
"3587";"360610110004";13;11;19;0;8;51
"3588";"360610110005";27;32;17;2;13;91
"3589";"360610110006";87;82;92;1;74;336
"3590";"360610111001";192;615;217;5;234;1263
"3591";"360610111002";37;91;46;2;189;365
"3592";"360610111003";71;37;29;1;103;241
"3593";"360610112011";24;69;70;3;159;325
"3594";"360610112021";4;35;145;1;94;279
"3595";"360610112031";17;14;12;2;60;105
"3596";"360610112032";14;4;22;0;29;69
"3597";"360610113001";12;105;248;9;927;1301
"3598";"360610114011";9;42;80;0;44;175
"3599";"360610114012";6;10;80;3;38;137
"3600";"360610114021";14;74;33;2;150;273
"3601";"360610114022";45;44;62;3;57;211
"3602";"360610115001";61;191;153;6;142;553
"3603";"360610115002";54;130;40;2;210;436
"3604";"360610116001";32;15;163;0;50;260
"3605";"360610116002";19;22;22;1;13;77
"3606";"360610116003";50;16;9;0;18;93
"3607";"360610117000";0;0;0;0;1;1
"3608";"360610117001";63;69;57;7;90;286
"3609";"360610118001";18;20;5;0;16;59
"3610";"360610118002";7;6;18;0;12;43
"3611";"360610118003";9;7;11;0;8;35
"3612";"360610118004";197;62;79;2;55;395
"3613";"360610118005";38;14;21;1;23;97
"3614";"360610118006";33;16;103;1;23;176
"3615";"360610118007";5;9;16;0;11;41
"3616";"360610118008";7;15;13;0;24;59
"3617";"360610119001";20;116;70;1;300;507
"3618";"360610119002";75;125;40;1;194;435
"3619";"360610120001";3;12;26;4;42;87
"3620";"360610120002";102;19;13;3;99;236
"3621";"360610120003";56;8;33;3;42;142
"3622";"360610120004";10;9;59;8;115;201
"3623";"360610121001";109;154;70;6;126;465
"3624";"360610121002";37;34;9;1;31;112
"3625";"360610121003";56;58;19;0;59;192
"3626";"360610121004";78;183;35;2;118;416
"3627";"360610121005";117;161;15;2;47;342
"3628";"360610121006";74;304;24;3;67;472
"3629";"360610122001";6;7;25;2;61;101
"3630";"360610122002";16;17;21;0;14;68
"3631";"360610122003";14;15;27;3;49;108
"3632";"360610122004";13;9;85;0;46;153
"3633";"360610124001";137;19;67;6;34;263
"3634";"360610124002";25;13;19;0;31;88
"3635";"360610124003";14;11;26;0;11;62
"3636";"360610124004";80;35;34;1;14;164
"3637";"360610124005";5;8;12;2;11;38
"3638";"360610124006";8;8;24;0;18;58
"3639";"360610124007";6;6;44;6;5;67
"3640";"360610124008";0;3;9;2;4;18
"3641";"360610125001";46;106;194;2;276;624
"3642";"360610125002";37;325;107;0;169;638
"3643";"360610126001";115;175;137;3;87;517
"3644";"360610126002";16;13;15;2;129;175
"3645";"360610126003";5;8;32;0;9;54
"3646";"360610126004";41;19;35;0;37;132
"3647";"360610126005";16;13;26;0;36;91
"3648";"360610126006";68;33;26;3;65;195
"3649";"360610126007";21;18;17;0;25;81
"3650";"360610126008";25;40;28;0;32;125
"3651";"360610127001";67;81;13;0;42;203
"3652";"360610127002";194;243;24;2;75;538
"3653";"360610127003";213;85;22;9;84;413
"3654";"360610127004";174;452;93;6;94;819
"3655";"360610127005";4;90;11;3;122;230
"3656";"360610128001";7;24;102;2;26;161
"3657";"360610128002";4;6;32;0;16;58
"3658";"360610128003";6;11;34;1;30;82
"3659";"360610128004";8;15;55;0;68;146
"3660";"360610128005";16;13;24;5;21;79
"3661";"360610129001";182;261;206;22;198;869
"3662";"360610129002";466;406;226;41;199;1338
"3663";"360610130001";6;3;40;1;15;65
"3664";"360610130002";5;7;44;3;27;86
"3665";"360610130003";6;22;26;2;33;89
"3666";"360610130004";5;6;43;2;28;84
"3667";"360610131001";37;451;117;4;204;813
"3668";"360610131002";31;476;69;9;159;744
"3669";"360610132001";85;11;11;7;29;143
"3670";"360610132002";63;48;32;0;32;175
"3671";"360610132003";29;16;15;0;17;77
"3672";"360610132004";56;44;46;6;42;194
"3673";"360610132005";49;11;32;0;16;108
"3674";"360610132006";27;34;108;0;41;210
"3675";"360610132007";15;20;31;3;10;79
"3676";"360610133001";63;29;9;3;92;196
"3677";"360610133002";187;221;20;4;98;530
"3678";"360610133003";163;912;97;3;325;1500
"3679";"360610133004";60;196;44;4;69;373
"3680";"360610133005";101;69;82;4;69;325
"3681";"360610134001";49;25;11;1;16;102
"3682";"360610134002";45;34;15;1;17;112
"3683";"360610134003";71;29;20;1;18;139
"3684";"360610134004";9;27;10;0;21;67
"3685";"360610134005";35;97;11;0;35;178
"3686";"360610134006";18;18;32;2;27;97
"3687";"360610134007";41;89;23;0;46;199
"3688";"360610134008";53;29;22;1;29;134
"3689";"360610134009";76;88;20;1;30;215
"3690";"360610135001";226;249;107;4;196;782
"3691";"360610135002";151;399;275;17;240;1082
"3692";"360610136001";68;25;22;2;25;142
"3693";"360610136002";28;23;35;1;31;118
"3694";"360610136003";39;21;54;1;24;139
"3695";"360610136004";46;18;33;0;37;134
"3696";"360610136005";4;27;56;7;68;162
"3697";"360610136006";18;5;14;1;8;46
"3698";"360610136007";42;9;16;0;23;90
"3699";"360610136008";104;50;34;0;45;233
"3700";"360610137001";9;10;28;0;47;94
"3701";"360610137002";22;72;37;0;54;185
"3702";"360610137003";38;140;137;2;141;458
"3703";"360610137004";13;101;969;2;135;1220
"3704";"360610137005";12;79;14;1;89;195
"3705";"360610137006";51;197;35;2;73;358
"3706";"360610138001";80;24;15;1;42;162
"3707";"360610138002";46;46;10;3;35;140
"3708";"360610138003";29;28;25;0;19;101
"3709";"360610138004";210;96;32;0;81;419
"3710";"360610138005";96;17;21;0;15;149
"3711";"360610138006";50;78;21;0;37;186
"3712";"360610138007";54;8;30;3;7;102
"3713";"360610138008";24;23;35;1;9;92
"3714";"360610138009";12;19;9;0;22;62
"3715";"360610139001";22;27;42;0;43;134
"3716";"360610139002";97;125;5;5;100;332
"3717";"360610139003";94;243;55;6;139;537
"3718";"360610139004";179;59;60;3;35;336
"3719";"360610139005";36;49;108;4;66;263
"3720";"360610139006";26;36;37;0;42;141
"3721";"360610139007";15;63;43;1;66;188
"3722";"360610140001";34;26;40;1;48;149
"3723";"360610140002";89;32;24;2;46;193
"3724";"360610140003";46;16;18;1;41;122
"3725";"360610140004";3;7;48;1;19;78
"3726";"360610140005";49;72;34;0;20;175
"3727";"360610140006";34;11;28;0;16;89
"3728";"360610142001";6;9;190;0;15;220
"3729";"360610142002";11;2;30;1;11;55
"3730";"360610142003";5;5;14;0;12;36
"3731";"360610142004";7;2;21;0;34;64
"3732";"360610142005";24;41;14;0;20;99
"3733";"360610142006";19;38;23;3;21;104
"3734";"360610143001";51;1114;208;6;1156;2535
"3735";"360610144011";9;9;16;0;15;49
"3736";"360610144012";12;15;9;1;16;53
"3737";"360610144013";13;23;18;1;15;70
"3738";"360610144014";59;18;18;3;10;108
"3739";"360610144021";11;16;42;1;21;91
"3740";"360610144022";84;50;12;0;24;170
"3741";"360610144023";54;15;15;2;37;123
"3742";"360610144024";251;139;73;0;173;636
"3743";"360610144025";33;20;30;0;20;103
"3744";"360610145001";18;23;60;4;35;140
"3745";"360610145002";11;13;14;0;19;57
"3746";"360610145003";10;56;146;5;397;614
"3747";"360610145004";10;29;40;0;76;155
"3748";"360610146011";32;110;68;2;158;370
"3749";"360610146012";65;83;11;0;48;207
"3750";"360610146013";48;690;65;1;238;1042
"3751";"360610146014";46;65;15;0;54;180
"3752";"360610146021";13;24;16;2;17;72
"3753";"360610146022";31;34;17;1;26;109
"3754";"360610146023";162;86;15;1;50;314
"3755";"360610146024";81;52;18;0;20;171
"3756";"360610146025";51;16;54;4;12;137
"3757";"360610146026";77;51;32;4;44;208
"3758";"360610147001";20;37;127;2;46;232
"3759";"360610148011";43;26;14;1;41;125
"3760";"360610148012";22;132;28;1;109;292
"3761";"360610148021";61;31;14;1;15;122
"3762";"360610148022";32;45;78;1;84;240
"3763";"360610148023";9;36;19;0;18;82
"3764";"360610148024";17;11;14;0;9;51
"3765";"360610148025";10;8;12;3;26;59
"3766";"360610149001";10;41;42;5;562;660
"3767";"360610149002";4;7;60;4;45;120
"3768";"360610149003";19;15;23;1;41;99
"3769";"360610149004";6;13;41;0;148;208
"3770";"360610149005";4;15;10;0;182;211
"3771";"360610150011";3;8;137;0;23;171
"3772";"360610150012";5;30;13;0;29;77
"3773";"360610150021";25;15;56;1;21;118
"3774";"360610150022";4;6;19;0;14;43
"3775";"360610150023";1;4;29;0;11;45
"3776";"360610150024";17;25;30;0;30;102
"3777";"360610151001";90;51;17;2;51;211
"3778";"360610151002";181;31;45;1;55;313
"3779";"360610151003";58;20;47;0;20;145
"3780";"360610151004";279;115;139;4;178;715
"3781";"360610152001";83;23;13;0;44;163
"3782";"360610152002";186;71;28;0;80;365
"3783";"360610152003";3;8;42;0;19;72
"3784";"360610152004";14;15;20;1;9;59
"3785";"360610152005";25;7;19;2;11;64
"3786";"360610152006";47;25;62;0;67;201
"3787";"360610153001";33;52;16;1;127;229
"3788";"360610153002";19;85;42;4;68;218
"3789";"360610153003";25;33;44;5;165;272
"3790";"360610153004";6;25;33;6;268;338
"3791";"360610153005";32;26;12;1;14;85
"3792";"360610153006";30;21;45;4;31;131
"3793";"360610153007";22;56;69;0;39;186
"3794";"360610154001";114;119;44;1;62;340
"3795";"360610154002";26;24;14;2;31;97
"3796";"360610154003";129;32;43;3;55;262
"3797";"360610154004";28;14;14;0;50;106
"3798";"360610154005";100;20;19;4;49;192
"3799";"360610154006";121;32;19;0;21;193
"3800";"360610154007";22;18;11;0;39;90
"3801";"360610154008";77;30;28;1;30;166
"3802";"360610154009";36;16;23;0;69;144
"3803";"360610155001";3;3;22;1;13;42
"3804";"360610155002";5;7;19;4;18;53
"3805";"360610155003";4;3;4;0;2;13
"3806";"360610155004";2;2;8;0;2;14
"3807";"360610155005";2;8;6;1;2;19
"3808";"360610155006";21;48;30;0;45;144
"3809";"360610156011";32;32;38;3;47;152
"3810";"360610156012";27;28;56;5;61;177
"3811";"360610156013";34;77;30;6;57;204
"3812";"360610156014";7;39;10;1;63;120
"3813";"360610156021";104;65;147;7;177;500
"3814";"360610157001";35;48;46;3;26;158
"3815";"360610157002";32;60;28;0;41;161
"3816";"360610157003";46;31;41;1;35;154
"3817";"360610157004";24;19;29;1;26;99
"3818";"360610157005";25;152;57;2;22;258
"3819";"360610157006";53;186;22;10;97;368
"3820";"360610157007";48;98;14;12;103;275
"3821";"360610157008";36;46;24;0;39;145
"3822";"360610158011";14;27;64;3;49;157
"3823";"360610158012";48;21;21;3;69;162
"3824";"360610158013";9;17;10;0;13;49
"3825";"360610158014";7;10;30;0;85;132
"3826";"360610158021";19;27;53;0;52;151
"3827";"360610158022";99;184;65;0;54;402
"3828";"360610159001";12;19;89;0;17;137
"3829";"360610159002";11;6;49;0;22;88
"3830";"360610159003";22;22;49;0;10;103
"3831";"360610159004";17;70;20;1;51;159
"3832";"360610159005";48;152;7;0;106;313
"3833";"360610159006";37;98;9;3;254;401
"3834";"360610159007";21;28;16;14;33;112
"3835";"360610160011";11;5;24;1;16;57
"3836";"360610160012";9;7;62;0;17;95
"3837";"360610160013";5;12;45;0;14;76
"3838";"360610160014";12;17;20;1;13;63
"3839";"360610160021";8;10;17;2;19;56
"3840";"360610160022";22;8;64;0;9;103
"3841";"360610161001";56;64;52;3;63;238
"3842";"360610161002";35;13;36;0;58;142
"3843";"360610161003";28;15;38;0;54;135
"3844";"360610161004";98;29;168;2;45;342
"3845";"360610161005";32;25;28;2;27;114
"3846";"360610161006";70;82;17;2;38;209
"3847";"360610162000";34;6;6;0;5;51
"3848";"360610162001";23;49;27;4;27;130
"3849";"360610162002";95;137;13;0;8;253
"3850";"360610162003";141;66;22;3;43;275
"3851";"360610162004";256;124;35;4;103;522
"3852";"360610162005";37;48;70;6;52;213
"3853";"360610163001";47;10;36;4;18;115
"3854";"360610163002";27;25;170;1;20;243
"3855";"360610163003";36;382;17;1;74;510
"3856";"360610163004";19;39;63;2;88;211
"3857";"360610163005";18;103;57;10;43;231
"3858";"360610164001";67;93;38;1;36;235
"3859";"360610164002";195;173;144;3;109;624
"3860";"360610164003";461;64;24;2;38;589
"3861";"360610164004";88;59;19;5;37;208
"3862";"360610165001";16;21;130;1;61;229
"3863";"360610165002";40;13;52;2;36;143
"3864";"360610165003";32;42;38;0;25;137
"3865";"360610165004";27;15;53;4;27;126
"3866";"360610165005";16;34;37;1;28;116
"3867";"360610166001";565;126;13;0;71;775
"3868";"360610166002";95;100;59;5;25;284
"3869";"360610166003";83;64;52;4;34;237
"3870";"360610166004";133;147;65;8;20;373
"3871";"360610166005";106;110;15;1;41;273
"3872";"360610166006";587;394;61;3;77;1122
"3873";"360610167001";15;27;19;1;25;87
"3874";"360610167002";5;13;21;5;11;55
"3875";"360610167003";11;111;27;0;178;327
"3876";"360610167004";73;67;24;3;75;242
"3877";"360610167005";38;117;45;6;72;278
"3878";"360610168001";143;124;32;3;86;388
"3879";"360610168002";340;89;178;4;68;679
"3880";"360610168003";25;354;101;2;85;567
"3881";"360610169001";43;58;21;0;58;180
"3882";"360610169002";65;58;49;2;16;190
"3883";"360610169003";67;174;51;0;63;355
"3884";"360610169004";87;104;255;4;90;540
"3885";"360610169005";70;41;67;0;8;186
"3886";"360610169006";111;18;42;6;16;193
"3887";"360610170001";36;77;112;6;30;261
"3888";"360610170002";221;56;31;4;45;357
"3889";"360610170003";145;176;78;4;77;480
"3890";"360610170004";34;332;61;3;75;505
"3891";"360610170005";113;216;67;1;59;456
"3892";"360610171001";36;30;18;0;47;131
"3893";"360610171002";98;180;75;9;200;562
"3894";"360610171003";19;61;16;1;46;143
"3895";"360610171004";26;8;48;0;7;89
"3896";"360610171005";124;56;37;3;18;238
"3897";"360610171006";3;7;20;1;16;47
"3898";"360610172001";177;313;91;10;133;724
"3899";"360610172002";128;53;11;3;36;231
"3900";"360610172003";307;71;101;5;39;523
"3901";"360610172004";311;185;57;2;86;641
"3902";"360610172005";76;53;55;7;36;227
"3903";"360610173001";154;25;17;1;27;224
"3904";"360610173002";30;27;10;0;19;86
"3905";"360610173003";193;123;121;2;65;504
"3906";"360610173004";31;30;50;2;21;134
"3907";"360610173005";7;8;29;3;13;60
"3908";"360610173006";50;53;30;0;24;157
"3909";"360610173007";53;10;38;1;28;130
"3910";"360610174011";92;76;26;2;53;249
"3911";"360610174012";38;92;23;6;24;183
"3912";"360610174013";147;255;43;5;66;516
"3913";"360610174021";143;277;78;2;79;579
"3914";"360610175001";30;23;56;2;43;154
"3915";"360610175002";15;22;23;0;13;73
"3916";"360610175003";17;19;21;2;29;88
"3917";"360610175004";7;32;44;3;34;120
"3918";"360610175005";4;10;9;0;12;35
"3919";"360610175006";16;56;66;1;32;171
"3920";"360610175007";31;149;21;2;127;330
"3921";"360610177001";35;57;17;10;32;151
"3922";"360610177002";65;47;11;1;28;152
"3923";"360610177003";70;115;358;1;39;583
"3924";"360610177004";1086;100;138;2;181;1507
"3925";"360610177005";48;39;68;5;43;203
"3926";"360610177006";111;25;100;5;24;265
"3927";"360610177007";49;43;32;0;21;145
"3928";"360610177008";89;55;54;1;18;217
"3929";"360610178001";143;217;135;2;68;565
"3930";"360610178002";74;264;77;1;49;465
"3931";"360610178003";353;636;150;18;145;1302
"3932";"360610179001";30;23;36;3;35;127
"3933";"360610179002";30;5;6;3;2;46
"3934";"360610179003";9;12;20;2;9;52
"3935";"360610179004";40;161;37;1;58;297
"3936";"360610179005";32;16;15;0;19;82
"3937";"360610179006";187;259;21;8;78;553
"3938";"360610179007";45;45;66;2;31;189
"3939";"360610180001";359;682;151;8;53;1253
"3940";"360610180002";116;392;150;5;54;717
"3941";"360610180003";152;451;94;2;55;754
"3942";"360610180004";101;434;9;2;21;567
"3943";"360610181001";29;69;39;1;40;178
"3944";"360610181002";36;44;24;0;24;128
"3945";"360610181003";22;19;30;3;35;109
"3946";"360610181004";17;13;27;1;9;67
"3947";"360610181005";9;9;16;1;8;43
"3948";"360610181006";20;10;9;3;29;71
"3949";"360610182001";262;190;20;3;101;576
"3950";"360610182002";175;160;73;4;72;484
"3951";"360610182003";392;244;57;4;230;927
"3952";"360610182004";134;207;21;2;67;431
"3953";"360610182005";295;67;16;0;71;449
"3954";"360610183001";39;86;22;6;63;216
"3955";"360610183002";22;7;9;1;8;47
"3956";"360610183003";586;75;14;1;27;703
"3957";"360610183004";4;36;42;2;43;127
"3958";"360610183005";10;105;33;2;115;265
"3959";"360610183006";59;165;31;1;122;378
"3960";"360610183007";40;86;32;8;90;256
"3961";"360610184001";261;270;169;8;122;830
"3962";"360610184002";78;103;22;4;36;243
"3963";"360610184003";55;25;13;2;19;114
"3964";"360610184004";62;15;10;2;32;121
"3965";"360610185001";14;22;18;0;24;78
"3966";"360610185002";37;50;54;2;66;209
"3967";"360610185003";7;75;6;0;8;96
"3968";"360610186001";406;107;22;22;60;617
"3969";"360610186002";328;261;19;30;155;793
"3970";"360610186003";176;265;34;8;58;541
"3971";"360610187001";51;89;23;0;247;410
"3972";"360610187002";54;16;23;0;19;112
"3973";"360610187003";17;24;19;1;9;70
"3974";"360610187004";7;92;11;3;23;136
"3975";"360610187005";73;110;24;6;49;262
"3976";"360610187006";154;64;20;4;33;275
"3977";"360610188001";141;108;260;4;39;552
"3978";"360610188002";154;200;56;4;45;459
"3979";"360610188003";122;196;26;3;74;421
"3980";"360610188004";217;113;58;1;55;444
"3981";"360610189001";132;189;38;2;60;421
"3982";"360610189002";390;160;34;5;113;702
"3983";"360610189003";749;53;17;2;50;871
"3984";"360610189004";140;535;71;8;79;833
"3985";"360610189005";172;259;61;1;83;576
"3986";"360610189006";425;225;42;3;93;788
"3987";"360610190001";458;582;108;24;205;1377
"3988";"360610191001";42;78;47;1;27;195
"3989";"360610191002";20;26;70;0;23;139
"3990";"360610191003";23;13;7;3;5;51
"3991";"360610191004";153;31;13;2;14;213
"3992";"360610191005";137;367;57;2;66;629
"3993";"360610191006";126;154;33;5;144;462
"3994";"360610192000";5;6;3;0;0;14
"3995";"360610192001";549;366;214;6;79;1214
"3996";"360610192002";118;43;5;0;12;178
"3997";"360610192003";5;5;1;0;0;11
"3998";"360610193001";91;614;63;1;63;832
"3999";"360610193002";144;345;34;1;63;587
"4000";"360610193003";156;190;55;5;57;463
"4001";"360610193004";110;147;64;8;66;395
"4002";"360610193005";223;415;85;1;88;812
"4003";"360610193006";81;211;79;3;60;434
"4004";"360610194001";541;82;32;2;42;699
"4005";"360610194002";159;128;423;5;55;770
"4006";"360610194003";122;56;25;2;1547;1752
"4007";"360610194004";41;50;54;1;436;582
"4008";"360610195001";15;18;32;4;77;146
"4009";"360610195002";62;131;53;2;75;323
"4010";"360610195003";415;499;105;6;102;1127
"4011";"360610195004";127;110;25;2;29;293
"4012";"360610195005";55;42;42;0;29;168
"4013";"360610196001";146;196;145;6;55;548
"4014";"360610196002";88;89;47;8;110;342
"4015";"360610196003";160;118;64;5;309;656
"4016";"360610197011";57;215;162;3;136;573
"4017";"360610197021";256;410;201;4;124;995
"4018";"360610198001";55;147;217;11;116;546
"4019";"360610198002";7;117;57;0;108;289
"4020";"360610199001";18;11;18;2;72;121
"4021";"360610199002";11;20;55;3;42;131
"4022";"360610199003";43;12;20;1;11;87
"4023";"360610199004";9;6;33;1;18;67
"4024";"360610199005";50;39;83;0;55;227
"4025";"360610199006";49;38;85;2;74;248
"4026";"360610200001";236;97;269;4;50;656
"4027";"360610200002";324;502;426;22;301;1575
"4028";"360610201011";36;16;39;0;16;107
"4029";"360610201021";103;169;51;4;110;437
"4030";"360610201022";213;1278;109;4;71;1675
"4031";"360610201023";51;325;8;1;17;402
"4032";"360610201024";90;177;13;1;33;314
"4033";"360610203001";14;5;11;0;4;34
"4034";"360610203002";4;7;15;1;47;74
"4035";"360610205001";46;23;50;0;67;186
"4036";"360610205002";7;8;4;0;46;65
"4037";"360610205003";6;8;59;0;13;86
"4038";"360610206001";141;267;95;11;104;618
"4039";"360610206002";344;236;82;18;83;763
"4040";"360610207011";8;4;10;2;6;30
"4041";"360610207012";16;11;12;3;15;57
"4042";"360610208001";229;284;43;7;167;730
"4043";"360610208002";548;416;68;3;74;1109
"4044";"360610208003";122;178;157;2;54;513
"4045";"360610209011";66;54;62;3;78;263
"4046";"360610209012";86;79;23;1;72;261
"4047";"360610210000";12;13;2;0;1;28
"4048";"360610210001";120;120;50;11;70;371
"4049";"360610210002";343;156;51;5;106;661
"4050";"360610210003";389;197;182;3;66;837
"4051";"360610210004";377;195;46;5;82;705
"4052";"360610211001";35;95;100;4;62;296
"4053";"360610211002";37;73;31;4;55;200
"4054";"360610211003";157;140;212;6;110;625
"4055";"360610211004";215;90;39;1;43;388
"4056";"360610211005";79;25;20;1;36;161
"4057";"360610211006";9;48;18;1;41;117
"4058";"360610211007";49;15;20;0;9;93
"4059";"360610212001";99;220;119;1;179;618
"4060";"360610212002";3;22;29;0;58;112
"4061";"360610212003";85;284;34;0;56;459
"4062";"360610212004";108;538;222;2;78;948
"4063";"360610213031";120;121;34;7;51;333
"4064";"360610213032";50;71;64;5;94;284
"4065";"360610213033";154;251;25;2;57;489
"4066";"360610213034";287;495;23;15;44;864
"4067";"360610214001";383;421;133;6;107;1050
"4068";"360610214002";81;119;56;8;70;334
"4069";"360610215001";100;176;29;1;106;412
"4070";"360610215002";892;270;182;13;225;1582
"4071";"360610216001";186;421;75;7;131;820
"4072";"360610216002";90;400;66;4;89;649
"4073";"360610216003";152;721;106;1;93;1073
"4074";"360610216004";282;601;128;5;160;1176
"4075";"360610216005";180;302;104;7;63;656
"4076";"360610217031";20;112;83;1;77;293
"4077";"360610218001";97;262;78;12;144;593
"4078";"360610218002";275;1043;360;28;223;1929
"4079";"360610218003";239;832;342;9;158;1580
"4080";"360610218004";505;972;98;16;212;1803
"4081";"360610219000";0;0;0;0;4;4
"4082";"360610219001";175;160;98;6;193;632
"4083";"360610219002";137;484;37;5;75;738
"4084";"360610219003";319;35;28;9;52;443
"4085";"360610219004";123;38;27;1;24;213
"4086";"360610220001";93;376;65;5;75;614
"4087";"360610220002";174;444;124;5;69;816
"4088";"360610220003";52;132;31;2;37;254
"4089";"360610220004";129;328;116;0;87;660
"4090";"360610220005";119;511;53;0;119;802
"4091";"360610221021";182;288;115;22;116;723
"4092";"360610221022";97;143;160;23;87;510
"4093";"360610222001";162;324;92;6;116;700
"4094";"360610222002";173;359;79;8;137;756
"4095";"360610223011";323;699;65;1;135;1223
"4096";"360610223012";714;733;21;3;241;1712
"4097";"360610223013";334;551;21;4;130;1040
"4098";"360610223014";111;196;16;2;160;485
"4099";"360610223020";0;3;0;0;2;5
"4100";"360610223021";139;91;136;6;102;474
"4101";"360610224001";144;243;25;11;73;496
"4102";"360610224002";137;174;152;8;98;569
"4103";"360610224003";2206;698;19;4;136;3063
"4104";"360610224004";448;75;21;8;71;623
"4105";"360610225001";1352;2088;247;3;154;3844
"4106";"360610225002";272;171;143;2;100;688
"4107";"360610225003";515;604;55;11;150;1335
"4108";"360610225004";78;252;19;4;35;388
"4109";"360610225005";525;550;64;3;65;1207
"4110";"360610226001";150;672;271;34;105;1232
"4111";"360610226002";106;295;53;1;144;599
"4112";"360610226003";288;650;142;22;105;1207
"4113";"360610227001";139;157;219;6;71;592
"4114";"360610227002";96;53;64;1;39;253
"4115";"360610227003";508;383;158;8;96;1153
"4116";"360610228001";284;405;106;16;129;940
"4117";"360610228002";29;103;29;1;164;326
"4118";"360610228003";158;160;89;2;88;497
"4119";"360610228004";81;149;56;5;51;342
"4120";"360610229001";88;78;9;0;43;218
"4121";"360610229002";443;497;46;6;82;1074
"4122";"360610229003";513;622;423;4;221;1783
"4123";"360610229004";143;334;59;2;65;603
"4124";"360610229005";377;1979;122;7;195;2680
"4125";"360610230001";93;229;39;9;49;419
"4126";"360610230002";189;210;92;3;111;605
"4127";"360610230003";175;195;258;4;101;733
"4128";"360610230004";256;312;85;3;129;785
"4129";"360610230005";280;134;20;0;53;487
"4130";"360610231001";193;776;113;32;164;1278
"4131";"360610231002";289;535;69;11;110;1014
"4132";"360610231003";223;373;111;9;117;833
"4133";"360610232001";116;191;69;55;71;502
"4134";"360610232002";207;239;174;6;84;710
"4135";"360610232003";477;112;31;5;47;672
"4136";"360610232004";314;415;51;18;76;874
"4137";"360610233001";356;642;104;1;159;1262
"4138";"360610233002";378;759;57;4;175;1373
"4139";"360610233003";490;518;62;11;204;1285
"4140";"360610234001";450;849;111;19;67;1496
"4141";"360610234002";491;474;83;18;75;1141
"4142";"360610235011";222;150;19;5;87;483
"4143";"360610235012";404;576;539;28;143;1690
"4144";"360610235013";92;76;34;1;24;227
"4145";"360610235014";125;140;55;0;44;364
"4146";"360610235021";280;563;47;16;97;1003
"4147";"360610236000";0;1;1;0;7;9
"4148";"360610236001";246;331;57;8;98;740
"4149";"360610236002";323;283;49;4;51;710
"4150";"360610236003";25;59;6;0;15;105
"4151";"360610236004";127;178;32;9;89;435
"4152";"360610237001";552;727;48;8;119;1454
"4153";"360610237002";3011;1548;61;9;157;4786
"4154";"360610237003";382;825;104;7;122;1440
"4155";"360610238010";1;0;0;0;1;2
"4156";"360610238011";56;24;15;0;78;173
"4157";"360610238021";8;15;3;0;9;35
"4158";"360610238022";31;9;4;0;3;47
"4159";"360610239001";156;175;28;3;117;479
"4160";"360610239002";245;1061;29;2;86;1423
"4161";"360610240000";1;3;0;0;1;5
"4162";"360610240001";59;326;5;1;53;444
"4163";"360610241001";367;358;76;7;93;901
"4164";"360610241002";203;434;48;10;139;834
"4165";"360610241003";326;251;15;6;45;643
"4166";"360610241004";961;353;22;2;142;1480
"4167";"360610241005";125;151;34;2;79;391
"4168";"360610242000";0;0;1;0;5;6
"4169";"360610242001";137;232;82;6;83;540
"4170";"360610242002";102;57;22;2;42;225
"4171";"360610242003";93;53;145;14;109;414
"4172";"360610243011";153;117;20;4;37;331
"4173";"360610243012";398;327;139;14;246;1124
"4174";"360610243013";173;240;9;2;104;528
"4175";"360610243020";0;1;1;0;0;2
"4176";"360610243021";670;266;57;14;67;1074
"4177";"360610243022";75;31;0;0;4;110
"4178";"360610243023";551;319;46;2;22;940
"4179";"360610245001";337;454;23;3;138;955
"4180";"360610245002";103;600;25;5;69;802
"4181";"360610245003";154;576;108;1;99;938
"4182";"360610245004";306;440;87;5;137;975
"4183";"360610245005";128;500;214;6;109;957
"4184";"360610245006";328;540;71;0;213;1152
"4185";"360610245007";281;303;25;3;101;713
"4186";"360610247000";0;0;2;0;2;4
"4187";"360610247001";104;699;100;9;61;973
"4188";"360610247002";175;698;62;2;131;1068
"4189";"360610247003";178;684;20;0;65;947
"4190";"360610247004";214;304;27;1;54;600
"4191";"360610247005";69;163;34;0;64;330
"4192";"360610249001";103;391;150;13;59;716
"4193";"360610251001";96;317;102;6;225;746
"4194";"360610251002";116;997;132;4;69;1318
"4195";"360610253001";134;555;71;5;110;875
"4196";"360610253002";231;1964;110;1;103;2409
"4197";"360610253003";313;3615;462;5;144;4539
"4198";"360610253004";138;1121;46;3;193;1501
"4199";"360610253005";248;246;18;2;188;702
"4200";"360610253006";135;122;50;3;123;433
"4201";"360610255001";28;75;78;1;60;242
"4202";"360610255002";269;826;87;6;181;1369
"4203";"360610255003";346;138;293;1;46;824
"4204";"360610255004";100;18;109;2;37;266
"4205";"360610257001";182;91;322;8;119;722
"4206";"360610257002";90;118;131;1;53;393
"4207";"360610257003";352;369;54;1;98;874
"4208";"360610259001";559;709;359;38;133;1798
"4209";"360610259002";188;753;327;8;160;1436
"4210";"360610261001";216;645;63;9;160;1093
"4211";"360610261002";176;492;20;0;93;781
"4212";"360610261003";72;120;14;2;24;232
"4213";"360610261004";139;261;29;13;55;497
"4214";"360610261005";107;556;274;17;90;1044
"4215";"360610261006";107;1247;33;4;47;1438
"4216";"360610261007";196;800;35;24;106;1161
"4217";"360610263001";104;504;229;8;80;925
"4218";"360610263002";478;333;19;1;63;894
"4219";"360610263003";250;663;59;13;83;1068
"4220";"360610263004";455;500;93;2;94;1144
"4221";"360610263005";159;331;31;7;122;650
"4222";"360610265001";158;390;29;0;45;622
"4223";"360610265002";104;161;161;11;76;513
"4224";"360610265003";38;192;46;4;52;332
"4225";"360610265004";238;366;31;7;126;768
"4226";"360610265005";35;42;24;0;46;147
"4227";"360610267001";158;140;47;15;29;389
"4228";"360610269001";205;595;17;5;47;869
"4229";"360610269002";266;343;28;5;47;689
"4230";"360610269003";60;144;70;5;32;311
"4231";"360610269004";82;573;43;8;55;761
"4232";"360610269005";248;637;26;10;102;1023
"4233";"360610269006";294;438;36;14;73;855
"4234";"360610271001";222;263;24;7;65;581
"4235";"360610271002";287;715;91;11;102;1206
"4236";"360610271003";78;191;177;4;106;556
"4237";"360610271004";86;97;129;4;75;391
"4238";"360610271005";241;22;60;1;60;384
"4239";"360610273001";83;163;99;0;87;432
"4240";"360610273002";54;74;71;2;53;254
"4241";"360610273003";70;285;165;18;125;663
"4242";"360610273004";150;122;54;0;92;418
"4243";"360610275000";0;1;0;0;9;10
"4244";"360610275001";20;296;19;1;22;358
"4245";"360610275002";7;14;11;0;11;43
"4246";"360610277001";293;1068;217;29;144;1751
"4247";"360610277002";139;651;157;10;111;1068
"4248";"360610277003";153;615;739;33;176;1716
"4249";"360610277004";115;328;50;4;18;515
"4250";"360610279001";85;241;47;0;40;413
"4251";"360610279002";946;880;187;4;118;2135
"4252";"360610279003";577;735;41;2;145;1500
"4253";"360610279004";310;880;69;27;130;1416
"4254";"360610279005";62;363;69;7;68;569
"4255";"360610279006";84;672;15;7;36;814
"4256";"360610279007";78;234;515;6;35;868
"4257";"360610281001";21;17;7;0;17;62
"4258";"360610281002";115;235;300;3;162;815
"4259";"360610283001";19;84;23;1;16;143
"4260";"360610283002";909;1376;445;15;236;2981
"4261";"360610283003";135;453;259;3;59;909
"4262";"360610283004";243;608;69;5;34;959
"4263";"360610285001";254;933;217;5;313;1722
"4264";"360610285002";384;710;66;5;204;1369
"4265";"360610285003";207;936;65;3;58;1269
"4266";"360610285004";322;1202;121;4;173;1822
"4267";"360610287001";481;2398;339;31;391;3640
"4268";"360610287002";162;565;131;2;149;1009
"4269";"360610287003";325;1190;142;9;319;1985
"4270";"360610291001";229;989;59;6;90;1373
"4271";"360610291002";109;477;32;0;149;767
"4272";"360610291003";135;295;36;3;57;526
"4273";"360610291004";139;754;75;3;147;1118
"4274";"360610291005";222;401;30;0;69;722
"4275";"360610291006";154;280;29;3;99;565
"4276";"360610291007";354;1348;312;1;147;2162
"4277";"360610293001";261;874;75;10;101;1321
"4278";"360610293002";407;2925;425;6;81;3844
"4279";"360610293003";275;620;117;9;117;1138
"4280";"360610293004";363;666;74;3;381;1487
"4281";"360610293005";627;1203;225;4;81;2140
"4282";"360610295001";193;1020;126;7;87;1433
"4283";"360610295002";291;996;137;4;198;1626
"4284";"360610295003";351;577;84;1;266;1279
"4285";"360610295004";373;316;290;4;158;1141
"4286";"360610297000";1;2;2;0;2;7
"4287";"360610297001";31;1240;302;14;340;1927
"4288";"360610299000";0;2;0;0;1;3
"4289";"360610299001";1286;367;59;4;72;1788
"4290";"360610299002";126;3014;216;32;141;3529
"4291";"360610303001";218;968;67;5;105;1363
"4292";"360610303002";227;399;320;3;155;1104
"4293";"360610303003";105;625;150;2;87;969
"4294";"360610307001";78;313;174;30;64;659
"4295";"360610307002";19;68;73;1;9;170
"4296";"360610307003";128;552;210;1;99;990
"4297";"360610309001";666;1322;173;6;183;2350
"4298";"360610309002";104;159;136;4;55;458
"4299";"360610309003";251;374;195;2;74;896
"4300";"360610309004";481;835;415;11;59;1801
"4301";"360610311000";0;0;1;0;6;7
"4302";"360610311001";81;425;75;3;124;708
"4303";"360610317030";0;2;1;0;30;33
"4304";"360610317031";29;73;154;0;73;329
"4305";"360610317032";10;42;67;3;57;179
"4306";"360610317041";23;25;20;0;46;114
"4307";"360610317042";16;33;17;1;28;95
"4308";"360610317043";22;27;44;1;71;165
"4309";"360610317044";32;62;123;1;60;278
"4310";"360610319001";1;5;8;1;66;81
"4311";"360810001001";897;1649;1649;43;878;5116
"4312";"360810002001";217;14;436;32;84;783
"4313";"360810002002";187;78;387;22;64;738
"4314";"360810004001";129;112;318;27;52;638
"4315";"360810004002";200;119;319;27;45;710
"4316";"360810004003";181;36;803;27;44;1091
"4317";"360810006001";136;25;218;18;47;444
"4318";"360810006002";62;22;210;20;34;348
"4319";"360810006003";185;794;386;94;63;1522
"4320";"360810007001";108;156;156;10;86;516
"4321";"360810007002";32;73;107;4;53;269
"4322";"360810007003";51;94;350;14;79;588
"4323";"360810007004";159;408;831;11;171;1580
"4324";"360810008001";182;34;514;26;78;834
"4325";"360810008002";126;86;532;16;43;803
"4326";"360810010001";207;37;389;19;28;680
"4327";"360810010002";154;59;475;18;74;780
"4328";"360810012001";113;132;223;15;84;567
"4329";"360810012002";110;34;170;7;35;356
"4330";"360810012003";141;44;374;30;65;654
"4331";"360810014001";147;95;855;73;30;1200
"4332";"360810014002";72;6;269;25;30;402
"4333";"360810014003";58;22;414;17;55;566
"4334";"360810016001";97;41;442;10;47;637
"4335";"360810016002";133;85;414;34;48;714
"4336";"360810018001";183;32;125;13;45;398
"4337";"360810018002";128;63;599;23;44;857
"4338";"360810019001";284;220;1272;70;314;2160
"4339";"360810020001";99;48;235;31;44;457
"4340";"360810022001";118;43;308;13;42;524
"4341";"360810022002";94;72;125;22;103;416
"4342";"360810024001";43;25;259;22;33;382
"4343";"360810024002";89;20;398;49;43;599
"4344";"360810025001";120;83;15;1;33;252
"4345";"360810025002";131;104;9;0;20;264
"4346";"360810025003";195;70;2;2;18;287
"4347";"360810025004";113;318;7;0;94;532
"4348";"360810025005";194;31;9;0;9;243
"4349";"360810025006";229;37;10;4;17;297
"4350";"360810026001";53;36;284;24;30;427
"4351";"360810026002";128;37;143;20;39;367
"4352";"360810028001";197;133;323;106;66;825
"4353";"360810028002";207;138;338;53;66;802
"4354";"360810030001";215;100;241;25;35;616
"4355";"360810031001";57;155;191;11;22;436
"4356";"360810031002";67;78;456;38;78;717
"4357";"360810032001";198;190;290;47;92;817
"4358";"360810033001";108;163;390;10;145;816
"4359";"360810033002";33;52;257;71;68;481
"4360";"360810033003";40;35;341;47;53;516
"4361";"360810033004";42;15;267;62;37;423
"4362";"360810034001";116;541;346;87;73;1163
"4363";"360810034002";94;73;250;33;61;511
"4364";"360810036001";119;186;454;40;43;842
"4365";"360810036002";103;16;187;37;41;384
"4366";"360810037001";75;97;50;2;93;317
"4367";"360810038001";66;33;301;32;30;462
"4368";"360810038002";73;24;348;23;43;511
"4369";"360810039001";42;31;299;43;44;459
"4370";"360810040011";77;42;174;18;23;334
"4371";"360810040012";71;12;286;34;38;441
"4372";"360810040021";48;18;282;50;52;450
"4373";"360810042001";125;49;417;22;74;687
"4374";"360810042002";34;13;141;11;40;239
"4375";"360810042003";32;13;97;26;43;211
"4376";"360810043001";358;118;102;7;42;627
"4377";"360810043002";7;57;361;38;42;505
"4378";"360810044011";103;108;149;34;51;445
"4379";"360810044012";56;20;183;20;48;327
"4380";"360810045001";68;65;123;26;96;378
"4381";"360810045002";2;24;4;10;5;45
"4382";"360810045003";1;31;23;0;7;62
"4383";"360810047001";108;42;151;6;37;344
"4384";"360810047002";258;124;47;6;43;478
"4385";"360810050001";2;4;28;0;4;38
"4386";"360810051001";39;24;154;7;71;295
"4387";"360810051002";43;22;157;15;22;259
"4388";"360810052001";66;87;219;29;49;450
"4389";"360810052002";36;37;174;20;55;322
"4390";"360810053001";53;27;131;0;42;253
"4391";"360810053002";370;20;152;7;43;592
"4392";"360810053003";58;26;47;2;13;146
"4393";"360810053004";69;31;118;3;41;262
"4394";"360810054001";72;87;68;11;32;270
"4395";"360810054002";211;32;198;18;39;498
"4396";"360810054003";238;126;531;64;130;1089
"4397";"360810054004";225;91;560;80;98;1054
"4398";"360810055001";57;76;517;271;64;985
"4399";"360810057001";181;254;148;6;97;686
"4400";"360810057002";34;28;91;15;29;197
"4401";"360810057003";118;99;93;16;71;397
"4402";"360810058001";104;15;348;31;85;583
"4403";"360810058002";45;24;82;32;27;210
"4404";"360810058003";227;15;155;20;53;470
"4405";"360810058004";72;66;349;26;75;588
"4406";"360810059001";111;154;126;3;94;488
"4407";"360810059002";82;35;81;3;46;247
"4408";"360810059003";29;39;98;1;58;225
"4409";"360810061001";103;174;97;3;63;440
"4410";"360810061002";267;92;93;0;75;527
"4411";"360810061003";120;171;44;0;111;446
"4412";"360810061004";98;44;80;2;30;254
"4413";"360810062011";38;7;22;4;6;77
"4414";"360810062012";63;29;293;22;50;457
"4415";"360810062021";12;139;60;24;29;264
"4416";"360810062022";81;122;107;16;53;379
"4417";"360810062023";106;15;127;10;39;297
"4418";"360810062024";53;9;227;7;58;354
"4419";"360810062025";127;24;65;3;29;248
"4420";"360810062026";64;25;86;9;47;231
"4421";"360810062027";151;54;321;25;48;599
"4422";"360810063001";58;43;192;1;78;372
"4423";"360810063002";96;86;73;1;60;316
"4424";"360810063003";199;189;76;4;85;553
"4425";"360810063004";54;656;91;0;82;883
"4426";"360810065011";77;53;120;4;77;331
"4427";"360810065012";59;15;187;11;18;290
"4428";"360810065013";25;14;124;1;6;170
"4429";"360810065021";104;605;180;2;182;1073
"4430";"360810065022";64;20;198;3;9;294
"4431";"360810065023";166;156;367;10;62;761
"4432";"360810069001";95;170;198;9;46;518
"4433";"360810069002";165;72;454;20;59;770
"4434";"360810069003";103;52;165;7;68;395
"4435";"360810071001";33;104;154;5;54;350
"4436";"360810071002";51;21;21;0;9;102
"4437";"360810071003";69;35;101;1;32;238
"4438";"360810071004";103;401;312;4;223;1043
"4439";"360810073001";138;42;246;14;54;494
"4440";"360810073002";43;23;167;4;17;254
"4441";"360810073003";107;39;147;1;37;331
"4442";"360810075001";63;17;157;5;13;255
"4443";"360810075002";93;38;124;3;56;314
"4444";"360810075003";31;38;71;3;44;187
"4445";"360810077001";60;73;241;11;85;470
"4446";"360810079001";76;42;479;18;50;665
"4447";"360810079002";43;74;281;18;33;449
"4448";"360810081001";236;155;369;24;66;850
"4449";"360810083001";69;102;335;11;46;563
"4450";"360810083002";210;267;208;33;87;805
"4451";"360810085001";45;35;427;79;33;619
"4452";"360810085002";24;74;117;17;35;267
"4453";"360810086001";65;51;279;32;77;504
"4454";"360810086002";110;31;151;18;84;394
"4455";"360810087001";138;174;69;3;47;431
"4456";"360810087002";135;86;226;11;67;525
"4457";"360810087003";191;236;17;0;37;481
"4458";"360810088001";163;48;345;42;96;694
"4459";"360810088002";109;65;278;86;90;628
"4460";"360810091001";51;19;87;2;17;176
"4461";"360810091002";81;37;322;3;79;522
"4462";"360810094001";91;46;156;15;57;365
"4463";"360810094002";430;258;229;4;71;992
"4464";"360810095001";30;6;93;1;20;150
"4465";"360810095002";53;94;260;11;66;484
"4466";"360810096001";293;172;398;19;112;994
"4467";"360810096002";235;67;292;22;97;713
"4468";"360810097001";25;24;58;1;32;140
"4469";"360810097002";25;53;96;1;34;209
"4470";"360810097003";11;20;68;3;23;125
"4471";"360810097004";75;22;65;3;24;189
"4472";"360810098001";146;50;160;6;78;440
"4473";"360810098002";138;126;211;11;77;563
"4474";"360810099001";12;138;30;0;203;383
"4475";"360810100001";187;33;118;20;57;415
"4476";"360810100002";226;54;324;11;267;882
"4477";"360810101001";53;48;163;8;65;337
"4478";"360810101002";81;105;92;4;69;351
"4479";"360810102001";67;29;140;20;69;325
"4480";"360810102002";302;71;161;20;66;620
"4481";"360810103001";142;791;250;19;123;1325
"4482";"360810103002";23;44;56;5;44;172
"4483";"360810103003";36;21;110;1;25;193
"4484";"360810103004";42;40;273;2;18;375
"4485";"360810104001";400;238;323;6;86;1053
"4486";"360810104002";136;25;197;19;57;434
"4487";"360810105001";58;53;6;2;16;135
"4488";"360810105002";360;26;20;0;8;414
"4489";"360810105003";26;53;40;4;21;144
"4490";"360810105004";25;13;56;3;15;112
"4491";"360810106001";165;49;244;8;54;520
"4492";"360810106002";218;133;404;27;135;917
"4493";"360810107010";0;0;0;0;1;1
"4494";"360810107011";7;98;69;7;16;197
"4495";"360810108001";200;40;283;16;74;613
"4496";"360810108002";199;33;445;36;91;804
"4497";"360810110001";56;50;822;19;123;1070
"4498";"360810110002";277;90;433;22;89;911
"4499";"360810111001";46;128;259;9;44;486
"4500";"360810111002";28;32;184;7;21;272
"4501";"360810112001";83;31;180;7;33;334
"4502";"360810112002";81;180;174;9;65;509
"4503";"360810113001";106;30;53;1;33;223
"4504";"360810113002";144;863;141;6;70;1224
"4505";"360810113003";57;295;200;2;74;628
"4506";"360810114001";135;30;219;44;55;483
"4507";"360810115001";75;68;273;4;56;476
"4508";"360810115002";25;110;86;6;246;473
"4509";"360810116001";179;67;185;14;22;467
"4510";"360810116002";155;37;343;26;53;614
"4511";"360810117001";24;199;218;1;54;496
"4512";"360810117002";18;68;101;2;107;296
"4513";"360810117003";67;60;305;7;62;501
"4514";"360810117004";59;35;205;3;19;321
"4515";"360810118001";112;26;443;39;61;681
"4516";"360810118002";104;32;644;13;132;925
"4517";"360810119001";210;82;138;1;50;481
"4518";"360810119002";32;35;98;6;38;209
"4519";"360810120001";59;12;123;4;21;219
"4520";"360810120002";271;162;336;17;74;860
"4521";"360810121001";40;63;83;2;42;230
"4522";"360810121002";30;27;97;3;40;197
"4523";"360810122001";139;43;229;15;69;495
"4524";"360810122002";283;63;173;28;100;647
"4525";"360810123011";82;196;278;58;84;698
"4526";"360810123012";27;108;162;126;60;483
"4527";"360810123013";43;78;107;23;73;324
"4528";"360810124001";38;12;125;5;27;207
"4529";"360810124002";93;20;236;34;62;445
"4530";"360810125001";45;49;233;7;66;400
"4531";"360810125002";36;23;39;7;48;153
"4532";"360810126011";88;19;240;41;39;427
"4533";"360810126012";39;44;288;26;25;422
"4534";"360810126021";87;48;191;23;34;383
"4535";"360810126022";145;56;398;52;47;698
"4536";"360810128001";79;28;83;6;34;230
"4537";"360810128002";102;167;226;19;42;556
"4538";"360810130001";5;7;94;6;19;131
"4539";"360810130002";76;15;93;11;23;218
"4540";"360810132001";26;25;118;11;12;192
"4541";"360810132002";77;98;121;39;104;439
"4542";"360810134001";210;32;27;0;36;305
"4543";"360810134002";72;63;433;1;26;595
"4544";"360810134003";121;53;104;3;39;320
"4545";"360810134004";45;6;14;1;12;78
"4546";"360810135001";79;41;70;9;34;233
"4547";"360810136001";25;11;39;0;18;93
"4548";"360810136002";85;63;42;0;114;304
"4549";"360810137001";62;64;272;21;44;463
"4550";"360810138001";198;31;86;1;24;340
"4551";"360810138002";300;52;375;18;77;822
"4552";"360810140001";119;42;238;8;47;454
"4553";"360810140002";188;16;168;2;27;401
"4554";"360810141001";47;186;127;1;32;393
"4555";"360810141002";80;41;255;113;47;536
"4556";"360810142011";73;20;128;3;44;268
"4557";"360810142012";132;41;342;20;56;591
"4558";"360810142021";254;51;223;30;147;705
"4559";"360810142022";146;578;173;59;38;994
"4560";"360810143001";26;26;132;2;18;204
"4561";"360810143002";132;442;394;13;89;1070
"4562";"360810144001";96;47;366;8;82;599
"4563";"360810145001";39;18;321;18;20;416
"4564";"360810145002";80;73;371;13;22;559
"4565";"360810147001";25;16;161;4;24;230
"4566";"360810147002";66;56;104;5;76;307
"4567";"360810147003";88;314;123;7;89;621
"4568";"360810148001";179;145;270;25;65;684
"4569";"360810149001";71;27;117;3;39;257
"4570";"360810149002";51;45;116;11;51;274
"4571";"360810150001";310;24;127;4;43;508
"4572";"360810150002";198;18;328;23;37;604
"4573";"360810151001";170;25;136;3;35;369
"4574";"360810151002";130;59;292;10;114;605
"4575";"360810152001";90;107;165;29;42;433
"4576";"360810152002";88;30;322;39;57;536
"4577";"360810153001";76;161;217;7;35;496
"4578";"360810153002";106;114;208;2;63;493
"4579";"360810154001";154;14;155;7;35;365
"4580";"360810154002";96;80;236;32;39;483
"4581";"360810155001";79;203;170;1;76;529
"4582";"360810155002";66;419;84;1;188;758
"4583";"360810156001";99;50;321;10;81;561
"4584";"360810156002";211;33;148;38;94;524
"4585";"360810157001";95;401;152;20;217;885
"4586";"360810158011";121;23;177;24;50;395
"4587";"360810158012";211;39;151;33;53;487
"4588";"360810158013";378;173;311;20;99;981
"4589";"360810158021";511;135;215;24;110;995
"4590";"360810158022";400;201;247;10;82;940
"4591";"360810158023";178;87;122;14;104;505
"4592";"360810159001";57;96;121;10;157;441
"4593";"360810159002";77;38;54;10;19;198
"4594";"360810159003";19;34;42;5;11;111
"4595";"360810159004";83;17;159;6;34;299
"4596";"360810161001";56;14;95;9;26;200
"4597";"360810161002";62;40;229;6;56;393
"4598";"360810163001";38;28;87;2;32;187
"4599";"360810163002";24;192;6;3;13;238
"4600";"360810163003";284;82;99;0;87;552
"4601";"360810164001";367;32;229;9;80;717
"4602";"360810164002";185;76;243;19;97;620
"4603";"360810166001";496;240;631;20;149;1536
"4604";"360810166002";49;102;145;10;57;363
"4605";"360810168001";181;25;246;30;69;551
"4606";"360810168002";243;88;383;36;65;815
"4607";"360810169001";59;123;97;0;30;309
"4608";"360810169002";64;214;106;6;35;425
"4609";"360810169003";60;46;148;1;24;279
"4610";"360810169004";67;53;51;1;16;188
"4611";"360810170001";259;27;195;19;49;549
"4612";"360810170002";233;56;171;8;65;533
"4613";"360810171001";44;360;735;23;175;1337
"4614";"360810172001";201;50;165;30;80;526
"4615";"360810172002";77;57;89;9;34;266
"4616";"360810174001";157;15;83;20;38;313
"4617";"360810174002";95;22;143;19;66;345
"4618";"360810176001";82;26;204;37;80;429
"4619";"360810176002";53;11;108;19;36;227
"4620";"360810178001";277;24;238;32;59;630
"4621";"360810178002";147;20;174;27;58;426
"4622";"360810179001";29;14;123;17;26;209
"4623";"360810179002";79;32;84;7;65;267
"4624";"360810180001";78;33;227;24;70;432
"4625";"360810181011";107;124;49;0;47;327
"4626";"360810181012";90;15;22;0;16;143
"4627";"360810181013";185;23;17;4;73;302
"4628";"360810181021";93;24;35;2;15;169
"4629";"360810181022";82;41;31;1;42;197
"4630";"360810181023";50;54;48;1;70;223
"4631";"360810182001";90;17;169;49;38;363
"4632";"360810182002";96;27;220;37;36;416
"4633";"360810183001";39;43;164;7;25;278
"4634";"360810183002";55;39;28;1;23;146
"4635";"360810183003";90;71;28;12;89;290
"4636";"360810183004";57;51;81;2;62;253
"4637";"360810183005";67;291;45;11;58;472
"4638";"360810184011";392;59;376;37;85;949
"4639";"360810184021";149;34;170;34;50;437
"4640";"360810184022";33;7;124;25;32;221
"4641";"360810185011";82;30;232;3;38;385
"4642";"360810185012";9;32;20;10;18;89
"4643";"360810185013";89;29;63;2;29;212
"4644";"360810185021";18;19;28;0;8;73
"4645";"360810185022";124;32;62;7;22;247
"4646";"360810185023";104;90;78;12;114;398
"4647";"360810186001";200;44;348;53;120;765
"4648";"360810187001";67;17;124;7;22;237
"4649";"360810187002";104;9;174;3;18;308
"4650";"360810187003";66;21;173;11;27;298
"4651";"360810188001";142;30;197;17;28;414
"4652";"360810189001";85;52;134;1;44;316
"4653";"360810189002";78;19;203;3;34;337
"4654";"360810189003";50;14;239;9;22;334
"4655";"360810190001";135;39;67;20;73;334
"4656";"360810190002";119;25;172;32;46;394
"4657";"360810192001";80;13;215;24;58;390
"4658";"360810192002";193;23;129;12;50;407
"4659";"360810194001";83;21;106;28;45;283
"4660";"360810194002";75;18;220;51;90;454
"4661";"360810196001";186;93;262;62;71;674
"4662";"360810196002";366;95;650;81;60;1252
"4663";"360810198001";90;24;179;39;201;533
"4664";"360810198002";149;53;272;23;43;540
"4665";"360810198003";62;21;89;28;32;232
"4666";"360810199001";3;7;231;23;33;297
"4667";"360810199002";39;96;347;103;56;641
"4668";"360810202001";126;41;439;51;65;722
"4669";"360810204001";59;35;174;80;35;383
"4670";"360810204002";162;254;184;24;58;682
"4671";"360810205001";14;31;88;45;30;208
"4672";"360810205002";70;10;236;38;22;376
"4673";"360810206001";155;30;391;39;87;702
"4674";"360810208001";44;14;188;11;114;371
"4675";"360810208002";63;77;525;81;83;829
"4676";"360810212001";127;105;327;39;139;737
"4677";"360810212002";166;173;114;18;51;522
"4678";"360810214001";143;12;176;1;38;370
"4679";"360810214002";32;17;121;6;73;249
"4680";"360810214003";79;66;399;33;108;685
"4681";"360810216001";76;74;70;5;56;281
"4682";"360810216002";45;9;65;4;15;138
"4683";"360810216003";67;14;63;27;79;250
"4684";"360810219001";38;121;192;62;41;454
"4685";"360810220011";21;1;85;2;12;121
"4686";"360810220012";181;37;230;15;22;485
"4687";"360810220013";195;65;47;4;66;377
"4688";"360810220014";16;8;3;1;5;33
"4689";"360810220021";40;7;106;8;9;170
"4690";"360810220022";137;27;80;6;35;285
"4691";"360810220023";181;24;100;0;13;318
"4692";"360810220024";68;14;84;3;26;195
"4693";"360810229001";96;284;37;12;24;453
"4694";"360810230001";45;30;58;13;40;186
"4695";"360810230002";99;10;34;3;31;177
"4696";"360810232001";26;3;11;0;9;49
"4697";"360810232002";84;18;124;0;19;245
"4698";"360810232003";67;8;121;6;45;247
"4699";"360810235001";209;235;84;10;28;566
"4700";"360810235002";86;127;46;0;114;373
"4701";"360810235003";79;54;58;11;34;236
"4702";"360810235004";105;107;61;5;44;322
"4703";"360810236001";51;18;44;3;39;155
"4704";"360810236002";117;135;101;2;50;405
"4705";"360810238001";499;25;53;4;60;641
"4706";"360810238002";43;51;26;0;80;200
"4707";"360810238003";137;69;9;2;12;229
"4708";"360810238004";57;26;67;1;18;169
"4709";"360810240001";98;52;76;3;53;282
"4710";"360810240002";132;98;158;15;99;502
"4711";"360810240003";112;43;29;6;27;217
"4712";"360810243001";11;13;60;18;21;123
"4713";"360810243002";39;27;68;15;45;194
"4714";"360810243003";122;19;158;34;48;381
"4715";"360810243004";116;16;315;44;132;623
"4716";"360810245001";35;6;25;2;24;92
"4717";"360810245002";44;12;108;3;7;174
"4718";"360810245003";36;12;98;2;43;191
"4719";"360810245004";95;17;87;3;8;210
"4720";"360810246001";56;3;11;3;65;138
"4721";"360810247001";142;99;236;17;64;558
"4722";"360810249001";101;71;108;9;63;352
"4723";"360810249002";108;22;46;0;26;202
"4724";"360810249003";91;20;112;1;56;280
"4725";"360810251001";138;159;181;3;103;584
"4726";"360810251002";67;5;41;1;15;129
"4727";"360810251003";146;40;453;9;78;726
"4728";"360810251004";190;54;53;1;37;335
"4729";"360810253011";73;85;171;6;46;381
"4730";"360810253012";180;80;62;1;36;359
"4731";"360810253013";32;47;32;5;94;210
"4732";"360810253014";125;246;165;0;47;583
"4733";"360810253021";246;4;10;0;11;271
"4734";"360810253022";108;53;143;5;78;387
"4735";"360810254001";207;138;179;55;53;632
"4736";"360810254002";141;93;140;26;49;449
"4737";"360810254003";277;97;30;17;65;486
"4738";"360810254004";1518;66;50;22;42;1698
"4739";"360810254005";61;34;432;82;41;650
"4740";"360810254006";89;56;227;39;46;457
"4741";"360810255001";106;56;247;56;110;575
"4742";"360810257001";50;53;298;44;59;504
"4743";"360810258001";75;36;95;45;39;290
"4744";"360810258002";24;7;156;20;20;227
"4745";"360810259001";82;34;242;30;221;609
"4746";"360810259002";64;21;47;2;101;235
"4747";"360810260001";218;17;48;23;16;322
"4748";"360810260002";90;23;189;73;31;406
"4749";"360810261001";29;25;41;7;89;191
"4750";"360810261002";122;19;219;2;28;390
"4751";"360810261003";99;60;74;6;32;271
"4752";"360810261004";128;196;307;5;609;1245
"4753";"360810262001";67;45;200;43;147;502
"4754";"360810263001";49;129;200;19;314;711
"4755";"360810263002";99;218;193;3;73;586
"4756";"360810263003";57;39;118;2;41;257
"4757";"360810264001";259;9;62;29;41;400
"4758";"360810264002";129;26;107;33;29;324
"4759";"360810265001";140;92;170;3;65;470
"4760";"360810265002";89;19;170;3;32;313
"4761";"360810266001";239;155;147;26;43;610
"4762";"360810267001";67;69;109;2;30;277
"4763";"360810267002";39;31;132;1;85;288
"4764";"360810267003";141;125;240;2;111;619
"4765";"360810269011";45;92;75;7;41;260
"4766";"360810269012";28;6;20;1;16;71
"4767";"360810269013";75;19;37;7;12;150
"4768";"360810269014";28;136;73;0;21;258
"4769";"360810269021";119;93;76;5;31;324
"4770";"360810269022";107;12;94;1;33;247
"4771";"360810270001";222;45;260;54;69;650
"4772";"360810271001";176;1664;323;9;73;2245
"4773";"360810271002";63;28;46;0;6;143
"4774";"360810271003";57;8;114;5;11;195
"4775";"360810271004";86;21;83;0;11;201
"4776";"360810271005";88;17;57;1;19;182
"4777";"360810272001";71;24;116;33;31;275
"4778";"360810272002";73;13;131;26;28;271
"4779";"360810273001";11;167;45;5;28;256
"4780";"360810273002";78;88;25;4;40;235
"4781";"360810273003";160;303;48;6;70;587
"4782";"360810273004";75;60;156;1;76;368
"4783";"360810273005";95;64;185;6;48;398
"4784";"360810274001";66;14;206;18;46;350
"4785";"360810275001";23;49;85;5;13;175
"4786";"360810275002";217;61;153;4;57;492
"4787";"360810275003";418;65;197;8;76;764
"4788";"360810276001";177;83;241;37;78;616
"4789";"360810277001";9;15;14;2;1;41
"4790";"360810277002";113;38;126;0;39;316
"4791";"360810277003";128;51;24;2;28;233
"4792";"360810277004";47;36;22;3;32;140
"4793";"360810277005";284;43;75;11;41;454
"4794";"360810278001";20;4;31;7;34;96
"4795";"360810278002";40;11;4;3;12;70
"4796";"360810279001";64;87;174;8;54;387
"4797";"360810279002";152;24;90;5;21;292
"4798";"360810279003";82;46;32;4;75;239
"4799";"360810279004";8;7;15;6;9;45
"4800";"360810280001";131;22;190;97;51;491
"4801";"360810281001";273;626;153;7;93;1152
"4802";"360810281002";282;40;89;3;38;452
"4803";"360810281003";18;63;36;1;34;152
"4804";"360810281004";64;341;20;3;41;469
"4805";"360810282001";78;13;159;38;50;338
"4806";"360810283001";150;94;20;1;33;298
"4807";"360810283002";87;29;73;1;17;207
"4808";"360810283003";45;266;33;0;107;451
"4809";"360810283004";44;59;48;0;38;189
"4810";"360810283005";133;46;35;3;29;246
"4811";"360810284001";114;25;222;48;49;458
"4812";"360810284002";106;76;72;35;32;321
"4813";"360810285001";7;56;22;9;12;106
"4814";"360810285002";11;32;20;4;10;77
"4815";"360810285003";36;35;32;0;42;145
"4816";"360810285004";128;160;66;8;84;446
"4817";"360810287001";119;222;139;3;119;602
"4818";"360810287002";14;91;65;3;26;199
"4819";"360810287003";79;131;100;5;66;381
"4820";"360810287004";245;218;80;3;39;585
"4821";"360810288001";23;11;46;19;16;115
"4822";"360810288002";112;37;121;23;76;369
"4823";"360810288003";141;13;107;29;27;317
"4824";"360810288004";118;65;194;66;71;514
"4825";"360810289001";42;39;97;3;15;196
"4826";"360810289002";57;22;83;7;8;177
"4827";"360810289003";145;96;104;4;126;475
"4828";"360810291001";20;19;131;12;29;211
"4829";"360810291002";40;40;516;2;64;662
"4830";"360810291003";82;69;77;2;54;284
"4831";"360810291004";41;69;210;0;40;360
"4832";"360810293001";32;70;261;44;562;969
"4833";"360810294001";46;5;122;10;55;238
"4834";"360810294002";55;56;111;22;35;279
"4835";"360810294003";58;10;108;32;30;238
"4836";"360810294004";127;2;42;24;25;220
"4837";"360810294005";106;24;169;47;54;400
"4838";"360810294006";51;15;109;21;44;240
"4839";"360810295001";27;67;72;13;13;192
"4840";"360810295002";183;66;454;58;58;819
"4841";"360810297001";53;168;448;61;243;973
"4842";"360810297002";41;82;311;54;66;554
"4843";"360810299001";1;30;11;14;11;67
"4844";"360810306001";58;215;136;38;27;474
"4845";"360810306002";119;31;109;35;32;326
"4846";"360810306003";112;24;155;35;32;358
"4847";"360810306004";31;157;152;22;42;404
"4848";"360810309021";37;15;71;5;66;194
"4849";"360810309022";101;18;258;8;62;447
"4850";"360810309023";58;11;136;11;31;247
"4851";"360810309024";18;7;68;7;21;121
"4852";"360810309025";143;2;254;2;15;416
"4853";"360810309031";63;77;355;8;66;569
"4854";"360810309032";126;37;207;6;46;422
"4855";"360810309033";77;20;254;5;29;385
"4856";"360810309041";139;35;177;18;73;442
"4857";"360810309042";55;45;133;6;77;316
"4858";"360810317001";76;42;288;26;70;502
"4859";"360810317002";23;23;134;0;31;211
"4860";"360810317003";57;21;226;40;32;376
"4861";"360810317004";46;34;127;12;41;260
"4862";"360810320001";94;32;64;43;47;280
"4863";"360810320002";13;21;123;22;25;204
"4864";"360810320003";71;45;98;41;43;298
"4865";"360810320004";56;33;64;9;37;199
"4866";"360810327001";140;27;447;8;29;651
"4867";"360810327002";153;452;177;1;96;879
"4868";"360810328001";77;12;78;34;22;223
"4869";"360810328002";73;30;55;27;42;227
"4870";"360810329001";73;21;145;16;53;308
"4871";"360810329002";63;8;130;37;32;270
"4872";"360810329003";56;213;154;6;154;583
"4873";"360810330001";154;54;143;44;54;449
"4874";"360810330002";28;13;32;4;14;91
"4875";"360810330003";21;21;85;29;82;238
"4876";"360810330004";39;14;67;23;18;161
"4877";"360810330005";146;13;84;19;18;280
"4878";"360810331001";3;3;7;0;17;30
"4879";"360810334011";75;15;170;53;56;369
"4880";"360810334012";111;21;282;78;63;555
"4881";"360810334021";25;1;8;0;10;44
"4882";"360810334022";63;2;2;0;7;74
"4883";"360810334023";10;8;38;0;11;67
"4884";"360810334024";27;17;14;0;16;74
"4885";"360810334025";50;62;28;2;38;180
"4886";"360810334026";103;13;308;30;38;492
"4887";"360810337001";152;28;261;11;56;508
"4888";"360810337002";84;263;163;6;93;609
"4889";"360810339001";77;62;88;4;28;259
"4890";"360810339002";10;26;9;3;17;65
"4891";"360810339003";53;19;78;1;26;177
"4892";"360810347001";116;34;237;24;60;471
"4893";"360810347002";125;32;185;5;23;370
"4894";"360810351001";199;22;296;8;36;561
"4895";"360810351002";115;51;522;4;25;717
"4896";"360810351003";28;39;425;2;18;512
"4897";"360810352001";72;46;91;33;47;289
"4898";"360810352002";22;39;97;53;43;254
"4899";"360810353001";122;40;162;6;37;367
"4900";"360810353002";64;28;68;3;39;202
"4901";"360810357001";97;19;292;19;45;472
"4902";"360810357002";102;35;174;14;48;373
"4903";"360810357003";69;16;143;11;13;252
"4904";"360810358001";36;26;55;29;35;181
"4905";"360810358002";112;39;86;70;30;337
"4906";"360810358003";42;14;35;22;22;135
"4907";"360810358004";50;12;33;7;8;110
"4908";"360810361001";101;69;138;11;65;384
"4909";"360810361002";67;24;123;9;25;248
"4910";"360810363001";130;31;154;17;44;376
"4911";"360810363002";81;57;215;4;25;382
"4912";"360810365001";82;16;146;12;22;278
"4913";"360810365002";62;80;189;5;67;403
"4914";"360810366001";90;18;126;73;37;344
"4915";"360810366002";60;28;87;72;50;297
"4916";"360810367001";23;5;34;25;8;95
"4917";"360810367002";173;37;329;58;55;652
"4918";"360810368001";85;72;68;24;79;328
"4919";"360810368002";13;13;45;9;29;109
"4920";"360810371001";85;90;181;13;38;407
"4921";"360810373001";72;26;217;31;25;371
"4922";"360810373002";400;166;297;17;62;942
"4923";"360810375001";122;45;245;9;103;524
"4924";"360810375002";139;129;198;3;73;542
"4925";"360810376001";36;23;77;17;31;184
"4926";"360810376002";35;7;83;14;44;183
"4927";"360810376003";28;13;37;10;20;108
"4928";"360810376004";90;9;144;26;19;288
"4929";"360810376005";36;24;67;40;34;201
"4930";"360810377001";136;84;639;18;40;917
"4931";"360810377002";124;23;251;11;20;429
"4932";"360810379001";178;50;378;32;37;675
"4933";"360810379002";291;268;398;19;73;1049
"4934";"360810379003";168;184;158;16;59;585
"4935";"360810381001";222;62;209;12;39;544
"4936";"360810381002";235;82;386;15;34;752
"4937";"360810381003";190;102;291;17;131;731
"4938";"360810383011";92;959;100;111;25;1287
"4939";"360810383021";80;1440;354;19;537;2430
"4940";"360810384001";74;16;119;20;15;244
"4941";"360810384002";33;17;128;21;22;221
"4942";"360810394001";131;27;74;37;48;317
"4943";"360810394002";123;82;71;32;56;364
"4944";"360810394003";46;10;75;19;28;178
"4945";"360810398001";26;8;44;6;23;107
"4946";"360810398002";25;5;36;12;7;85
"4947";"360810399001";51;22;186;9;23;291
"4948";"360810399002";170;123;198;9;30;530
"4949";"360810399003";81;28;162;34;22;327
"4950";"360810400001";17;17;141;8;25;208
"4951";"360810400002";19;23;43;11;13;109
"4952";"360810401001";175;106;480;44;40;845
"4953";"360810401002";63;58;629;18;53;821
"4954";"360810401003";78;14;193;3;23;311
"4955";"360810402001";28;19;55;22;37;161
"4956";"360810402002";29;17;99;11;26;182
"4957";"360810403001";453;1648;628;22;60;2811
"4958";"360810403002";50;93;172;9;32;356
"4959";"360810403003";79;30;340;4;42;495
"4960";"360810404001";39;9;46;2;14;110
"4961";"360810404002";50;8;64;11;22;155
"4962";"360810404003";32;11;35;8;29;115
"4963";"360810404004";27;12;150;8;38;235
"4964";"360810405001";85;725;98;10;33;951
"4965";"360810405002";38;227;108;21;231;625
"4966";"360810407001";103;314;199;9;45;670
"4967";"360810407002";94;199;72;16;40;421
"4968";"360810407003";51;63;204;21;33;372
"4969";"360810407004";100;28;533;12;16;689
"4970";"360810407005";26;20;31;2;22;101
"4971";"360810409001";42;65;299;5;9;420
"4972";"360810409002";533;114;227;4;27;905
"4973";"360810409003";40;51;99;4;28;222
"4974";"360810409004";79;41;106;5;34;265
"4975";"360810411001";126;42;200;14;41;423
"4976";"360810411002";83;9;87;8;7;194
"4977";"360810413001";144;86;212;18;74;534
"4978";"360810413002";116;117;255;5;66;559
"4979";"360810414001";167;28;236;83;66;580
"4980";"360810414002";34;27;6;7;17;91
"4981";"360810414003";272;59;170;84;82;667
"4982";"360810415001";167;206;310;20;75;778
"4983";"360810415002";66;53;414;9;35;577
"4984";"360810424001";73;26;104;32;23;258
"4985";"360810424002";16;8;18;16;15;73
"4986";"360810424003";28;9;22;9;13;81
"4987";"360810426001";17;16;21;2;22;78
"4988";"360810427001";228;98;281;26;70;703
"4989";"360810427002";140;120;406;23;63;752
"4990";"360810432001";113;78;97;40;99;427
"4991";"360810434001";137;23;59;23;39;281
"4992";"360810437011";149;14;206;11;30;410
"4993";"360810437012";74;7;75;11;34;201
"4994";"360810437021";82;31;129;4;24;270
"4995";"360810437022";185;36;227;4;45;497
"4996";"360810437023";145;18;317;13;19;512
"4997";"360810439001";120;42;319;18;30;529
"4998";"360810439002";165;67;282;19;82;615
"4999";"360810440001";84;33;266;114;91;588
"5000";"360810440002";606;72;201;67;76;1022
"5001";"360810440003";99;24;184;66;98;471
"5002";"360810443011";124;86;171;45;35;461
"5003";"360810443012";89;37;108;12;43;289
"5004";"360810443021";77;31;173;22;35;338
"5005";"360810443022";55;130;98;24;12;319
"5006";"360810443023";93;836;179;7;143;1258
"5007";"360810444001";70;24;59;5;43;201
"5008";"360810444002";48;120;381;33;52;634
"5009";"360810444003";189;35;337;58;103;722
"5010";"360810446011";87;93;136;6;98;420
"5011";"360810446012";111;25;28;2;94;260
"5012";"360810446021";109;243;92;5;59;508
"5013";"360810446022";118;146;31;3;35;333
"5014";"360810448001";106;20;125;3;66;320
"5015";"360810448002";21;4;68;5;12;110
"5016";"360810450001";25;6;61;12;29;133
"5017";"360810450002";23;6;38;7;24;98
"5018";"360810452001";27;21;47;2;124;221
"5019";"360810454001";32;37;178;1;53;301
"5020";"360810454002";132;12;128;2;58;332
"5021";"360810455001";51;25;11;2;18;107
"5022";"360810455002";56;19;7;0;15;97
"5023";"360810455003";71;8;10;0;20;109
"5024";"360810455004";129;2;7;1;3;142
"5025";"360810455005";46;2;1;0;5;54
"5026";"360810455006";0;2;26;1;23;52
"5027";"360810456001";63;128;99;8;46;344
"5028";"360810457001";206;16;314;13;18;567
"5029";"360810457002";66;11;169;16;16;278
"5030";"360810458001";112;28;167;24;57;388
"5031";"360810459001";246;19;380;10;36;691
"5032";"360810459002";117;25;261;4;16;423
"5033";"360810460001";72;7;58;0;72;209
"5034";"360810460002";918;29;38;1;40;1026
"5035";"360810460003";37;22;56;3;42;160
"5036";"360810461001";90;25;302;1;34;452
"5037";"360810462001";53;15;88;0;31;187
"5038";"360810462002";186;156;202;11;84;639
"5039";"360810462003";98;76;256;10;67;507
"5040";"360810463001";115;36;243;1;9;404
"5041";"360810463002";79;97;309;6;20;511
"5042";"360810464001";74;15;97;9;16;211
"5043";"360810465001";101;170;273;9;82;635
"5044";"360810465002";94;11;154;2;34;295
"5045";"360810466001";96;16;92;0;17;221
"5046";"360810466002";98;48;62;1;39;248
"5047";"360810467001";132;14;96;4;15;261
"5048";"360810467002";139;22;430;0;14;605
"5049";"360810467003";156;21;110;1;9;297
"5050";"360810467004";90;26;137;2;17;272
"5051";"360810468001";54;20;126;4;101;305
"5052";"360810468002";217;123;273;26;73;712
"5053";"360810469001";433;83;243;5;32;796
"5054";"360810469002";79;13;34;0;10;136
"5055";"360810469003";25;10;105;0;5;145
"5056";"360810469004";47;13;32;2;38;132
"5057";"360810469005";125;16;51;1;12;205
"5058";"360810470001";108;27;128;8;60;331
"5059";"360810470002";175;41;254;12;62;544
"5060";"360810471001";183;77;94;9;182;545
"5061";"360810471002";45;27;95;3;106;276
"5062";"360810472001";82;5;31;3;22;143
"5063";"360810472002";30;3;54;9;11;107
"5064";"360810472003";23;14;19;1;9;66
"5065";"360810473001";58;15;234;5;29;341
"5066";"360810473002";56;39;128;2;158;383
"5067";"360810473003";11;3;26;0;2;42
"5068";"360810475001";65;25;389;4;42;525
"5069";"360810475002";87;13;293;8;31;432
"5070";"360810476001";43;7;18;19;21;108
"5071";"360810476002";44;6;23;8;11;92
"5072";"360810478001";28;18;57;7;63;173
"5073";"360810478002";69;16;104;37;32;258
"5074";"360810478003";141;11;147;12;53;364
"5075";"360810479001";256;29;137;7;44;473
"5076";"360810479002";43;23;180;18;65;329
"5077";"360810479003";73;17;269;10;40;409
"5078";"360810480001";70;39;204;15;100;428
"5079";"360810480002";33;11;109;33;20;206
"5080";"360810481001";40;8;183;1;49;281
"5081";"360810481002";66;10;109;1;25;211
"5082";"360810481003";163;32;46;4;13;258
"5083";"360810481004";32;28;18;0;133;211
"5084";"360810482001";94;14;132;26;67;333
"5085";"360810483001";222;20;153;2;35;432
"5086";"360810483002";76;69;435;23;75;678
"5087";"360810484001";47;8;114;5;53;227
"5088";"360810484002";78;36;149;13;33;309
"5089";"360810484003";58;15;176;21;41;311
"5090";"360810484004";90;31;146;29;30;326
"5091";"360810485001";30;45;78;1;54;208
"5092";"360810485002";15;3;55;2;20;95
"5093";"360810485003";92;41;287;13;231;664
"5094";"360810489001";41;18;548;111;315;1033
"5095";"360810489002";27;1;66;5;12;111
"5096";"360810492001";212;11;41;8;24;296
"5097";"360810492002";95;5;13;1;19;133
"5098";"360810492003";72;12;58;4;39;185
"5099";"360810493011";91;15;226;41;21;394
"5100";"360810493012";37;4;223;6;24;294
"5101";"360810493021";34;77;273;14;62;460
"5102";"360810493022";100;23;335;24;105;587
"5103";"360810495001";68;12;802;11;63;956
"5104";"360810496001";79;20;119;14;44;276
"5105";"360810496002";80;25;176;23;74;378
"5106";"360810496003";33;7;115;31;46;232
"5107";"360810497001";78;8;310;13;17;426
"5108";"360810497002";51;7;430;23;30;541
"5109";"360810499001";16;6;73;11;30;136
"5110";"360810499002";81;141;275;22;103;622
"5111";"360810499003";24;11;149;20;28;232
"5112";"360810500001";107;49;158;22;47;383
"5113";"360810500002";159;31;143;39;44;416
"5114";"360810502011";233;40;115;40;48;476
"5115";"360810502021";82;20;63;22;30;217
"5116";"360810504001";23;12;36;17;26;114
"5117";"360810504002";32;10;81;19;24;166
"5118";"360810505001";74;3;185;6;30;298
"5119";"360810506001";16;15;32;16;37;116
"5120";"360810506002";23;17;21;8;23;92
"5121";"360810507001";60;30;348;21;45;504
"5122";"360810507002";24;10;172;5;11;222
"5123";"360810508001";81;93;66;17;40;297
"5124";"360810508002";45;78;143;13;22;301
"5125";"360810510001";66;2;38;19;32;157
"5126";"360810510002";40;35;32;14;28;149
"5127";"360810511001";72;44;430;92;63;701
"5128";"360810511002";23;10;189;16;30;268
"5129";"360810512001";22;13;49;29;31;144
"5130";"360810512002";128;32;57;16;35;268
"5131";"360810512003";33;19;34;23;52;161
"5132";"360810513001";46;10;339;8;36;439
"5133";"360810513002";59;10;312;14;35;430
"5134";"360810515001";14;22;122;3;20;181
"5135";"360810515002";56;30;91;10;18;205
"5136";"360810515003";59;82;266;47;33;487
"5137";"360810516001";31;36;36;2;20;125
"5138";"360810516002";97;21;224;21;30;393
"5139";"360810517001";20;14;148;5;43;230
"5140";"360810517002";53;18;147;12;30;260
"5141";"360810518001";67;32;54;16;33;202
"5142";"360810518002";102;14;80;16;52;264
"5143";"360810520001";54;22;65;13;50;204
"5144";"360810521001";18;28;66;16;12;140
"5145";"360810521002";56;58;327;30;60;531
"5146";"360810522001";101;18;105;29;49;302
"5147";"360810524001";92;4;55;10;22;183
"5148";"360810524002";66;10;220;13;30;339
"5149";"360810525001";47;43;423;12;25;550
"5150";"360810525002";37;33;274;20;24;388
"5151";"360810526001";20;7;50;16;40;133
"5152";"360810526002";58;23;96;9;51;237
"5153";"360810528001";91;29;103;21;67;311
"5154";"360810530001";21;15;40;11;28;115
"5155";"360810530002";73;22;70;34;41;240
"5156";"360810531001";89;47;389;48;42;615
"5157";"360810531002";36;29;269;28;28;390
"5158";"360810531003";27;89;258;71;109;554
"5159";"360810532001";50;6;68;7;24;155
"5160";"360810532002";37;13;53;8;25;136
"5161";"360810534011";29;122;100;17;95;363
"5162";"360810534012";43;2;83;11;23;162
"5163";"360810535001";113;74;267;42;33;529
"5164";"360810536011";41;6;20;9;46;122
"5165";"360810536012";38;11;33;19;23;124
"5166";"360810538001";47;10;22;33;26;138
"5167";"360810538002";31;8;36;5;18;98
"5168";"360810539001";74;120;239;22;44;499
"5169";"360810539002";73;59;297;15;85;529
"5170";"360810539003";173;55;460;21;51;760
"5171";"360810540001";188;51;432;51;145;867
"5172";"360810540002";94;98;201;121;73;587
"5173";"360810540003";36;61;69;27;31;224
"5174";"360810542001";53;12;54;2;42;163
"5175";"360810542002";135;21;75;10;40;281
"5176";"360810542003";89;27;92;9;52;269
"5177";"360810542004";101;17;83;9;70;280
"5178";"360810545001";78;35;502;0;13;628
"5179";"360810545002";68;30;159;8;24;289
"5180";"360810545003";168;89;213;3;35;508
"5181";"360810547001";60;85;214;4;70;433
"5182";"360810547002";104;26;120;5;22;277
"5183";"360810547003";156;42;82;0;22;302
"5184";"360810548001";46;7;63;6;39;161
"5185";"360810548002";34;3;120;4;41;202
"5186";"360810549001";106;58;134;2;39;339
"5187";"360810549002";112;69;82;4;34;301
"5188";"360810549003";98;61;127;12;49;347
"5189";"360810549004";3197;99;51;27;61;3435
"5190";"360810551001";12;20;87;6;40;165
"5191";"360810551002";63;106;56;6;53;284
"5192";"360810551003";77;42;68;7;28;222
"5193";"360810551004";132;131;116;2;37;418
"5194";"360810552001";64;12;47;9;47;179
"5195";"360810552002";41;15;90;7;72;225
"5196";"360810553001";167;532;564;5;120;1388
"5197";"360810553002";346;358;82;1;81;868
"5198";"360810554001";60;9;50;1;18;138
"5199";"360810554002";80;11;118;13;23;245
"5200";"360810555001";27;21;279;13;20;360
"5201";"360810555002";102;156;255;7;75;595
"5202";"360810556001";44;12;82;5;36;179
"5203";"360810556002";13;8;31;2;11;65
"5204";"360810557001";80;23;297;9;50;459
"5205";"360810557002";59;92;323;13;43;530
"5206";"360810557003";62;22;64;4;24;176
"5207";"360810558001";35;9;25;14;33;116
"5208";"360810558002";76;7;31;32;38;184
"5209";"360810559001";170;168;332;79;105;854
"5210";"360810560001";28;9;60;4;12;113
"5211";"360810560002";28;3;42;18;12;103
"5212";"360810561001";29;280;149;10;35;503
"5213";"360810562001";69;0;73;5;42;189
"5214";"360810564001";112;21;82;7;17;239
"5215";"360810565001";158;51;517;125;39;890
"5216";"360810566001";29;3;25;11;15;83
"5217";"360810566002";59;58;48;3;34;202
"5218";"360810567001";36;16;408;11;15;486
"5219";"360810567002";69;61;568;21;45;764
"5220";"360810567003";127;30;761;79;41;1038
"5221";"360810567004";79;47;398;8;49;581
"5222";"360810568001";39;36;79;15;37;206
"5223";"360810568002";40;7;140;27;35;249
"5224";"360810568003";9;6;26;3;41;85
"5225";"360810568004";43;48;110;44;73;318
"5226";"360810577001";59;21;105;9;18;212
"5227";"360810577002";78;30;560;11;45;724
"5228";"360810577003";54;19;214;14;26;327
"5229";"360810579001";62;50;74;3;15;204
"5230";"360810579002";63;9;400;17;8;497
"5231";"360810580001";14;5;7;7;7;40
"5232";"360810580002";49;14;40;4;29;136
"5233";"360810580003";52;6;59;7;27;151
"5234";"360810580004";27;6;14;8;19;74
"5235";"360810581001";41;21;423;8;13;506
"5236";"360810581002";54;47;398;9;69;577
"5237";"360810582001";78;27;97;21;24;247
"5238";"360810582002";84;19;180;26;36;345
"5239";"360810582003";40;7;99;13;32;191
"5240";"360810583001";572;116;122;3;53;866
"5241";"360810583002";34;123;169;2;70;398
"5242";"360810583003";56;31;178;12;24;301
"5243";"360810585001";66;63;120;5;31;285
"5244";"360810585002";51;14;208;5;26;304
"5245";"360810585003";178;725;252;4;77;1236
"5246";"360810587001";26;20;374;5;37;462
"5247";"360810587002";26;27;90;1;52;196
"5248";"360810587003";64;10;286;5;50;415
"5249";"360810589001";98;59;238;17;27;439
"5250";"360810589002";99;93;173;13;49;427
"5251";"360810589003";101;286;69;5;59;520
"5252";"360810590001";30;19;66;20;32;167
"5253";"360810591001";99;90;120;2;47;358
"5254";"360810591002";84;27;205;7;21;344
"5255";"360810591003";67;101;256;5;26;455
"5256";"360810591004";69;18;138;3;15;243
"5257";"360810592001";12;9;39;10;26;96
"5258";"360810593001";141;37;145;6;29;358
"5259";"360810593002";100;34;361;6;48;549
"5260";"360810594001";7;18;23;17;9;74
"5261";"360810594002";13;8;21;7;18;67
"5262";"360810595001";62;46;553;27;43;731
"5263";"360810595002";144;200;156;2;45;547
"5264";"360810595003";31;21;207;4;30;293
"5265";"360810595004";151;196;258;16;42;663
"5266";"360810596001";7;0;11;4;10;32
"5267";"360810596002";9;5;19;6;10;49
"5268";"360810598001";19;14;28;3;16;80
"5269";"360810598002";26;20;41;26;27;140
"5270";"360810599001";19;24;224;13;29;309
"5271";"360810599002";58;29;222;2;21;332
"5272";"360810600001";32;33;79;5;23;172
"5273";"360810601001";75;48;347;12;78;560
"5274";"360810601002";47;54;337;37;28;503
"5275";"360810603001";61;40;406;41;75;623
"5276";"360810606001";40;10;33;7;12;102
"5277";"360810606002";65;13;14;10;15;117
"5278";"360810607011";9;12;136;9;10;176
"5279";"360810608001";95;210;72;9;44;430
"5280";"360810610001";32;55;118;18;44;267
"5281";"360810612001";38;7;16;8;12;81
"5282";"360810612002";14;7;79;9;24;133
"5283";"360810613011";97;67;473;7;74;718
"5284";"360810613012";95;192;853;45;134;1319
"5285";"360810613013";95;85;345;13;43;581
"5286";"360810613014";192;268;140;3;18;621
"5287";"360810613021";2;5;5;0;3;15
"5288";"360810614001";18;6;37;10;14;85
"5289";"360810616011";15;1;20;8;19;63
"5290";"360810616012";8;0;17;7;5;37
"5291";"360810616013";3;0;15;2;3;23
"5292";"360810616021";9;17;42;11;16;95
"5293";"360810616022";11;8;12;4;16;51
"5294";"360810618001";5;2;9;3;5;24
"5295";"360810618002";44;17;70;11;38;180
"5296";"360810619001";67;59;282;21;53;482
"5297";"360810619002";73;18;261;8;45;405
"5298";"360810620001";35;9;28;24;23;119
"5299";"360810621001";85;9;315;5;57;471
"5300";"360810621002";18;42;266;35;45;406
"5301";"360810621003";39;12;168;2;37;258
"5302";"360810622001";4;15;55;9;27;110
"5303";"360810622002";50;21;83;13;22;189
"5304";"360810623001";54;16;341;24;37;472
"5305";"360810623002";44;11;395;12;19;481
"5306";"360810624001";0;1;0;0;1;2
"5307";"360810625001";23;66;162;5;67;323
"5308";"360810625002";39;27;500;19;41;626
"5309";"360810626001";53;54;152;25;24;308
"5310";"360810626002";22;37;44;30;23;156
"5311";"360810626003";13;3;18;13;21;68
"5312";"360810627001";49;10;503;11;34;607
"5313";"360810627002";83;22;329;5;30;469
"5314";"360810629001";30;22;536;8;40;636
"5315";"360810629002";27;26;87;7;40;187
"5316";"360810629003";43;11;286;4;12;356
"5317";"360810630001";10;17;79;36;26;168
"5318";"360810630002";25;8;31;18;23;105
"5319";"360810632001";2;1;18;6;15;42
"5320";"360810632002";48;12;109;18;34;221
"5321";"360810633011";89;47;612;71;65;884
"5322";"360810633021";19;79;123;3;9;233
"5323";"360810633022";14;6;239;6;27;292
"5324";"360810635001";10;17;173;7;22;229
"5325";"360810635002";34;25;969;41;56;1125
"5326";"360810637001";26;36;147;38;58;305
"5327";"360810637002";25;19;268;22;67;401
"5328";"360810637003";25;54;105;7;56;247
"5329";"360810638001";31;5;58;7;10;111
"5330";"360810638002";14;14;61;9;13;111
"5331";"360810638003";5;9;30;9;14;67
"5332";"360810638004";23;19;24;18;15;99
"5333";"360810638005";83;49;20;7;17;176
"5334";"360810639001";45;15;272;34;25;391
"5335";"360810639002";37;71;259;24;128;519
"5336";"360810641011";19;20;72;4;16;131
"5337";"360810641021";99;320;503;25;125;1072
"5338";"360810645001";15;8;20;7;15;65
"5339";"360810645002";29;56;126;10;68;289
"5340";"360810646001";29;4;58;25;19;135
"5341";"360810646002";41;12;36;25;38;152
"5342";"360810650001";27;16;22;16;19;100
"5343";"360810650002";35;33;55;28;21;172
"5344";"360810654001";76;76;81;19;43;295
"5345";"360810654002";70;42;79;11;37;239
"5346";"360810654003";59;54;89;16;24;242
"5347";"360810655011";2;4;484;1;34;525
"5348";"360810656001";53;36;73;17;26;205
"5349";"360810656002";73;7;29;16;22;147
"5350";"360810656003";215;45;212;29;43;544
"5351";"360810657021";68;24;250;13;51;406
"5352";"360810657031";78;13;258;6;60;415
"5353";"360810657032";41;42;138;9;39;269
"5354";"360810657033";42;20;127;4;17;210
"5355";"360810659001";42;86;86;7;11;232
"5356";"360810659002";116;13;262;18;102;511
"5357";"360810660001";108;17;57;20;24;226
"5358";"360810660002";46;8;68;35;30;187
"5359";"360810661001";31;25;195;1;29;281
"5360";"360810663001";14;5;200;11;14;244
"5361";"360810663002";22;15;152;2;39;230
"5362";"360810663003";47;79;172;8;201;507
"5363";"360810664001";8;8;37;12;20;85
"5364";"360810664002";64;18;77;28;35;222
"5365";"360810664003";43;20;106;13;33;215
"5366";"360810664004";99;8;55;7;14;183
"5367";"360810664005";52;4;65;21;34;176
"5368";"360810664006";10;10;33;10;7;70
"5369";"360810664007";141;11;142;19;25;338
"5370";"360810664008";59;7;69;6;25;166
"5371";"360810665011";25;7;89;2;20;143
"5372";"360810665012";59;61;183;8;20;331
"5373";"360810665013";65;38;165;4;38;310
"5374";"360810665014";43;15;186;1;21;266
"5375";"360810667011";72;34;207;13;35;361
"5376";"360810667012";27;9;351;4;17;408
"5377";"360810669001";28;4;261;7;52;352
"5378";"360810669002";42;10;629;4;53;738
"5379";"360810671001";19;13;74;2;25;133
"5380";"360810671002";10;4;139;15;21;189
"5381";"360810677001";9;1;47;5;10;72
"5382";"360810677002";11;15;100;6;20;152
"5383";"360810679001";8;5;98;3;8;122
"5384";"360810679002";248;13;68;8;31;368
"5385";"360810679003";32;39;606;5;31;713
"5386";"360810680001";10;5;41;28;26;110
"5387";"360810680002";54;7;110;63;27;261
"5388";"360810680003";111;101;181;67;43;503
"5389";"360810680004";70;11;112;10;29;232
"5390";"360810682001";3;4;30;9;16;62
"5391";"360810682002";6;3;28;10;13;60
"5392";"360810683001";130;16;46;2;19;213
"5393";"360810683002";51;15;93;2;37;198
"5394";"360810683003";26;13;75;3;61;178
"5395";"360810687001";23;9;46;0;11;89
"5396";"360810687002";81;4;104;0;16;205
"5397";"360810687003";58;17;631;4;107;817
"5398";"360810690001";123;37;132;37;55;384
"5399";"360810690002";52;15;102;30;17;216
"5400";"360810693001";97;58;372;2;86;615
"5401";"360810693002";32;5;203;1;24;265
"5402";"360810694001";63;11;101;25;23;223
"5403";"360810694002";64;53;204;54;19;394
"5404";"360810695001";24;36;169;1;29;259
"5405";"360810695002";22;5;131;2;10;170
"5406";"360810697011";70;19;30;1;28;148
"5407";"360810697012";143;6;203;1;22;375
"5408";"360810697013";57;10;76;1;9;153
"5409";"360810697021";22;3;53;2;24;104
"5410";"360810697022";18;3;159;11;27;218
"5411";"360810697023";15;12;105;3;16;151
"5412";"360810697024";93;13;202;12;18;338
"5413";"360810703001";32;4;321;17;30;404
"5414";"360810703002";37;18;2429;18;32;2534
"5415";"360810707001";15;3;44;1;8;71
"5416";"360810707002";3;4;15;2;8;32
"5417";"360810707003";29;8;39;3;11;90
"5418";"360810709001";50;11;72;4;17;154
"5419";"360810709002";14;15;92;4;23;148
"5420";"360810711001";32;3;148;4;5;192
"5421";"360810711002";118;59;195;4;133;509
"5422";"360810711003";22;8;23;1;9;63
"5423";"360810711004";17;39;51;2;200;309
"5424";"360810713031";60;14;91;1;22;188
"5425";"360810713032";97;45;61;0;45;248
"5426";"360810713033";37;2;24;3;9;75
"5427";"360810713041";33;1;46;1;8;89
"5428";"360810713042";11;9;39;0;6;65
"5429";"360810713043";5;1;0;1;5;12
"5430";"360810713044";72;8;43;4;10;137
"5431";"360810713051";28;11;18;0;22;79
"5432";"360810713052";13;8;27;0;33;81
"5433";"360810713053";94;16;51;0;46;207
"5434";"360810713061";47;25;117;1;7;197
"5435";"360810713062";178;33;274;3;190;678
"5436";"360810713063";37;26;65;1;406;535
"5437";"360810713064";81;16;51;1;37;186
"5438";"360810716001";0;2;108;0;42;152
"5439";"360810717011";41;16;13;0;29;99
"5440";"360810717012";73;15;103;2;57;250
"5441";"360810717013";7;10;28;0;13;58
"5442";"360810717014";36;18;380;3;29;466
"5443";"360810717021";32;137;153;8;224;554
"5444";"360810717022";14;9;30;1;4;58
"5445";"360810719001";604;16;201;5;42;868
"5446";"360810719002";84;40;260;2;33;419
"5447";"360810721001";42;4;15;5;33;99
"5448";"360810721002";7;2;18;3;13;43
"5449";"360810721003";1087;19;64;2;21;1193
"5450";"360810721004";17;16;24;0;30;87
"5451";"360810721005";18;6;229;2;22;277
"5452";"360810723001";6;23;2;5;11;47
"5453";"360810723002";10;7;14;2;6;39
"5454";"360810723003";9;3;28;1;8;49
"5455";"360810729001";6;7;29;3;14;59
"5456";"360810729002";17;17;86;0;56;176
"5457";"360810731001";8;46;44;5;14;117
"5458";"360810731002";24;91;61;1;30;207
"5459";"360810737001";27;102;23;0;192;344
"5460";"360810737002";56;35;6;1;51;149
"5461";"360810739001";12;2;18;2;1;35
"5462";"360810739002";33;12;14;7;8;74
"5463";"360810739003";51;123;15;0;7;196
"5464";"360810739004";17;32;23;0;10;82
"5465";"360810739005";27;15;8;1;27;78
"5466";"360810741001";6;7;38;0;5;56
"5467";"360810741002";18;9;66;0;20;113
"5468";"360810741003";5;0;13;0;1;19
"5469";"360810741004";3;9;19;0;12;43
"5470";"360810743001";4;8;19;0;45;76
"5471";"360810743002";18;4;44;0;27;93
"5472";"360810743003";63;30;34;1;30;158
"5473";"360810743004";33;9;8;0;66;116
"5474";"360810745001";122;21;115;1;29;288
"5475";"360810745002";181;73;39;2;73;368
"5476";"360810747001";72;59;166;11;159;467
"5477";"360810747002";39;20;139;6;46;250
"5478";"360810749001";11;4;4;0;8;27
"5479";"360810749002";4;14;15;2;3;38
"5480";"360810757011";126;285;110;4;28;553
"5481";"360810757012";27;11;23;0;22;83
"5482";"360810757013";15;26;90;6;23;160
"5483";"360810757021";34;9;15;1;10;69
"5484";"360810757022";56;28;143;4;46;277
"5485";"360810757023";19;14;6;0;2;41
"5486";"360810769011";14;8;9;1;23;55
"5487";"360810769012";162;71;30;0;69;332
"5488";"360810769021";73;54;69;0;57;253
"5489";"360810773001";58;353;180;10;137;738
"5490";"360810773002";20;9;41;4;34;108
"5491";"360810775001";35;15;29;0;28;107
"5492";"360810775002";12;16;37;2;18;85
"5493";"360810775003";13;65;71;6;34;189
"5494";"360810779021";4;2;22;4;18;50
"5495";"360810779022";13;4;40;8;31;96
"5496";"360810779023";7;15;52;8;37;119
"5497";"360810779024";5;1;11;1;3;21
"5498";"360810779025";18;4;55;8;16;101
"5499";"360810779031";35;7;69;2;6;119
"5500";"360810779032";13;3;37;3;14;70
"5501";"360810779033";19;1;41;1;9;71
"5502";"360810779041";39;3;18;1;19;80
"5503";"360810779042";89;10;60;12;47;218
"5504";"360810779043";82;7;68;3;26;186
"5505";"360810779044";18;5;31;5;10;69
"5506";"360810779051";132;16;54;8;30;240
"5507";"360810779052";3;4;12;0;7;26
"5508";"360810779061";32;34;54;2;40;162
"5509";"360810779062";46;24;82;16;48;216
"5510";"360810779071";74;15;58;2;26;175
"5511";"360810779072";26;3;44;0;39;112
"5512";"360810779081";46;10;28;1;11;96
"5513";"360810779082";148;5;43;1;25;222
"5514";"360810788001";134;21;123;15;50;343
"5515";"360810788002";68;14;50;19;18;169
"5516";"360810790001";205;61;108;26;57;457
"5517";"360810790002";164;19;152;44;53;432
"5518";"360810792001";95;39;178;37;50;399
"5519";"360810792002";208;29;170;31;59;497
"5520";"360810793001";0;2;4;0;1;7
"5521";"360810797011";23;2;11;0;7;43
"5522";"360810797012";387;12;4;1;15;419
"5523";"360810797013";12;3;0;0;15;30
"5524";"360810797014";11;10;25;0;9;55
"5525";"360810797021";38;22;182;2;24;268
"5526";"360810797022";71;13;85;0;19;188
"5527";"360810797023";9;3;6;0;3;21
"5528";"360810799001";24;5;344;4;51;428
"5529";"360810799002";48;25;169;2;28;272
"5530";"360810803011";87;51;124;4;15;281
"5531";"360810803012";64;12;234;8;33;351
"5532";"360810803013";22;5;97;5;31;160
"5533";"360810803021";30;9;98;14;18;169
"5534";"360810803022";73;15;102;25;28;243
"5535";"360810803023";20;3;98;9;15;145
"5536";"360810809001";8;9;14;3;4;38
"5537";"360810809002";17;0;29;0;2;48
"5538";"360810809003";69;9;65;1;31;175
"5539";"360810809004";13;13;43;5;30;104
"5540";"360810809005";8;0;9;1;5;23
"5541";"360810809006";10;3;7;1;2;23
"5542";"360810809007";24;38;41;3;29;135
"5543";"360810814001";108;13;299;27;97;544
"5544";"360810814002";153;79;94;15;69;410
"5545";"360810814003";114;17;142;22;49;344
"5546";"360810818001";114;64;172;17;66;433
"5547";"360810818002";121;64;151;52;36;424
"5548";"360810818003";81;43;148;12;38;322
"5549";"360810837001";63;228;144;12;131;578
"5550";"360810837002";29;14;114;5;30;192
"5551";"360810837003";36;4;72;3;35;150
"5552";"360810837004";14;4;30;8;21;77
"5553";"360810838001";95;25;175;34;53;382
"5554";"360810838002";35;14;132;12;37;230
"5555";"360810838003";59;16;155;15;76;321
"5556";"360810838004";143;27;127;6;46;349
"5557";"360810840001";91;37;240;24;70;462
"5558";"360810840002";267;78;172;27;90;634
"5559";"360810840003";39;22;160;20;40;281
"5560";"360810840004";101;9;133;9;75;327
"5561";"360810840005";224;73;143;7;122;569
"5562";"360810845001";30;3;0;0;9;42
"5563";"360810845002";127;18;18;3;22;188
"5564";"360810845003";45;32;244;5;87;413
"5565";"360810846011";84;24;252;25;35;420
"5566";"360810846012";232;35;94;23;48;432
"5567";"360810846021";80;114;439;123;60;816
"5568";"360810849001";78;2;163;0;37;280
"5569";"360810849002";39;37;76;0;22;174
"5570";"360810849003";70;10;86;2;32;200
"5571";"360810849004";20;177;174;11;56;438
"5572";"360810853001";60;42;47;1;68;218
"5573";"360810853002";20;29;13;0;34;96
"5574";"360810853003";25;12;79;0;43;159
"5575";"360810853004";22;5;16;0;4;47
"5576";"360810855001";41;4;12;0;10;67
"5577";"360810855002";187;11;86;2;10;296
"5578";"360810855003";366;3;65;0;6;440
"5579";"360810855004";102;104;40;0;32;278
"5580";"360810857001";30;5;31;0;21;87
"5581";"360810857002";27;11;42;1;18;99
"5582";"360810857003";277;15;59;0;574;925
"5583";"360810859001";28;4;20;0;10;62
"5584";"360810859002";38;14;84;0;39;175
"5585";"360810859003";70;80;47;0;50;247
"5586";"360810861001";47;2;31;0;9;89
"5587";"360810861002";34;24;84;0;22;164
"5588";"360810863001";20;5;11;0;8;44
"5589";"360810863002";41;7;81;0;7;136
"5590";"360810863003";65;13;4;0;6;88
"5591";"360810863004";53;4;61;0;18;136
"5592";"360810864001";108;57;264;25;98;552
"5593";"360810864002";139;73;119;17;55;403
"5594";"360810865001";61;21;117;1;28;228
"5595";"360810865002";57;37;73;1;40;208
"5596";"360810869001";41;85;180;8;68;382
"5597";"360810869002";46;49;173;19;50;337
"5598";"360810871001";241;129;73;1;106;550
"5599";"360810871002";45;68;190;19;140;462
"5600";"360810884001";18;12;73;9;29;141
"5601";"360810884002";17;7;54;2;58;138
"5602";"360810884003";8;4;36;5;19;72
"5603";"360810884004";30;8;133;4;34;209
"5604";"360810884005";48;25;61;3;58;195
"5605";"360810884006";113;21;86;44;51;315
"5606";"360810884007";7;3;43;4;9;66
"5607";"360810884008";10;6;56;4;31;107
"5608";"360810889011";71;18;236;23;38;386
"5609";"360810889012";43;10;25;1;5;84
"5610";"360810889013";43;16;33;1;31;124
"5611";"360810889014";70;25;38;2;11;146
"5612";"360810889015";37;26;29;4;10;106
"5613";"360810889016";239;41;53;1;26;360
"5614";"360810889017";42;15;45;1;12;115
"5615";"360810892001";38;16;42;4;34;134
"5616";"360810892002";39;108;20;9;14;190
"5617";"360810892003";52;12;45;3;44;156
"5618";"360810892004";41;14;33;1;28;117
"5619";"360810892005";59;26;64;7;72;228
"5620";"360810892006";9;7;15;0;12;43
"5621";"360810892007";17;19;14;0;45;95
"5622";"360810892008";21;51;23;0;42;137
"5623";"360810907001";131;223;344;56;90;844
"5624";"360810916011";10;2;11;0;11;34
"5625";"360810916012";1;0;0;0;2;3
"5626";"360810916013";19;21;1;0;12;53
"5627";"360810916014";2;3;54;0;10;69
"5628";"360810916021";0;0;29;0;2;31
"5629";"360810918000";0;0;0;0;1;1
"5630";"360810918001";1;6;11;0;27;45
"5631";"360810919001";132;33;144;17;30;356
"5632";"360810919002";170;18;443;20;41;692
"5633";"360810919003";156;13;221;19;29;438
"5634";"360810922001";31;5;62;0;22;120
"5635";"360810922002";9;3;112;1;13;138
"5636";"360810922003";5;10;273;0;22;310
"5637";"360810925001";65;62;256;9;43;435
"5638";"360810925002";154;71;231;31;63;550
"5639";"360810925003";129;26;262;13;39;469
"5640";"360810928001";181;55;125;3;166;530
"5641";"360810928002";20;5;20;0;18;63
"5642";"360810928003";14;5;101;0;7;127
"5643";"360810929000";4;9;0;0;0;13
"5644";"360810929001";644;709;422;67;117;1959
"5645";"360810929002";146;37;404;22;75;684
"5646";"360810929003";73;10;141;14;18;256
"5647";"360810929004";30;7;73;5;20;135
"5648";"360810934010";14;7;29;0;23;73
"5649";"360810934011";17;14;112;5;50;198
"5650";"360810934012";61;54;388;2;48;553
"5651";"360810934013";25;110;220;0;45;400
"5652";"360810934021";88;22;255;2;19;386
"5653";"360810934022";18;14;103;1;14;150
"5654";"360810934023";65;21;716;2;43;847
"5655";"360810938001";32;8;56;4;78;178
"5656";"360810938002";82;37;299;0;50;468
"5657";"360810938003";261;158;257;3;220;899
"5658";"360810939001";220;62;240;31;63;616
"5659";"360810939002";81;17;139;28;30;295
"5660";"360810939003";110;30;317;17;28;502
"5661";"360810942011";563;465;802;31;164;2025
"5662";"360810942021";242;79;244;13;37;615
"5663";"360810942022";368;191;545;22;91;1217
"5664";"360810942031";120;59;227;14;51;471
"5665";"360810942032";10;57;312;2;33;414
"5666";"360810942033";139;26;211;5;22;403
"5667";"360810942034";12;36;54;1;4;107
"5668";"360810942035";7;7;20;7;4;45
"5669";"360810945000";4;5;3;0;0;12
"5670";"360810945001";160;162;92;16;98;528
"5671";"360810945002";70;82;136;43;105;436
"5672";"360810947001";67;29;193;14;41;344
"5673";"360810947002";284;25;166;17;35;527
"5674";"360810954001";243;22;74;20;57;416
"5675";"360810954002";40;9;56;7;35;147
"5676";"360810954003";66;37;143;18;55;319
"5677";"360810964001";172;37;153;36;55;453
"5678";"360810964002";143;192;275;29;53;692
"5679";"360810972021";363;146;36;11;33;589
"5680";"360810972031";74;3;39;16;16;148
"5681";"360810972032";81;15;10;0;12;118
"5682";"360810972033";34;4;37;22;14;111
"5683";"360810972034";252;28;15;2;21;318
"5684";"360810972041";53;22;11;2;14;102
"5685";"360810972042";251;72;247;34;37;641
"5686";"360810972043";37;10;15;1;8;71
"5687";"360810973001";31;212;31;7;71;352
"5688";"360810973002";35;59;61;8;18;181
"5689";"360810973003";26;7;8;2;13;56
"5690";"360810981001";74;22;85;8;28;217
"5691";"360810981002";20;171;128;10;48;377
"5692";"360810987001";27;67;61;5;40;200
"5693";"360810987002";111;129;122;18;120;500
"5694";"360810991000";2;0;14;0;3;19
"5695";"360810991001";36;24;134;4;22;220
"5696";"360810991002";43;7;70;0;6;126
"5697";"360810991003";26;32;57;2;58;175
"5698";"360810991004";28;18;16;2;10;74
"5699";"360810991005";64;16;126;1;48;255
"5700";"360810992001";186;12;123;29;20;370
"5701";"360810992002";163;22;87;21;42;335
"5702";"360810997011";53;14;44;3;22;136
"5703";"360810997012";65;3;10;0;25;103
"5704";"360810997013";8;7;31;4;26;76
"5705";"360810997031";200;15;194;3;19;431
"5706";"360810997032";5;2;7;0;4;18
"5707";"360810997033";32;12;45;4;23;116
"5708";"360810997041";60;2;37;1;10;110
"5709";"360810997042";20;16;80;7;46;169
"5710";"360810997043";16;5;140;3;4;168
"5711";"360810997044";17;20;44;0;23;104
"5712";"360810997050";0;1;0;0;2;3
"5713";"360810997051";27;20;110;11;32;200
"5714";"360810998011";67;12;111;14;20;224
"5715";"360810998012";106;17;18;4;14;159
"5716";"360810998013";126;8;148;4;25;311
"5717";"360810998014";19;1;27;0;19;66
"5718";"360810998015";49;6;102;23;23;203
"5719";"360810998021";202;55;88;65;59;469
"5720";"360810998022";69;4;27;1;10;111
"5721";"360810998023";8;10;16;0;16;50
"5722";"360810999001";0;13;4;0;33;50
"5723";"360811008011";100;11;18;12;17;158
"5724";"360811008012";94;31;62;17;39;243
"5725";"360811008021";123;152;452;10;108;845
"5726";"360811008022";40;4;87;28;25;184
"5727";"360811008023";40;16;57;21;23;157
"5728";"360811008024";50;10;43;15;34;152
"5729";"360811010011";122;77;212;4;38;453
"5730";"360811010012";67;26;70;5;19;187
"5731";"360811010013";139;171;134;7;118;569
"5732";"360811010014";49;16;87;9;62;223
"5733";"360811010021";33;14;60;9;35;151
"5734";"360811010022";289;51;254;8;57;659
"5735";"360811017001";87;10;33;5;24;159
"5736";"360811017002";12;1;27;0;20;60
"5737";"360811017003";9;21;40;7;40;117
"5738";"360811017004";4;6;110;1;8;129
"5739";"360811017005";13;6;41;4;24;88
"5740";"360811017006";19;28;99;2;26;174
"5741";"360811017007";9;9;44;1;4;67
"5742";"360811029001";44;32;308;7;62;453
"5743";"360811029002";128;134;90;2;26;380
"5744";"360811032011";83;15;130;15;40;283
"5745";"360811032012";254;11;153;21;33;472
"5746";"360811032013";74;46;66;3;22;211
"5747";"360811032021";31;117;74;9;18;249
"5748";"360811032022";15;5;227;6;8;261
"5749";"360811032023";111;29;166;4;32;342
"5750";"360811032024";150;41;110;2;30;333
"5751";"360811033001";65;16;149;11;31;272
"5752";"360811033002";64;30;146;6;27;273
"5753";"360811033003";15;4;21;4;15;59
"5754";"360811033004";45;33;45;10;17;150
"5755";"360811039001";99;19;236;8;37;399
"5756";"360811039002";58;19;268;4;45;394
"5757";"360811039003";40;21;133;9;38;241
"5758";"360811039004";26;267;164;13;47;517
"5759";"360811047001";37;38;134;4;33;246
"5760";"360811047002";25;36;45;10;91;207
"5761";"360811047003";19;18;110;3;36;186
"5762";"360811047004";22;17;54;0;22;115
"5763";"360811047005";71;9;392;12;38;522
"5764";"360811059001";15;17;15;0;26;73
"5765";"360811059002";51;7;21;10;25;114
"5766";"360811059003";10;17;17;0;17;61
"5767";"360811059004";15;10;25;1;33;84
"5768";"360811072011";118;58;353;20;83;632
"5769";"360811072020";2;9;2;0;3;16
"5770";"360811072021";0;1;0;1;3;5
"5771";"360811085001";28;6;47;2;22;105
"5772";"360811085002";21;9;88;7;12;137
"5773";"360811085003";7;13;290;7;41;358
"5774";"360811093001";4;7;22;4;23;60
"5775";"360811093002";12;16;8;1;42;79
"5776";"360811093003";6;3;9;0;12;30
"5777";"360811097001";9;3;11;1;20;44
"5778";"360811097002";35;49;51;1;20;156
"5779";"360811097003";22;7;4;2;10;45
"5780";"360811099001";27;25;90;2;52;196
"5781";"360811099002";14;4;37;0;39;94
"5782";"360811099003";13;8;79;5;32;137
"5783";"360811113001";18;7;18;3;30;76
"5784";"360811113002";21;8;29;12;28;98
"5785";"360811113003";19;4;39;4;22;88
"5786";"360811123001";50;8;97;3;47;205
"5787";"360811123002";57;251;146;1;105;560
"5788";"360811129001";29;15;9;0;12;65
"5789";"360811129002";5;5;25;8;8;51
"5790";"360811129003";65;5;66;1;14;151
"5791";"360811133001";20;7;62;3;33;125
"5792";"360811133002";11;7;64;0;24;106
"5793";"360811139001";7;30;113;8;15;173
"5794";"360811139002";48;12;141;12;17;230
"5795";"360811139003";16;2;64;4;19;105
"5796";"360811141001";21;9;37;2;39;108
"5797";"360811141002";17;13;45;0;23;98
"5798";"360811147001";21;4;64;1;25;115
"5799";"360811147002";38;6;29;7;17;97
"5800";"360811151001";28;143;30;3;109;313
"5801";"360811155001";40;8;50;1;42;141
"5802";"360811155002";59;21;24;0;34;138
"5803";"360811157001";27;20;81;1;44;173
"5804";"360811157002";19;71;38;2;32;162
"5805";"360811157003";50;4;60;0;10;124
"5806";"360811159001";13;10;55;1;8;87
"5807";"360811159002";27;31;115;1;16;190
"5808";"360811159003";138;8;78;0;16;240
"5809";"360811161001";131;8;126;1;27;293
"5810";"360811161002";88;17;59;0;14;178
"5811";"360811163001";262;6;4;0;17;289
"5812";"360811163002";110;13;79;2;6;210
"5813";"360811163003";42;26;86;0;22;176
"5814";"360811163004";56;20;37;0;20;133
"5815";"360811163005";26;39;110;0;30;205
"5816";"360811167001";78;126;1247;6;63;1520
"5817";"360811171001";15;24;71;5;36;151
"5818";"360811171002";31;6;75;1;25;138
"5819";"360811171003";47;41;67;5;23;183
"5820";"360811175001";8;64;80;2;14;168
"5821";"360811175002";43;171;270;4;18;506
"5822";"360811175003";20;27;100;2;21;170
"5823";"360811175004";15;25;113;6;21;180
"5824";"360811181001";25;0;64;0;23;112
"5825";"360811181002";66;14;109;2;46;237
"5826";"360811185001";65;12;76;4;33;190
"5827";"360811185002";57;6;84;2;19;168
"5828";"360811187001";20;2;41;5;15;83
"5829";"360811187002";111;9;388;8;46;562
"5830";"360811189001";76;6;192;5;31;310
"5831";"360811189002";5;3;83;2;26;119
"5832";"360811191001";93;20;366;0;33;512
"5833";"360811191002";87;12;214;6;55;374
"5834";"360811193001";38;7;121;5;32;203
"5835";"360811193002";75;8;100;0;18;201
"5836";"360811195001";51;24;97;7;35;214
"5837";"360811199001";86;7;170;15;29;307
"5838";"360811201001";37;8;140;7;35;227
"5839";"360811203001";19;7;60;1;3;90
"5840";"360811203002";30;24;62;2;21;139
"5841";"360811205001";55;44;140;6;31;276
"5842";"360811207001";20;17;98;3;23;161
"5843";"360811207002";59;16;128;30;41;274
"5844";"360811211001";4;33;28;8;67;140
"5845";"360811215001";86;15;191;21;27;340
"5846";"360811215002";48;26;102;6;55;237
"5847";"360811215003";62;9;150;10;44;275
"5848";"360811223001";40;16;90;9;19;174
"5849";"360811223002";34;13;109;9;25;190
"5850";"360811223003";30;10;51;8;52;151
"5851";"360811227011";48;9;228;10;36;331
"5852";"360811227012";20;4;72;14;41;151
"5853";"360811227013";137;1139;1580;45;971;3872
"5854";"360811227014";63;21;32;0;15;131
"5855";"360811227015";94;16;86;10;34;240
"5856";"360811227016";2;0;13;0;2;17
"5857";"360811227017";108;25;45;3;8;189
"5858";"360811227021";196;24;85;5;9;319
"5859";"360811227022";105;19;47;9;48;228
"5860";"360811227023";525;24;14;3;43;609
"5861";"360811227024";39;14;85;5;19;162
"5862";"360811227025";159;39;91;9;209;507
"5863";"360811241001";86;2;55;17;30;190
"5864";"360811241002";59;7;54;4;14;138
"5865";"360811241003";116;7;101;14;20;258
"5866";"360811247001";73;9;39;9;21;151
"5867";"360811247002";19;7;39;9;8;82
"5868";"360811247003";44;11;128;9;10;202
"5869";"360811257001";150;50;278;14;30;522
"5870";"360811257002";636;4515;390;0;301;5842
"5871";"360811257003";547;8129;2575;0;625;11876
"5872";"360811265001";15;6;74;5;28;128
"5873";"360811265002";53;1888;139;18;309;2407
"5874";"360811267001";34;32;31;8;35;140
"5875";"360811267002";23;4547;239;4;316;5129
"5876";"360811267003";36;5;43;13;38;135
"5877";"360811277001";93;14;20;8;18;153
"5878";"360811277002";102;15;24;5;24;170
"5879";"360811277003";43;6;11;10;15;85
"5880";"360811277004";33;12;20;1;23;89
"5881";"360811283001";12;149;141;1;307;610
"5882";"360811291021";30;7;38;1;31;107
"5883";"360811291022";46;1;6;1;15;69
"5884";"360811291023";34;1;9;3;13;60
"5885";"360811291024";8;3;39;5;11;66
"5886";"360811291031";47;9;24;0;32;112
"5887";"360811291032";53;11;41;1;23;129
"5888";"360811291033";43;9;10;6;27;95
"5889";"360811291041";33;9;1;0;22;65
"5890";"360811291042";9;5;63;6;11;94
"5891";"360811291043";10;7;22;1;14;54
"5892";"360811291044";4;3;17;0;22;46
"5893";"360811291045";23;4;65;0;15;107
"5894";"360811301001";17;2;40;2;19;80
"5895";"360811301002";20;4;43;5;13;85
"5896";"360811301003";39;19;74;4;42;178
"5897";"360811301004";13;3;56;1;17;90
"5898";"360811333001";37;5;74;2;36;154
"5899";"360811333002";39;2;27;4;9;81
"5900";"360811333003";153;11;60;4;38;266
"5901";"360811333004";42;27;111;5;15;200
"5902";"360811339001";28;4;84;3;26;145
"5903";"360811341001";20;5;93;5;34;157
"5904";"360811341002";63;6;80;11;40;200
"5905";"360811341003";13;9;49;4;20;95
"5906";"360811347001";56;49;96;2;30;233
"5907";"360811347002";37;19;71;8;30;165
"5908";"360811347003";100;20;111;7;21;259
"5909";"360811347004";68;16;62;1;46;193
"5910";"360811347005";121;61;172;3;17;374
"5911";"360811367001";64;23;154;1;19;261
"5912";"360811367002";8;12;24;4;15;63
"5913";"360811367003";1;3;16;0;4;24
"5914";"360811367004";8;8;43;7;14;80
"5915";"360811367005";17;12;67;1;13;110
"5916";"360811377001";10;5;116;2;8;141
"5917";"360811377002";45;51;118;3;34;251
"5918";"360811377003";36;7;110;1;24;178
"5919";"360811377004";74;6;56;2;26;164
"5920";"360811385011";8;2;43;0;11;64
"5921";"360811385012";53;5;44;1;36;139
"5922";"360811385013";7;3;36;2;14;62
"5923";"360811385014";18;4;45;2;19;88
"5924";"360811385021";46;64;101;5;61;277
"5925";"360811399001";8;2;38;4;21;73
"5926";"360811399002";26;0;13;2;12;53
"5927";"360811403001";8;6;17;0;11;42
"5928";"360811403002";17;18;38;11;20;104
"5929";"360811409011";14;4;11;3;19;51
"5930";"360811409021";44;6;126;7;61;244
"5931";"360811409022";40;28;112;10;37;227
"5932";"360811417001";7;3;35;5;26;76
"5933";"360811417002";19;23;35;4;67;148
"5934";"360811417003";22;7;31;4;14;78
"5935";"360811417004";15;10;38;2;28;93
"5936";"360811417005";28;36;59;4;11;138
"5937";"360811429001";8;100;29;2;24;163
"5938";"360811429002";20;3;58;2;21;104
"5939";"360811429003";35;4;22;6;9;76
"5940";"360811429004";24;11;24;4;7;70
"5941";"360811435001";13;4;119;1;23;160
"5942";"360811435002";19;4;57;6;15;101
"5943";"360811441001";18;6;25;1;4;54
"5944";"360811441002";11;1;25;0;8;45
"5945";"360811441003";3;0;21;3;8;35
"5946";"360811441004";4;2;21;0;9;36
"5947";"360811447001";39;5;115;7;27;193
"5948";"360811447002";92;46;153;0;55;346
"5949";"360811451011";75;10;101;4;42;232
"5950";"360811451021";22;5;31;2;26;86
"5951";"360811451022";27;5;84;6;31;153
"5952";"360811459001";12;5;23;1;11;52
"5953";"360811459002";16;6;98;8;27;155
"5954";"360811459003";37;2;55;3;20;117
"5955";"360811463001";22;10;85;7;16;140
"5956";"360811463002";12;11;85;2;24;134
"5957";"360811467001";239;116;141;3;38;537
"5958";"360811467002";22;19;9;1;9;60
"5959";"360811467003";16;2;74;13;26;131
"5960";"360811471001";108;21;195;18;27;369
"5961";"360811471002";18;8;60;0;25;111
"5962";"360811479001";9;8;62;0;19;98
"5963";"360811479002";20;6;128;1;29;184
"5964";"360811479003";31;7;131;2;15;186
"5965";"360811483001";18;5;61;0;27;111
"5966";"360811483002";6;8;43;3;19;79
"5967";"360811483003";6;19;14;3;25;67
"5968";"360811483004";18;5;21;0;59;103
"5969";"360811507011";2;3;19;2;19;45
"5970";"360811507012";8;8;45;0;30;91
"5971";"360811507013";3;0;91;5;3;102
"5972";"360811507021";9;4;22;7;8;50
"5973";"360811507022";4;2;26;0;8;40
"5974";"360811507023";20;1;42;6;21;90
"5975";"360811507024";16;41;109;1;12;179
"5976";"360811529011";25;6;124;7;14;176
"5977";"360811529012";52;56;200;18;48;374
"5978";"360811529013";11;26;116;3;28;184
"5979";"360811529021";6;3;15;0;14;38
"5980";"360811529022";7;5;21;2;14;49
"5981";"360811529023";8;3;57;4;20;92
"5982";"360811529024";7;2;25;3;31;68
"5983";"360811551011";9;1;0;0;5;15
"5984";"360811551021";13;4;118;0;8;143
"5985";"360811551022";7;1;20;1;9;38
"5986";"360811551023";26;106;177;3;29;341
"5987";"360811551024";11;86;109;4;20;230
"5988";"360811551025";1;1;66;2;11;81
"5989";"360811551026";0;1;30;2;4;37
"5990";"360811567001";22;11;79;12;80;204
"5991";"360811571011";3;3;23;1;9;39
"5992";"360811571012";15;38;50;2;20;125
"5993";"360811571013";1;2;48;1;0;52
"5994";"360811571014";35;3;20;5;12;75
"5995";"360811571015";35;3;31;2;29;100
"5996";"360811571016";17;3;33;20;26;99
"5997";"360811571017";13;1;33;5;36;88
"5998";"360811571018";11;3;9;5;30;58
"5999";"360811571021";16;5;26;6;21;74
"6000";"360811571022";19;6;90;1;26;142
"6001";"360811579011";27;10;25;4;14;80
"6002";"360811579012";19;3;13;1;30;66
"6003";"360811579013";17;2;9;0;31;59
"6004";"360811579014";24;2;8;0;13;47
"6005";"360811579015";9;1;16;1;9;36
"6006";"360811579016";42;8;19;0;33;102
"6007";"360811579021";21;5;22;9;25;82
"6008";"360811579022";29;5;28;1;13;76
"6009";"360811579023";62;181;7;3;23;276
"6010";"360811579024";10;2;10;1;20;43
"6011";"360811579025";11;6;27;1;44;89
"6012";"360811579031";35;7;36;8;12;98
"6013";"360811579032";14;8;39;1;34;96
"6014";"360811579033";26;5;106;28;33;198
"6015";"360811579034";15;10;115;17;17;174
"6016";"360811617001";34;1;73;4;48;160
"6017";"360811617002";4;5;23;2;20;54
"6018";"360811617003";16;0;49;10;39;114
"6019";"360811617004";53;17;154;9;58;291
"6020";"360811621001";58;9;32;2;25;126
"6021";"360811621002";91;13;119;15;26;264
"6022";"360811621003";89;16;43;4;25;177
"6023";"360811621004";28;3;64;4;20;119
"6024";"360811621005";54;18;106;14;42;234
"6025";"360850003001";52;11;20;0;261;344
"6026";"360850003002";52;395;16;3;85;551
"6027";"360850006001";24;52;55;19;41;191
"6028";"360850006002";102;17;111;8;34;272
"6029";"360850007001";103;1040;583;4;127;1857
"6030";"360850007002";75;14;159;17;14;279
"6031";"360850007003";61;72;44;15;16;208
"6032";"360850007004";323;33;106;2;65;529
"6033";"360850008001";32;18;169;35;44;298
"6034";"360850008002";91;10;113;14;29;257
"6035";"360850008003";78;12;113;20;40;263
"6036";"360850009001";249;31;289;13;39;621
"6037";"360850009002";78;21;58;27;39;223
"6038";"360850011001";124;67;70;20;78;359
"6039";"360850011002";69;23;90;50;59;291
"6040";"360850011003";156;52;69;30;40;347
"6041";"360850017001";1;2;9;5;9;26
"6042";"360850017002";59;11;53;26;18;167
"6043";"360850018001";1;0;2;0;6;9
"6044";"360850020011";30;3;83;10;60;186
"6045";"360850020012";23;0;32;17;22;94
"6046";"360850020021";65;11;91;17;60;244
"6047";"360850020022";2;1;33;4;26;66
"6048";"360850021001";170;23;129;29;48;399
"6049";"360850021002";331;232;231;54;86;934
"6050";"360850021003";290;156;179;49;101;775
"6051";"360850027001";133;63;91;77;68;432
"6052";"360850029001";190;46;198;110;72;616
"6053";"360850029002";391;79;13;5;21;509
"6054";"360850029003";145;52;149;77;94;517
"6055";"360850029004";43;30;70;42;34;219
"6056";"360850033001";29;16;33;7;21;106
"6057";"360850033002";109;23;158;23;46;359
"6058";"360850036001";34;7;138;30;27;236
"6059";"360850036002";86;15;48;11;27;187
"6060";"360850039001";5;2;23;0;3;33
"6061";"360850039002";74;20;18;5;39;156
"6062";"360850040001";76;12;58;24;15;185
"6063";"360850040002";540;79;63;25;70;777
"6064";"360850040003";205;10;39;10;20;284
"6065";"360850040004";57;19;55;9;44;184
"6066";"360850040005";32;11;18;0;23;84
"6067";"360850040006";120;22;36;5;53;236
"6068";"360850040007";103;10;47;4;15;179
"6069";"360850047001";44;14;120;13;49;240
"6070";"360850047002";54;12;27;3;24;120
"6071";"360850050001";40;4;52;2;39;137
"6072";"360850050002";57;30;178;4;26;295
"6073";"360850050003";2;5;29;5;25;66
"6074";"360850059001";73;38;41;13;103;268
"6075";"360850059002";108;28;64;2;40;242
"6076";"360850064001";8;0;60;0;16;84
"6077";"360850064002";7;4;20;1;12;44
"6078";"360850064003";118;24;76;12;49;279
"6079";"360850067001";14;12;10;13;15;64
"6080";"360850067002";30;33;73;6;90;232
"6081";"360850067003";30;7;26;2;23;88
"6082";"360850070001";88;43;144;23;102;400
"6083";"360850070002";41;4;83;23;31;182
"6084";"360850070003";66;16;75;14;62;233
"6085";"360850070004";109;20;99;14;37;279
"6086";"360850074001";54;14;124;14;23;229
"6087";"360850074002";103;59;161;11;94;428
"6088";"360850075001";75;21;73;27;21;217
"6089";"360850075002";40;6;69;23;19;157
"6090";"360850075003";112;7;110;38;42;309
"6091";"360850077001";84;37;62;30;50;263
"6092";"360850081001";60;96;68;32;35;291
"6093";"360850081002";101;17;45;22;36;221
"6094";"360850081003";168;66;73;22;67;396
"6095";"360850096011";54;84;51;1;34;224
"6096";"360850096012";23;13;88;10;29;163
"6097";"360850096021";69;18;75;6;57;225
"6098";"360850096022";39;44;40;2;52;177
"6099";"360850096023";124;3;44;1;24;196
"6100";"360850097001";96;33;100;27;71;327
"6101";"360850097002";47;15;24;34;24;144
"6102";"360850097003";34;25;25;4;29;117
"6103";"360850105001";21;3;43;2;15;84
"6104";"360850105002";16;7;34;10;42;109
"6105";"360850105003";67;25;114;7;41;254
"6106";"360850105004";105;60;172;22;84;443
"6107";"360850105005";179;81;122;27;118;527
"6108";"360850112011";37;25;112;3;87;264
"6109";"360850112012";71;16;102;17;81;287
"6110";"360850112021";39;19;93;7;115;273
"6111";"360850112022";60;52;90;9;30;241
"6112";"360850112023";64;9;98;7;54;232
"6113";"360850112024";1;2;0;0;12;15
"6114";"360850114011";19;11;56;7;28;121
"6115";"360850114012";238;28;51;6;43;366
"6116";"360850114021";6;1;38;3;32;80
"6117";"360850114022";48;15;80;2;26;171
"6118";"360850114023";42;8;32;4;29;115
"6119";"360850121001";18;4;30;4;11;67
"6120";"360850121002";18;2;26;3;47;96
"6121";"360850121003";30;13;27;6;65;141
"6122";"360850122001";8;4;16;1;18;47
"6123";"360850122002";19;25;22;2;54;122
"6124";"360850122003";22;9;21;2;33;87
"6125";"360850122004";15;126;31;1;27;200
"6126";"360850125001";371;81;158;26;116;752
"6127";"360850125002";34;9;57;13;43;156
"6128";"360850125003";19;11;57;1;36;124
"6129";"360850128041";105;49;140;18;89;401
"6130";"360850128042";213;11;296;10;131;661
"6131";"360850128051";56;11;73;7;75;222
"6132";"360850128061";15;3;25;8;21;72
"6133";"360850128062";36;12;17;7;13;85
"6134";"360850128063";123;17;46;0;68;254
"6135";"360850128064";123;22;113;10;39;307
"6136";"360850132011";7;3;15;1;12;38
"6137";"360850132012";9;0;8;4;8;29
"6138";"360850132031";14;4;22;10;20;70
"6139";"360850132032";46;6;59;11;42;164
"6140";"360850132033";64;17;103;7;58;249
"6141";"360850132041";21;7;51;0;48;127
"6142";"360850132042";18;4;75;1;46;144
"6143";"360850132043";17;10;24;6;22;79
"6144";"360850133011";293;11;39;14;25;382
"6145";"360850133021";36;13;111;17;45;222
"6146";"360850133022";86;46;131;46;68;377
"6147";"360850133023";483;59;113;47;127;829
"6148";"360850134001";34;12;39;1;37;123
"6149";"360850134002";11;6;39;5;19;80
"6150";"360850134003";40;3;30;5;18;96
"6151";"360850138001";22;4;24;1;21;72
"6152";"360850138002";71;5;42;0;37;155
"6153";"360850138003";28;4;71;3;46;152
"6154";"360850138004";22;1;34;0;27;84
"6155";"360850138005";20;3;16;2;25;66
"6156";"360850141001";78;11;75;16;46;226
"6157";"360850141002";69;10;79;8;28;194
"6158";"360850146041";10;3;32;2;36;83
"6159";"360850146042";57;25;57;3;115;257
"6160";"360850146043";47;11;67;4;40;169
"6161";"360850146044";22;20;76;6;51;175
"6162";"360850146051";20;16;71;9;38;154
"6163";"360850146052";61;28;26;1;47;163
"6164";"360850146061";31;5;198;9;64;307
"6165";"360850146062";55;24;78;2;26;185
"6166";"360850146063";49;6;72;1;34;162
"6167";"360850146064";12;2;83;1;32;130
"6168";"360850146071";48;42;184;17;71;362
"6169";"360850146072";18;15;42;3;38;116
"6170";"360850146081";48;6;193;14;63;324
"6171";"360850146082";27;16;102;4;57;206
"6172";"360850147001";2;3;16;2;23;46
"6173";"360850147002";22;30;40;0;58;150
"6174";"360850147003";25;4;89;3;30;151
"6175";"360850151001";69;56;71;9;55;260
"6176";"360850151002";7;3;13;1;12;36
"6177";"360850151003";12;1;9;0;8;30
"6178";"360850151004";35;2;26;3;16;82
"6179";"360850151005";19;17;29;8;47;120
"6180";"360850154001";3;1;2;0;8;14
"6181";"360850156011";12;16;27;7;58;120
"6182";"360850156012";22;4;10;8;5;49
"6183";"360850156013";17;5;28;0;27;77
"6184";"360850156014";45;3;16;3;21;88
"6185";"360850156015";10;10;11;1;27;59
"6186";"360850156016";13;6;34;0;14;67
"6187";"360850156021";7;11;37;1;37;93
"6188";"360850156022";17;8;8;0;18;51
"6189";"360850156023";15;12;17;0;39;83
"6190";"360850156024";4;4;9;0;10;27
"6191";"360850156031";15;8;45;2;36;106
"6192";"360850156032";27;16;67;9;82;201
"6193";"360850156033";46;96;80;19;99;340
"6194";"360850169011";16;11;41;8;57;133
"6195";"360850169012";14;25;35;8;44;126
"6196";"360850170051";65;16;104;4;113;302
"6197";"360850170052";101;84;89;5;62;341
"6198";"360850170071";64;103;87;5;60;319
"6199";"360850170072";133;84;82;9;49;357
"6200";"360850170081";40;14;95;7;59;215
"6201";"360850170082";30;3;179;11;74;297
"6202";"360850170083";22;15;174;4;77;292
"6203";"360850170091";10;0;23;2;24;59
"6204";"360850170092";30;3;12;12;71;128
"6205";"360850170093";37;7;44;3;44;135
"6206";"360850170101";51;27;183;13;97;371
"6207";"360850170102";53;9;207;12;154;435
"6208";"360850170103";180;6;225;7;51;469
"6209";"360850170104";30;6;65;2;36;139
"6210";"360850170111";32;4;61;0;54;151
"6211";"360850170112";18;6;32;2;48;106
"6212";"360850170121";45;65;86;4;63;263
"6213";"360850170122";54;12;85;1;39;191
"6214";"360850170123";21;7;60;7;18;113
"6215";"360850173001";13;8;41;5;45;112
"6216";"360850173002";137;45;13;2;22;219
"6217";"360850176001";32;7;86;4;36;165
"6218";"360850176002";23;6;13;6;28;76
"6219";"360850176003";74;17;61;4;50;206
"6220";"360850176004";21;4;25;4;26;80
"6221";"360850177001";25;6;11;2;8;52
"6222";"360850177002";33;57;34;3;19;146
"6223";"360850177003";24;30;30;5;24;113
"6224";"360850177004";34;33;34;5;38;144
"6225";"360850177005";11;9;39;2;13;74
"6226";"360850177006";1;1;2;0;1;5
"6227";"360850181001";26;4;20;0;15;65
"6228";"360850181002";49;7;22;5;52;135
"6229";"360850181003";21;31;12;2;14;80
"6230";"360850187011";28;23;54;4;60;169
"6231";"360850187012";23;3;33;4;14;77
"6232";"360850187021";57;5;40;4;26;132
"6233";"360850187022";60;46;75;6;64;251
"6234";"360850187023";23;8;59;3;23;116
"6235";"360850187024";54;6;97;5;35;197
"6236";"360850189011";101;29;113;16;179;438
"6237";"360850189012";134;14;55;6;78;287
"6238";"360850189021";25;9;57;0;12;103
"6239";"360850189022";51;5;64;7;22;149
"6240";"360850189023";47;15;50;10;35;157
"6241";"360850197001";23;2;9;6;18;58
"6242";"360850197002";34;2;38;5;15;94
"6243";"360850198000";0;0;0;0;2;2
"6244";"360850198001";0;6;1;0;6;13
"6245";"360850198002";50;14;120;4;52;240
"6246";"360850198003";23;7;31;1;50;112
"6247";"360850198004";38;11;44;6;87;186
"6248";"360850201001";97;12;41;10;64;224
"6249";"360850201002";21;7;35;1;36;100
"6250";"360850201003";76;11;5;4;47;143
"6251";"360850207000";0;7;0;0;1;8
"6252";"360850207001";228;54;357;66;136;841
"6253";"360850207002";139;18;155;9;63;384
"6254";"360850207003";63;9;70;8;58;208
"6255";"360850207004";187;46;118;15;67;433
"6256";"360850208011";37;8;90;3;40;178
"6257";"360850208012";42;5;81;3;29;160
"6258";"360850208013";38;9;154;6;40;247
"6259";"360850208014";85;97;143;7;119;451
"6260";"360850208031";65;17;262;5;95;444
"6261";"360850208032";62;23;104;1;75;265
"6262";"360850208033";17;8;53;9;63;150
"6263";"360850208041";83;7;168;5;81;344
"6264";"360850208042";28;10;52;17;50;157
"6265";"360850208043";12;7;22;1;74;116
"6266";"360850213001";82;24;120;16;81;323
"6267";"360850213002";10;14;27;3;18;72
"6268";"360850213003";60;68;54;3;33;218
"6269";"360850213004";58;5;29;18;36;146
"6270";"360850213005";24;2;66;10;34;136
"6271";"360850223001";98;23;99;41;52;313
"6272";"360850223002";105;32;202;31;47;417
"6273";"360850226001";24;18;72;21;278;413
"6274";"360850226002";137;18;63;7;57;282
"6275";"360850226003";52;4;106;7;88;257
"6276";"360850226004";52;27;148;7;103;337
"6277";"360850228001";9;31;36;5;252;333
"6278";"360850231001";241;47;146;23;79;536
"6279";"360850231002";76;10;55;15;26;182
"6280";"360850239001";112;29;112;27;33;313
"6281";"360850239002";133;16;110;6;38;303
"6282";"360850244011";30;3;44;1;37;115
"6283";"360850244012";85;68;66;5;44;268
"6284";"360850244013";105;50;165;6;72;398
"6285";"360850244021";149;37;65;4;54;309
"6286";"360850244022";44;20;92;4;38;198
"6287";"360850247001";35;8;74;19;29;165
"6288";"360850247002";68;40;59;3;33;203
"6289";"360850248001";55;10;87;4;55;211
"6290";"360850248002";33;10;43;1;42;129
"6291";"360850248003";43;175;119;5;94;436
"6292";"360850251001";65;30;77;14;103;289
"6293";"360850251002";13;36;23;0;25;97
"6294";"360850251003";32;9;76;15;68;200
"6295";"360850273011";8;2;32;12;20;74
"6296";"360850273012";125;10;104;10;62;311
"6297";"360850273021";117;10;80;8;57;272
"6298";"360850273022";15;3;16;0;18;52
"6299";"360850277021";50;10;64;7;25;156
"6300";"360850277022";8;14;17;0;42;81
"6301";"360850277023";60;44;69;5;32;210
"6302";"360850277041";68;7;139;3;29;246
"6303";"360850277042";49;13;73;6;28;169
"6304";"360850277051";71;32;185;7;57;352
"6305";"360850277052";101;14;109;7;18;249
"6306";"360850277053";31;15;80;4;23;153
"6307";"360850277061";40;85;48;9;108;290
"6308";"360850277062";17;0;8;0;32;57
"6309";"360850277063";15;8;33;2;181;239
"6310";"360850279001";8;6;22;5;49;90
"6311";"360850279002";36;6;17;2;25;86
"6312";"360850291021";33;24;95;10;60;222
"6313";"360850291022";63;76;123;10;141;413
"6314";"360850291031";43;55;162;6;102;368
"6315";"360850291032";8;1;14;1;12;36
"6316";"360850291033";50;20;16;5;32;123
"6317";"360850291034";33;2;41;4;23;103
"6318";"360850291035";26;6;85;13;67;197
"6319";"360850291041";89;8;93;14;50;254
"6320";"360850291042";44;15;116;1;26;202
"6321";"360850291043";46;9;40;3;33;131
"6322";"360850291044";74;35;103;21;55;288
"6323";"360850303011";157;8;199;26;46;436
"6324";"360850303012";15;10;107;17;79;228
"6325";"360850303021";40;38;75;6;66;225
"6326";"360850303022";238;24;205;9;46;522
"6327";"360850303023";79;22;47;13;18;179
"6328";"360850303024";68;7;41;6;51;173
"6329";"360850319011";48;33;26;5;28;140
"6330";"360850319012";35;29;78;19;34;195
"6331";"360850319021";143;53;23;2;6;227
"6332";"360850319022";197;34;60;23;42;356
"6333";"360850319023";130;27;155;58;41;411
"6334";"360850323001";139;194;111;16;51;511
"6335";"361190002031";6;0;0;0;0;6
"6336";"361190013033";0;1;0;0;0;1
"6337";"361190015021";0;0;2;0;0;2
"6338";"361190015031";0;1;2;0;0;3
"6339";"361190015043";0;11;2;0;2;15
"6340";"361190026001";0;0;6;1;0;7
"6341";"361190026002";1;1;9;1;3;15
"6342";"361190026003";0;1;14;4;2;21
"6343";"361190029002";0;0;9;1;1;11
"6344";"361190030002";6;5;11;0;2;24
"6345";"361190055004";2;0;0;0;0;2
