"";"Data";"0";"1";"3";"4";"5";"sum"
"1";"360050001001";1;0;15;0;13;29
"2";"360050002001";167;56;312;99;31;665
"3";"360050002002";143;261;404;288;66;1162
"4";"360050002003";97;20;106;104;30;357
"5";"360050004001";12;32;101;43;23;211
"6";"360050004002";70;47;195;83;48;443
"7";"360050004003";40;66;147;56;28;337
"8";"360050004004";35;13;64;25;6;143
"9";"360050016001";45;6;20;1;9;81
"10";"360050016002";33;12;169;46;29;289
"11";"360050016003";12;2;9;1;5;29
"12";"360050016004";48;37;156;89;19;349
"13";"360050019001";165;178;265;50;65;723
"14";"360050019002";2;1;32;5;14;54
"15";"360050019003";41;355;278;55;58;787
"16";"360050019004";13;96;46;8;14;177
"17";"360050020001";86;41;139;57;17;340
"18";"360050020002";72;118;166;97;16;469
"19";"360050020003";222;27;12;3;7;271
"20";"360050020004";28;215;8;0;0;251
"21";"360050020005";149;0;9;6;0;164
"22";"360050020006";83;9;82;8;18;200
"23";"360050023001";102;18;10;1;7;138
"24";"360050023002";61;1;5;1;1;69
"25";"360050023003";96;6;8;3;4;117
"26";"360050024000";0;2;5;1;5;13
"27";"360050024001";55;35;8;0;4;102
"28";"360050025001";58;27;11;0;45;141
"29";"360050025002";60;23;1;2;7;93
"30";"360050025003";37;26;6;0;18;87
"31";"360050025004";97;99;8;1;11;216
"32";"360050025005";17;20;34;3;8;82
"33";"360050027011";163;61;34;7;3;268
"34";"360050027012";66;201;28;7;23;325
"35";"360050027021";69;22;20;3;3;117
"36";"360050027022";19;21;20;3;18;81
"37";"360050027023";43;66;30;2;56;197
"38";"360050027024";616;60;9;0;11;696
"39";"360050028000";0;0;2;0;0;2
"40";"360050028001";31;78;196;35;27;367
"41";"360050028002";56;66;26;1;5;154
"42";"360050028003";11;0;3;0;0;14
"43";"360050028004";34;82;39;1;6;162
"44";"360050031001";201;111;195;40;42;589
"45";"360050033001";142;8;72;57;17;296
"46";"360050033002";65;28;29;9;5;136
"47";"360050033003";108;80;34;12;9;243
"48";"360050035001";68;63;172;25;32;360
"49";"360050035002";158;19;9;2;10;198
"50";"360050035003";119;283;77;9;41;529
"51";"360050037001";34;43;19;2;14;112
"52";"360050038001";273;19;188;97;11;588
"53";"360050039001";83;49;15;2;24;173
"54";"360050039002";61;51;46;22;36;216
"55";"360050039003";29;25;47;8;50;159
"56";"360050039004";27;22;82;14;27;172
"57";"360050039005";65;39;45;5;25;179
"58";"360050040011";42;27;187;33;14;303
"59";"360050041001";170;12;27;12;11;232
"60";"360050041002";186;83;127;23;48;467
"61";"360050041003";0;0;3;0;3;6
"62";"360050041004";307;84;17;4;16;428
"63";"360050042001";334;4;0;0;1;339
"64";"360050042002";176;20;4;0;6;206
"65";"360050042003";20;5;88;7;13;133
"66";"360050042004";9;4;8;6;4;31
"67";"360050042005";36;14;64;8;29;151
"68";"360050042006";1;4;13;3;2;23
"69";"360050042007";1;1;4;1;0;7
"70";"360050043001";230;72;64;7;52;425
"71";"360050043002";47;47;118;12;55;279
"72";"360050043003";109;95;54;4;11;273
"73";"360050043004";208;75;57;3;6;349
"74";"360050044001";97;8;6;5;6;122
"75";"360050044002";39;7;1;0;2;49
"76";"360050044003";62;6;103;6;15;192
"77";"360050044004";93;4;39;5;9;150
"78";"360050046001";76;32;35;44;23;210
"79";"360050048001";144;132;60;3;28;367
"80";"360050048002";66;73;98;16;35;288
"81";"360050050011";62;33;261;20;45;421
"82";"360050050012";166;54;29;2;147;398
"83";"360050050013";154;139;95;2;23;413
"84";"360050050014";143;31;30;10;19;233
"85";"360050050021";137;140;87;7;40;411
"86";"360050050022";52;27;19;3;14;115
"87";"360050050023";36;27;13;3;35;114
"88";"360050050024";100;42;10;0;22;174
"89";"360050051001";46;25;109;28;74;282
"90";"360050051002";207;70;96;31;64;468
"91";"360050051003";162;26;16;0;15;219
"92";"360050052001";37;15;270;33;35;390
"93";"360050052002";149;39;10;1;7;206
"94";"360050053001";199;13;7;0;15;234
"95";"360050053002";1;1;3;1;1;7
"96";"360050054001";22;4;60;1;28;115
"97";"360050054002";66;39;247;7;62;421
"98";"360050054003";37;24;200;31;46;338
"99";"360050054004";46;20;18;1;22;107
"100";"360050056001";349;36;44;3;10;442
"101";"360050056002";4;0;31;2;2;39
"102";"360050056003";34;15;148;11;20;228
"103";"360050059021";44;13;34;2;25;118
"104";"360050059022";7;18;76;0;8;109
"105";"360050060001";135;98;98;18;17;366
"106";"360050061001";0;4;42;1;13;60
"107";"360050061002";586;17;25;3;6;637
"108";"360050061003";5;8;97;0;3;113
"109";"360050062001";407;56;124;2;14;603
"110";"360050062002";74;12;208;2;6;302
"111";"360050062003";177;66;41;7;18;309
"112";"360050062004";98;49;30;13;37;227
"113";"360050062005";5;7;7;3;1;23
"114";"360050063001";47;62;16;2;29;156
"115";"360050063002";73;124;154;49;116;516
"116";"360050063003";86;311;35;2;29;463
"117";"360050063004";143;194;3;1;5;346
"118";"360050063005";68;149;34;8;27;286
"119";"360050063006";365;335;190;10;91;991
"120";"360050064001";54;19;236;7;33;349
"121";"360050064002";26;7;16;0;9;58
"122";"360050064003";31;2;120;2;9;164
"123";"360050064004";43;11;67;6;20;147
"124";"360050065001";93;90;65;3;128;379
"125";"360050065002";124;29;63;14;18;248
"126";"360050065003";99;14;26;7;21;167
"127";"360050065004";13;25;29;8;125;200
"128";"360050067001";92;99;91;2;48;332
"129";"360050067002";100;64;43;2;44;253
"130";"360050067003";39;20;7;4;5;75
"131";"360050067004";49;30;10;11;2;102
"132";"360050067005";11;4;0;3;10;28
"133";"360050067006";30;89;81;8;15;223
"134";"360050068001";56;18;68;3;27;172
"135";"360050068002";17;14;44;1;16;92
"136";"360050068003";88;56;235;7;49;435
"137";"360050069001";53;27;80;13;17;190
"138";"360050069002";154;93;221;43;39;550
"139";"360050069003";5;7;4;0;0;16
"140";"360050069004";14;2;1;2;2;21
"141";"360050070001";73;15;197;15;50;350
"142";"360050070002";90;1885;82;11;42;2110
"143";"360050070003";437;590;97;0;37;1161
"144";"360050071001";17;16;55;3;9;100
"145";"360050071002";279;195;72;9;87;642
"146";"360050072001";70;38;116;9;25;258
"147";"360050072002";86;38;68;7;43;242
"148";"360050072003";49;8;114;23;32;226
"149";"360050072004";17;7;51;4;4;83
"150";"360050073001";121;77;96;11;39;344
"151";"360050073002";102;45;11;0;22;180
"152";"360050073003";93;37;45;5;21;201
"153";"360050074001";54;34;115;55;18;276
"154";"360050074002";63;31;43;30;20;187
"155";"360050074003";4;18;45;4;5;76
"156";"360050075001";93;76;115;4;19;307
"157";"360050075002";208;69;110;8;30;425
"158";"360050075003";296;1;10;0;11;318
"159";"360050075004";26;2;5;0;7;40
"160";"360050076001";26;11;15;0;8;60
"161";"360050076002";204;26;111;0;68;409
"162";"360050076003";21;15;67;1;15;119
"163";"360050076004";47;95;128;18;47;335
"164";"360050076005";39;20;143;9;44;255
"165";"360050077001";102;27;114;12;32;287
"166";"360050078001";78;70;133;7;37;325
"167";"360050078002";188;88;220;49;134;679
"168";"360050078003";32;10;25;2;13;82
"169";"360050078004";45;13;82;4;11;155
"170";"360050079001";117;46;38;6;40;247
"171";"360050079002";19;20;134;17;16;206
"172";"360050079003";46;12;12;0;5;75
"173";"360050079004";82;78;73;2;8;243
"174";"360050079005";33;20;10;1;0;64
"175";"360050079006";11;17;1;0;11;40
"176";"360050083001";26;72;25;6;9;138
"177";"360050083002";16;10;17;1;14;58
"178";"360050083003";40;21;70;6;11;148
"179";"360050083004";63;47;96;2;16;224
"180";"360050083005";145;92;32;4;10;283
"181";"360050083006";101;131;110;6;8;356
"182";"360050084001";36;5;90;51;10;192
"183";"360050084002";56;13;199;93;34;395
"184";"360050085001";85;213;61;3;17;379
"185";"360050085002";49;120;180;11;31;391
"186";"360050085003";30;32;29;5;6;102
"187";"360050085004";7;11;7;4;0;29
"188";"360050085005";66;12;3;3;3;87
"189";"360050086001";44;13;96;42;19;214
"190";"360050086002";79;12;3;1;6;101
"191";"360050086003";70;7;9;1;3;90
"192";"360050087001";101;50;12;1;30;194
"193";"360050087002";136;100;12;7;5;260
"194";"360050087003";74;27;58;1;5;165
"195";"360050087004";176;54;0;0;8;238
"196";"360050087005";67;45;9;1;16;138
"197";"360050089001";152;19;21;0;19;211
"198";"360050089002";17;27;56;3;13;116
"199";"360050090000";0;0;1;0;0;1
"200";"360050090001";2;56;63;18;7;146
"201";"360050090002";20;54;42;33;20;169
"202";"360050090003";54;17;3;4;6;84
"203";"360050090004";26;16;113;34;21;210
"204";"360050090005";114;9;8;0;2;133
"205";"360050092001";141;44;50;4;26;265
"206";"360050092002";73;26;177;7;18;301
"207";"360050092003";53;36;183;11;56;339
"208";"360050092004";42;21;47;4;35;149
"209";"360050092005";54;17;141;6;19;237
"210";"360050093001";9;6;164;48;55;282
"211";"360050093002";66;66;97;21;43;293
"212";"360050093003";107;65;31;2;29;234
"213";"360050093004";62;62;115;9;26;274
"214";"360050093005";41;109;207;42;44;443
"215";"360050093006";8;60;233;163;96;560
"216";"360050096001";151;25;177;31;25;409
"217";"360050096002";41;185;195;119;76;616
"218";"360050098001";74;57;130;31;34;326
"219";"360050098002";36;6;57;15;13;127
"220";"360050098003";65;8;71;19;11;174
"221";"360050098004";9;7;61;11;7;95
"222";"360050098005";69;10;18;5;16;118
"223";"360050110001";40;56;86;25;28;235
"224";"360050115021";173;116;403;60;57;809
"225";"360050115022";176;213;109;2;45;545
"226";"360050115023";37;62;160;4;13;276
"227";"360050117001";394;147;42;7;22;612
"228";"360050117002";1;33;59;84;28;205
"229";"360050118000";0;0;1;0;1;2
"230";"360050118001";25;15;95;33;45;213
"231";"360050118002";23;19;519;4;12;577
"232";"360050118003";54;46;209;75;28;412
"233";"360050119001";81;47;14;1;71;214
"234";"360050119002";48;29;38;2;7;124
"235";"360050119003";15;16;20;2;13;66
"236";"360050119004";24;14;4;0;12;54
"237";"360050119005";33;43;22;4;11;113
"238";"360050121011";279;31;148;12;18;488
"239";"360050121012";203;94;209;18;33;557
"240";"360050121021";118;100;32;6;57;313
"241";"360050123001";65;23;187;5;29;309
"242";"360050123002";193;20;152;19;23;407
"243";"360050123003";74;55;38;27;29;223
"244";"360050125001";72;113;170;29;62;446
"245";"360050125002";121;197;99;38;23;478
"246";"360050127011";10;19;19;11;35;94
"247";"360050127012";27;14;39;6;14;100
"248";"360050129011";71;86;84;6;58;305
"249";"360050129012";403;191;73;1;62;730
"250";"360050130001";27;11;216;24;33;311
"251";"360050131001";106;23;28;9;12;178
"252";"360050131002";99;33;216;59;31;438
"253";"360050131003";153;100;84;26;45;408
"254";"360050132001";59;13;195;69;17;353
"255";"360050132002";440;28;64;26;22;580
"256";"360050132003";39;19;145;44;18;265
"257";"360050132004";36;16;198;90;39;379
"258";"360050132005";46;21;113;73;12;265
"259";"360050133001";161;18;4;4;8;195
"260";"360050133002";99;81;84;1;18;283
"261";"360050133003";31;27;0;0;3;61
"262";"360050133004";125;45;6;0;0;176
"263";"360050135001";191;51;131;5;24;402
"264";"360050135002";40;17;6;3;3;69
"265";"360050135003";194;28;212;2;32;468
"266";"360050138001";29;57;61;46;24;217
"267";"360050138002";78;11;241;52;31;413
"268";"360050141001";115;168;58;19;21;381
"269";"360050141002";361;194;26;6;30;617
"270";"360050141003";177;98;111;18;42;446
"271";"360050143001";46;144;123;80;31;424
"272";"360050144001";2;3;2;0;0;7
"273";"360050144002";33;9;4;7;4;57
"274";"360050144003";36;3;4;1;0;44
"275";"360050144004";180;17;15;0;1;213
"276";"360050144005";106;14;122;31;20;293
"277";"360050144006";76;11;182;54;27;350
"278";"360050145001";126;23;42;6;21;218
"279";"360050145002";155;15;3;0;4;177
"280";"360050145003";15;20;22;1;14;72
"281";"360050145004";233;66;111;27;123;560
"282";"360050147011";76;11;11;4;5;107
"283";"360050147012";236;50;39;3;23;351
"284";"360050147013";869;21;24;1;126;1041
"285";"360050147021";431;131;7;0;1;570
"286";"360050147022";148;28;19;1;4;200
"287";"360050147023";96;6;8;3;3;116
"288";"360050147024";32;107;12;9;1;161
"289";"360050149001";98;79;107;11;10;305
"290";"360050149002";66;170;73;11;16;336
"291";"360050149003";133;390;58;15;38;634
"292";"360050151001";98;26;69;9;9;211
"293";"360050151002";73;130;41;4;18;266
"294";"360050151003";254;84;73;8;17;436
"295";"360050151004";239;106;191;5;33;574
"296";"360050152001";28;2;140;69;22;261
"297";"360050152002";57;25;120;47;65;314
"298";"360050153001";271;67;247;88;48;721
"299";"360050153002";24;284;24;37;29;398
"300";"360050153003";23;21;259;20;12;335
"301";"360050155001";150;160;34;2;21;367
"302";"360050155002";34;28;38;11;23;134
"303";"360050157001";215;136;165;8;12;536
"304";"360050157002";129;67;70;3;33;302
"305";"360050157003";164;34;156;10;28;392
"306";"360050158001";87;14;203;73;12;389
"307";"360050159001";90;47;42;14;34;227
"308";"360050159002";175;69;30;3;5;282
"309";"360050160001";54;34;202;44;24;358
"310";"360050160002";15;2;108;12;6;143
"311";"360050160003";13;5;110;24;7;159
"312";"360050160004";48;15;124;20;16;223
"313";"360050161001";152;194;63;17;27;453
"314";"360050161002";55;202;69;8;19;353
"315";"360050161003";58;15;20;2;9;104
"316";"360050161004";176;582;25;3;55;841
"317";"360050162001";9;2;58;11;18;98
"318";"360050162002";35;7;82;40;10;174
"319";"360050163001";26;55;34;4;12;131
"320";"360050164001";48;4;91;45;22;210
"321";"360050165001";136;24;166;57;43;426
"322";"360050166001";82;12;317;22;47;480
"323";"360050166002";22;1;49;33;14;119
"324";"360050167001";75;25;24;6;12;142
"325";"360050167002";116;45;51;82;48;342
"326";"360050169001";94;75;112;14;35;330
"327";"360050171001";203;168;39;9;20;439
"328";"360050173001";53;25;86;15;16;195
"329";"360050173002";39;13;70;5;32;159
"330";"360050173003";253;68;78;13;43;455
"331";"360050173004";87;121;34;0;11;253
"332";"360050175001";126;118;21;15;19;299
"333";"360050175002";167;37;9;0;6;219
"334";"360050175003";106;32;8;5;7;158
"335";"360050175004";274;77;21;4;21;397
"336";"360050175005";42;14;11;2;6;75
"337";"360050175006";107;2;1;1;4;115
"338";"360050177011";349;318;105;15;18;805
"339";"360050177012";48;13;4;3;14;82
"340";"360050177013";90;56;28;9;20;203
"341";"360050177021";60;16;41;1;11;129
"342";"360050177022";54;60;81;20;36;251
"343";"360050177023";88;104;112;3;23;330
"344";"360050177024";137;35;24;1;11;208
"345";"360050179011";91;345;40;14;20;510
"346";"360050179012";16;11;2;0;7;36
"347";"360050179013";81;75;20;0;18;194
"348";"360050179021";103;67;52;1;13;236
"349";"360050179022";366;84;12;0;11;473
"350";"360050179023";107;54;6;0;8;175
"351";"360050181011";217;126;202;7;29;581
"352";"360050181012";29;32;20;1;11;93
"353";"360050181013";64;41;43;2;6;156
"354";"360050181021";86;75;35;11;10;217
"355";"360050181022";89;63;13;1;6;172
"356";"360050181023";122;70;27;1;6;226
"357";"360050181024";184;14;18;0;9;225
"358";"360050183011";156;112;96;1;30;395
"359";"360050183012";70;114;23;2;13;222
"360";"360050183013";144;132;15;2;9;302
"361";"360050183021";227;88;55;3;18;391
"362";"360050183022";43;59;26;6;15;149
"363";"360050183023";41;24;66;0;6;137
"364";"360050184001";13;0;131;35;37;216
"365";"360050184002";28;8;249;82;80;447
"366";"360050184003";34;13;93;60;49;249
"367";"360050184004";30;41;146;44;22;283
"368";"360050185001";267;77;293;67;58;762
"369";"360050185002";49;13;81;11;25;179
"370";"360050185003";97;44;118;9;40;308
"371";"360050185004";85;18;17;1;7;128
"372";"360050185005";58;21;62;11;9;161
"373";"360050189001";84;44;37;20;31;216
"374";"360050189002";65;23;5;1;0;94
"375";"360050189003";1644;893;326;70;358;3291
"376";"360050189004";354;199;254;12;49;868
"377";"360050193001";637;108;27;4;19;795
"378";"360050193002";55;15;5;0;8;83
"379";"360050193003";17;8;15;1;2;43
"380";"360050193004";45;28;102;6;26;207
"381";"360050194001";85;78;272;71;36;542
"382";"360050195001";183;186;18;12;7;406
"383";"360050195002";186;128;46;7;118;485
"384";"360050195003";219;208;14;1;17;459
"385";"360050195004";123;151;34;3;26;337
"386";"360050197001";115;84;27;10;7;243
"387";"360050197002";108;125;14;12;15;274
"388";"360050197003";60;134;17;15;28;254
"389";"360050197004";15;14;4;1;16;50
"390";"360050197005";159;48;13;2;8;230
"391";"360050199001";81;104;5;3;16;209
"392";"360050199002";77;197;3;3;17;297
"393";"360050199003";31;81;34;4;4;154
"394";"360050199004";118;97;57;12;20;304
"395";"360050199005";46;229;20;2;10;307
"396";"360050199006";189;405;236;4;22;856
"397";"360050200001";97;54;181;21;79;432
"398";"360050200002";63;31;128;51;21;294
"399";"360050200003";130;7;202;16;72;427
"400";"360050200004";126;7;25;7;27;192
"401";"360050201001";122;220;52;25;10;429
"402";"360050201002";33;113;64;27;17;254
"403";"360050201003";150;98;45;37;32;362
"404";"360050202001";38;5;78;17;52;190
"405";"360050202002";222;18;200;13;43;496
"406";"360050204001";62;13;63;7;22;167
"407";"360050204002";12;11;177;24;17;241
"408";"360050204003";79;42;114;3;21;259
"409";"360050205011";80;605;18;6;10;719
"410";"360050205012";106;83;115;4;16;324
"411";"360050205013";122;78;98;11;10;319
"412";"360050205014";253;128;255;11;16;663
"413";"360050205021";79;117;111;10;13;330
"414";"360050205022";11;8;175;1;8;203
"415";"360050205023";18;13;104;8;12;155
"416";"360050206011";124;5;73;5;41;248
"417";"360050206012";22;10;233;19;45;329
"418";"360050209001";32;1035;46;16;12;1141
"419";"360050209002";155;310;23;13;23;524
"420";"360050209003";20;80;26;2;5;133
"421";"360050209004";336;96;17;4;17;470
"422";"360050210011";19;1;14;0;1;35
"423";"360050210012";29;6;2;1;6;44
"424";"360050210013";2;1;0;0;0;3
"425";"360050210014";12;2;2;1;2;19
"426";"360050210015";7;1;1;1;1;11
"427";"360050210016";4;1;2;0;3;10
"428";"360050210021";14;3;17;0;2;36
"429";"360050210022";73;14;19;0;0;106
"430";"360050210023";0;1;1;0;0;2
"431";"360050210025";28;0;1;2;0;31
"432";"360050210026";14;5;4;0;4;27
"433";"360050211001";206;31;121;10;20;388
"434";"360050211002";69;81;58;22;20;250
"435";"360050211003";67;85;57;4;10;223
"436";"360050211004";16;6;8;0;0;30
"437";"360050212001";3;2;2;0;0;7
"438";"360050212002";7;0;4;0;2;13
"439";"360050212004";33;1;16;0;1;51
"440";"360050212005";0;3;0;0;2;5
"441";"360050213011";6;7;24;1;2;40
"442";"360050213012";28;22;103;11;30;194
"443";"360050213021";135;121;161;88;18;523
"444";"360050213022";18;15;67;3;17;120
"445";"360050213023";6;7;58;5;8;84
"446";"360050213024";78;62;58;7;8;213
"447";"360050215011";27;33;47;17;29;153
"448";"360050215012";227;145;56;19;14;461
"449";"360050215013";139;83;86;0;13;321
"450";"360050215021";236;157;97;19;18;527
"451";"360050215022";220;28;81;17;14;360
"452";"360050215023";510;111;188;2;21;832
"453";"360050215024";154;34;67;0;15;270
"454";"360050215025";113;24;36;10;12;195
"455";"360050216011";76;22;253;9;25;385
"456";"360050216012";104;37;138;9;42;330
"457";"360050216013";58;7;19;10;7;101
"458";"360050216014";58;18;39;6;10;131
"459";"360050216021";11;4;60;2;16;93
"460";"360050216022";22;10;22;0;6;60
"461";"360050216023";16;1;9;1;7;34
"462";"360050216024";24;3;33;0;9;69
"463";"360050216025";10;20;71;14;15;130
"464";"360050217001";98;204;188;58;38;586
"465";"360050217002";352;80;28;9;19;488
"466";"360050217003";8;12;54;11;15;100
"467";"360050217004";63;133;61;9;23;289
"468";"360050218001";74;24;11;5;11;125
"469";"360050218002";134;41;75;6;14;270
"470";"360050218003";68;23;328;16;29;464
"471";"360050218004";44;9;80;23;35;191
"472";"360050218005";117;25;44;8;21;215
"473";"360050219001";179;790;224;49;58;1300
"474";"360050220001";130;31;147;26;57;391
"475";"360050221011";117;14;9;6;5;151
"476";"360050221012";34;71;21;10;31;167
"477";"360050221013";95;32;15;4;13;159
"478";"360050221021";78;292;128;14;47;559
"479";"360050221022";106;89;27;7;12;241
"480";"360050221023";115;74;31;5;16;241
"481";"360050222001";54;81;111;12;13;271
"482";"360050222002";21;3;35;3;29;91
"483";"360050222003";149;46;75;9;32;311
"484";"360050222004";23;4;39;10;47;123
"485";"360050223001";47;129;31;13;114;334
"486";"360050223002";163;116;8;1;13;301
"487";"360050223003";139;459;11;13;40;662
"488";"360050223004";95;122;8;1;15;241
"489";"360050224011";65;36;3;0;7;111
"490";"360050224012";268;54;102;10;39;473
"491";"360050224031";81;31;7;3;21;143
"492";"360050224032";499;88;38;3;61;689
"493";"360050224041";22;8;13;3;22;68
"494";"360050224042";124;44;23;4;20;215
"495";"360050224043";581;25;28;2;13;649
"496";"360050225001";326;578;33;6;31;974
"497";"360050225002";86;88;49;4;22;249
"498";"360050225003";52;53;11;11;15;142
"499";"360050225004";30;40;10;1;10;91
"500";"360050225005";68;30;4;1;5;108
"501";"360050225006";158;26;11;1;7;203
"502";"360050227011";173;64;37;4;29;307
"503";"360050227012";144;194;36;11;44;429
"504";"360050227013";61;63;93;28;38;283
"505";"360050227021";143;238;44;23;41;489
"506";"360050227031";97;192;43;0;14;346
"507";"360050228001";55;34;151;6;20;266
"508";"360050228002";103;19;57;1;11;191
"509";"360050228003";199;55;10;0;21;285
"510";"360050228004";141;5;7;0;7;160
"511";"360050229011";136;86;29;6;29;286
"512";"360050229012";96;80;39;11;9;235
"513";"360050229013";85;91;21;6;9;212
"514";"360050229014";83;173;90;10;13;369
"515";"360050229015";248;95;172;13;17;545
"516";"360050229021";66;133;52;4;13;268
"517";"360050229022";18;56;73;23;11;181
"518";"360050229023";138;225;23;14;11;411
"519";"360050230001";338;60;140;14;39;591
"520";"360050230002";216;12;213;1;33;475
"521";"360050231001";48;70;109;20;52;299
"522";"360050232001";97;25;182;11;16;331
"523";"360050232002";60;14;111;1;29;215
"524";"360050233011";110;45;38;9;31;233
"525";"360050233012";177;327;20;3;31;558
"526";"360050233013";22;22;106;16;20;186
"527";"360050233014";48;42;16;6;8;120
"528";"360050233021";492;114;31;12;46;695
"529";"360050233022";128;223;29;5;21;406
"530";"360050235011";159;70;41;12;46;328
"531";"360050235012";47;72;16;2;9;146
"532";"360050235013";617;250;7;0;3;877
"533";"360050235021";37;120;44;11;10;222
"534";"360050235022";14;29;12;9;10;74
"535";"360050235023";44;60;24;3;17;148
"536";"360050235024";175;88;21;1;19;304
"537";"360050236001";14;8;127;2;25;176
"538";"360050236002";33;11;42;2;29;117
"539";"360050237021";107;65;22;10;36;240
"540";"360050237031";108;130;66;9;94;407
"541";"360050237032";97;142;15;12;180;446
"542";"360050237033";134;133;18;4;10;299
"543";"360050237041";59;38;3;1;12;113
"544";"360050237042";167;115;131;2;24;439
"545";"360050237043";843;75;6;0;14;938
"546";"360050238001";2;11;67;13;22;115
"547";"360050238002";56;24;176;10;17;283
"548";"360050238003";45;24;131;16;48;264
"549";"360050239001";195;316;115;22;39;687
"550";"360050239002";129;125;27;8;69;358
"551";"360050239003";123;85;104;39;25;376
"552";"360050239004";336;208;44;11;50;649
"553";"360050239005";54;107;11;5;16;193
"554";"360050239006";76;35;11;4;8;134
"555";"360050240001";116;82;584;49;78;909
"556";"360050240002";45;14;83;8;20;170
"557";"360050240003";178;25;162;14;36;415
"558";"360050241001";47;135;16;2;53;253
"559";"360050241002";43;31;32;7;34;147
"560";"360050241003";60;30;81;4;18;193
"561";"360050241004";82;30;22;5;17;156
"562";"360050241005";82;153;15;2;22;274
"563";"360050243001";52;50;12;5;27;146
"564";"360050243002";35;7;136;15;12;205
"565";"360050243003";26;2;15;0;11;54
"566";"360050243004";140;42;115;5;23;325
"567";"360050244001";79;9;98;12;31;229
"568";"360050244002";47;10;180;71;45;353
"569";"360050245011";52;35;49;7;17;160
"570";"360050245012";105;135;159;11;32;442
"571";"360050245013";45;78;17;7;2;149
"572";"360050245014";113;213;42;3;10;381
"573";"360050245021";31;87;161;5;16;300
"574";"360050245022";34;11;2;0;12;59
"575";"360050245023";236;220;131;4;33;624
"576";"360050246001";330;9;325;29;35;728
"577";"360050246002";34;16;106;21;18;195
"578";"360050247001";0;1;6;0;0;7
"579";"360050247002";30;12;36;5;15;98
"580";"360050248001";18;7;109;27;15;176
"581";"360050248002";73;12;159;32;12;288
"582";"360050248003";15;9;132;9;14;179
"583";"360050249001";47;57;109;8;5;226
"584";"360050250001";205;5;197;46;22;475
"585";"360050250002";61;5;84;48;24;222
"586";"360050251001";218;100;53;6;19;396
"587";"360050251002";38;65;113;16;14;246
"588";"360050251003";47;219;118;4;46;434
"589";"360050251004";9;5;58;6;1;79
"590";"360050251005";210;23;109;10;19;371
"591";"360050251006";26;26;90;0;5;147
"592";"360050251007";8;5;16;1;4;34
"593";"360050252001";55;9;310;11;20;405
"594";"360050252002";51;18;284;99;62;514
"595";"360050253001";655;67;17;2;42;783
"596";"360050253002";72;31;110;0;10;223
"597";"360050253003";123;45;18;1;30;217
"598";"360050253004";406;98;21;1;21;547
"599";"360050254001";70;27;91;19;19;226
"600";"360050254002";37;15;184;49;19;304
"601";"360050255001";244;143;88;11;34;520
"602";"360050255002";411;332;68;7;20;838
"603";"360050255003";244;346;172;3;27;792
"604";"360050256001";111;21;116;109;37;394
"605";"360050256002";47;22;105;57;35;266
"606";"360050257001";293;47;233;28;9;610
"607";"360050261001";134;93;40;8;17;292
"608";"360050263001";261;309;28;4;46;648
"609";"360050263002";85;85;29;2;9;210
"610";"360050263003";324;283;62;3;10;682
"611";"360050263004";29;149;273;1;2;454
"612";"360050263005";72;122;30;1;11;236
"613";"360050264001";29;36;193;38;27;323
"614";"360050264002";37;7;204;31;21;300
"615";"360050264003";105;32;160;72;34;403
"616";"360050264004";28;8;172;23;28;259
"617";"360050265001";103;140;101;10;28;382
"618";"360050265002";356;107;59;29;25;576
"619";"360050265003";250;227;15;1;42;535
"620";"360050265004";44;154;84;10;16;308
"621";"360050266011";14;16;144;77;12;263
"622";"360050266012";47;4;41;6;8;106
"623";"360050266013";25;2;69;21;15;132
"624";"360050266021";34;23;92;28;8;185
"625";"360050266022";73;10;138;23;22;266
"626";"360050266023";40;16;450;27;15;548
"627";"360050266024";54;7;83;7;7;158
"628";"360050266025";51;7;166;63;16;303
"629";"360050267011";79;48;120;2;7;256
"630";"360050267012";155;127;18;3;10;313
"631";"360050267013";105;30;130;68;28;361
"632";"360050267021";212;97;177;14;41;541
"633";"360050267022";17;4;24;4;10;59
"634";"360050267023";160;30;221;3;11;425
"635";"360050267024";9;20;70;5;3;107
"636";"360050267025";67;16;21;0;26;130
"637";"360050267026";113;67;143;0;18;341
"638";"360050269001";135;319;268;30;28;780
"639";"360050269002";198;40;130;5;1;374
"640";"360050269003";37;24;32;0;7;100
"641";"360050273001";66;174;52;52;10;354
"642";"360050273002";280;118;151;7;17;573
"643";"360050273003";163;77;242;3;18;503
"644";"360050273004";187;375;262;25;27;876
"645";"360050274011";7;7;6;15;13;48
"646";"360050274012";5;4;125;41;26;201
"647";"360050274013";30;6;162;58;43;299
"648";"360050274014";64;8;178;101;36;387
"649";"360050274021";51;5;88;8;14;166
"650";"360050274022";2;10;53;38;24;127
"651";"360050274023";29;133;281;50;23;516
"652";"360050276001";44;17;108;24;36;229
"653";"360050277001";73;177;63;1;16;330
"654";"360050277002";48;41;88;11;10;198
"655";"360050277003";349;38;88;8;7;490
"656";"360050277004";303;141;22;0;9;475
"657";"360050279001";40;95;100;14;13;262
"658";"360050279002";67;21;129;4;28;249
"659";"360050279003";84;7;90;7;33;221
"660";"360050279004";94;33;151;8;19;305
"661";"360050279005";80;4;46;4;3;137
"662";"360050279006";377;27;136;0;11;551
"663";"360050281001";86;3;119;4;4;216
"664";"360050281002";56;3;52;8;4;123
"665";"360050281003";5;4;31;14;1;55
"666";"360050283001";161;49;62;4;44;320
"667";"360050283002";116;35;231;9;22;413
"668";"360050284001";45;6;122;73;36;282
"669";"360050285001";217;55;87;5;5;369
"670";"360050285002";24;15;22;1;7;69
"671";"360050285003";44;152;20;5;9;230
"672";"360050285004";105;11;254;22;19;411
"673";"360050286001";16;3;104;15;22;160
"674";"360050286002";30;50;108;39;29;256
"675";"360050287001";50;30;184;10;14;288
"676";"360050287002";142;26;71;3;5;247
"677";"360050287003";133;50;44;15;11;253
"678";"360050288001";41;7;88;25;10;171
"679";"360050288002";29;2;136;26;16;209
"680";"360050288003";9;1;49;2;2;63
"681";"360050288004";0;2;50;27;19;98
"682";"360050289001";216;41;273;14;39;583
"683";"360050289002";86;10;27;1;9;133
"684";"360050289003";32;41;229;9;37;348
"685";"360050289004";46;56;148;3;4;257
"686";"360050293011";1;3;11;1;4;20
"687";"360050293012";14;5;15;3;9;46
"688";"360050293021";41;5;39;1;3;89
"689";"360050293022";7;6;148;4;5;170
"690";"360050293023";120;5;35;9;3;172
"691";"360050293024";41;5;68;11;24;149
"692";"360050295001";96;35;155;1;11;298
"693";"360050295002";241;67;74;1;23;406
"694";"360050295003";256;19;141;4;10;430
"695";"360050295004";29;19;212;5;24;289
"696";"360050296001";345;86;229;129;29;818
"697";"360050296002";6;11;16;14;37;84
"698";"360050297001";18;16;41;2;12;89
"699";"360050297002";55;12;53;3;10;133
"700";"360050297003";14;12;33;3;2;64
"701";"360050300001";196;20;107;27;36;386
"702";"360050300002";50;17;175;108;55;405
"703";"360050300003";45;276;103;20;14;458
"704";"360050300004";74;22;62;23;25;206
"705";"360050300005";20;4;57;34;8;123
"706";"360050300006";23;7;238;27;12;307
"707";"360050301001";2;3;35;19;8;67
"708";"360050301002";1;0;17;0;1;19
"709";"360050302001";1;1;9;2;1;14
"710";"360050302002";6;0;5;1;1;13
"711";"360050302003";4;7;134;13;6;164
"712";"360050302004";1;0;4;0;3;8
"713";"360050302005";47;1;23;6;5;82
"714";"360050302006";0;0;2;1;0;3
"715";"360050307011";11;7;42;15;3;78
"716";"360050307012";55;3;34;10;7;109
"717";"360050307013";32;8;46;2;18;106
"718";"360050307014";0;7;16;0;5;28
"719";"360050309001";1;4;7;0;13;25
"720";"360050309002";1;16;15;1;16;49
"721";"360050309003";6;0;105;0;3;114
"722";"360050309004";45;63;173;1;8;290
"723";"360050310001";24;23;72;48;7;174
"724";"360050310002";37;14;49;53;30;183
"725";"360050310003";46;3;68;47;25;189
"726";"360050312001";8;3;42;36;22;111
"727";"360050312002";8;5;66;33;13;125
"728";"360050314001";22;4;66;19;16;127
"729";"360050314002";40;5;32;23;20;120
"730";"360050316001";66;44;235;61;17;423
"731";"360050316002";15;5;58;33;36;147
"732";"360050318001";17;5;107;28;21;178
"733";"360050318002";15;9;89;45;14;172
"734";"360050319001";0;1;0;0;0;1
"735";"360050323001";12;3;3;4;2;24
"736";"360050323002";18;22;12;12;7;71
"737";"360050323003";8;6;11;14;5;44
"738";"360050323004";163;8;108;41;13;333
"739";"360050324001";172;40;61;4;16;293
"740";"360050324002";72;48;170;70;30;390
"741";"360050326001";104;30;114;25;16;289
"742";"360050326002";16;7;82;45;37;187
"743";"360050326003";40;8;102;33;8;191
"744";"360050328001";75;28;72;24;26;225
"745";"360050328002";160;16;16;2;5;199
"746";"360050328003";60;8;99;2;12;181
"747";"360050328004";550;5;65;10;18;648
"748";"360050330001";112;8;102;22;27;271
"749";"360050330002";1208;31;101;26;9;1375
"750";"360050330003";111;23;45;6;22;207
"751";"360050330004";25;8;33;11;6;83
"752";"360050332011";64;11;13;6;13;107
"753";"360050332012";73;28;31;4;3;139
"754";"360050332013";84;13;36;5;2;140
"755";"360050332021";116;9;63;2;14;204
"756";"360050332022";64;12;47;4;15;142
"757";"360050332023";19;9;35;7;6;76
"758";"360050332024";38;1;26;9;3;77
"759";"360050334001";24;138;28;39;51;280
"760";"360050335001";0;0;4;3;3;10
"761";"360050335002";238;29;156;12;24;459
"762";"360050335003";46;40;73;0;3;162
"763";"360050336001";9;16;122;28;11;186
"764";"360050336002";89;60;9;5;30;193
"765";"360050336003";129;16;11;0;5;161
"766";"360050336004";45;12;5;2;3;67
"767";"360050336005";84;5;1;34;19;143
"768";"360050336006";97;13;50;0;58;218
"769";"360050337001";31;3;86;16;3;139
"770";"360050337002";38;5;113;80;10;246
"771";"360050337003";15;18;121;28;32;214
"772";"360050338001";49;13;51;4;17;134
"773";"360050338002";44;25;11;8;13;101
"774";"360050338003";52;6;184;8;10;260
"775";"360050338004";81;13;163;16;21;294
"776";"360050340001";60;6;217;7;32;322
"777";"360050340002";120;14;78;21;12;245
"778";"360050340003";96;27;38;9;8;178
"779";"360050340004";45;11;63;7;10;136
"780";"360050342001";6;1;58;14;9;88
"781";"360050342002";127;54;257;35;24;497
"782";"360050343001";11;11;113;21;10;166
"783";"360050343002";317;31;125;57;6;536
"784";"360050344001";29;5;59;8;4;105
"785";"360050344002";43;5;59;34;14;155
"786";"360050345001";59;11;137;57;11;275
"787";"360050345002";81;8;159;27;14;289
"788";"360050345003";17;3;118;2;6;146
"789";"360050348001";15;17;247;119;34;432
"790";"360050348002";319;96;11;8;14;448
"791";"360050348003";61;8;248;104;29;450
"792";"360050348004";16;3;124;71;16;230
"793";"360050350001";57;5;127;91;47;327
"794";"360050350002";46;9;61;60;18;194
"795";"360050351001";4;10;61;23;4;102
"796";"360050351002";127;8;146;83;6;370
"797";"360050351003";11;37;70;29;14;161
"798";"360050356001";3;4;47;31;7;92
"799";"360050356002";48;20;193;85;29;375
"800";"360050358001";34;11;118;88;22;273
"801";"360050358002";31;10;112;42;22;217
"802";"360050358003";59;9;111;48;17;244
"803";"360050358004";33;8;60;44;20;165
"804";"360050358005";17;3;37;23;6;86
"805";"360050358006";42;75;51;3;24;195
"806";"360050358007";28;23;86;32;35;204
"807";"360050359001";158;79;91;13;62;403
"808";"360050360001";16;3;59;21;17;116
"809";"360050360002";31;6;143;75;25;280
"810";"360050360003";8;2;61;31;6;108
"811";"360050361001";67;17;71;7;5;167
"812";"360050361002";140;24;142;5;10;321
"813";"360050361003";20;8;5;6;19;58
"814";"360050361004";36;7;2;0;2;47
"815";"360050361005";117;61;19;4;12;213
"816";"360050363001";92;37;20;3;12;164
"817";"360050363002";6;4;16;1;1;28
"818";"360050363003";81;60;43;7;51;242
"819";"360050363004";122;33;118;21;34;328
"820";"360050363005";58;35;16;2;29;140
"821";"360050363006";202;34;31;13;39;319
"822";"360050364001";13;30;98;24;29;194
"823";"360050364002";31;19;53;12;16;131
"824";"360050364003";21;12;60;10;20;123
"825";"360050365011";49;11;26;6;16;108
"826";"360050365012";130;35;52;21;18;256
"827";"360050365013";38;18;21;13;27;117
"828";"360050365021";92;49;29;12;17;199
"829";"360050365022";125;24;49;11;49;258
"830";"360050367001";160;32;84;34;21;331
"831";"360050367002";211;50;34;12;16;323
"832";"360050368001";65;14;85;13;21;198
"833";"360050368002";38;3;60;34;11;146
"834";"360050369011";198;111;27;6;52;394
"835";"360050369012";120;82;32;7;19;260
"836";"360050369021";94;7;6;0;16;123
"837";"360050369022";145;68;44;1;11;269
"838";"360050370001";13;7;92;25;8;145
"839";"360050370002";3;17;81;15;11;127
"840";"360050370003";12;6;29;7;12;66
"841";"360050371001";179;43;155;18;12;407
"842";"360050371002";71;14;48;25;60;218
"843";"360050371003";136;18;38;13;14;219
"844";"360050371004";48;59;45;17;18;187
"845";"360050372001";48;3;66;6;17;140
"846";"360050372002";131;47;139;18;13;348
"847";"360050373001";115;53;33;4;21;226
"848";"360050373002";115;100;153;9;30;407
"849";"360050373003";99;56;53;9;53;270
"850";"360050373004";208;67;51;13;21;360
"851";"360050374001";29;35;102;4;20;190
"852";"360050374002";269;52;103;20;61;505
"853";"360050374003";35;13;3;1;0;52
"854";"360050374004";12;1;0;0;0;13
"855";"360050375041";23;10;42;30;21;126
"856";"360050375042";244;113;35;21;13;426
"857";"360050375043";136;158;111;26;25;456
"858";"360050376001";321;5;38;44;11;419
"859";"360050376002";16;6;49;78;23;172
"860";"360050378001";150;18;156;21;41;386
"861";"360050378002";25;35;9;3;8;80
"862";"360050378003";40;45;62;9;40;196
"863";"360050379001";30;81;109;71;28;319
"864";"360050379002";30;2;9;4;6;51
"865";"360050379003";73;22;21;2;10;128
"866";"360050379004";120;40;43;1;15;219
"867";"360050379005";120;28;32;9;15;204
"868";"360050380001";16;22;23;9;9;79
"869";"360050380002";71;11;112;18;21;233
"870";"360050380003";212;53;87;30;38;420
"871";"360050380004";44;48;113;60;40;305
"872";"360050381001";78;23;3;1;6;111
"873";"360050381002";101;38;41;3;7;190
"874";"360050381003";228;55;32;5;5;325
"875";"360050381004";50;18;61;1;11;141
"876";"360050381005";68;19;91;6;21;205
"877";"360050381006";307;111;26;10;27;481
"878";"360050382001";34;10;137;42;24;247
"879";"360050382002";37;10;123;19;17;206
"880";"360050383011";102;64;47;6;16;235
"881";"360050383012";172;24;83;10;10;299
"882";"360050383013";101;134;41;6;20;302
"883";"360050383021";71;32;36;10;36;185
"884";"360050383022";136;109;53;6;4;308
"885";"360050383023";162;83;65;4;21;335
"886";"360050385001";137;96;60;35;39;367
"887";"360050385002";101;38;37;5;18;199
"888";"360050385003";37;69;46;8;19;179
"889";"360050385004";123;65;115;78;53;434
"890";"360050386001";53;5;141;32;29;260
"891";"360050386002";15;12;75;84;31;217
"892";"360050386003";62;119;17;3;16;217
"893";"360050386004";23;32;86;28;10;179
"894";"360050386005";40;17;56;22;12;147
"895";"360050386006";13;5;11;3;5;37
"896";"360050386007";11;3;15;6;5;40
"897";"360050386008";39;161;29;0;9;238
"898";"360050387001";471;41;37;15;88;652
"899";"360050387002";93;20;43;31;23;210
"900";"360050387003";68;18;6;5;18;115
"901";"360050388001";37;0;91;11;10;149
"902";"360050388002";29;8;220;8;10;275
"903";"360050389001";133;21;51;13;13;231
"904";"360050389002";55;9;12;6;24;106
"905";"360050389003";99;80;39;11;48;277
"906";"360050389004";48;34;31;1;11;125
"907";"360050389005";49;20;38;5;17;129
"908";"360050390001";37;21;304;15;22;399
"909";"360050390002";70;33;164;22;24;313
"910";"360050391001";354;48;68;7;31;508
"911";"360050391002";76;67;153;18;24;338
"912";"360050391003";67;13;494;5;17;596
"913";"360050391004";43;111;28;9;47;238
"914";"360050391005";16;10;5;3;19;53
"915";"360050391006";37;20;6;8;36;107
"916";"360050392001";28;6;94;4;11;143
"917";"360050392002";21;9;196;0;45;271
"918";"360050393001";279;88;104;10;15;496
"919";"360050393002";183;214;29;6;23;455
"920";"360050393003";96;12;6;2;4;120
"921";"360050393004";91;30;15;9;13;158
"922";"360050393005";19;1;11;5;8;44
"923";"360050393006";60;160;63;13;11;307
"924";"360050394001";104;9;8;3;26;150
"925";"360050394002";84;25;102;24;54;289
"926";"360050394003";8;8;6;3;12;37
"927";"360050394004";47;38;124;3;40;252
"928";"360050395001";47;34;157;71;31;340
"929";"360050395002";50;27;92;28;41;238
"930";"360050395003";56;19;173;54;23;325
"931";"360050395004";129;104;113;50;88;484
"932";"360050396001";139;8;129;20;23;319
"933";"360050396002";55;12;147;11;15;240
"934";"360050396003";86;21;117;64;43;331
"935";"360050396004";29;9;118;1;28;185
"936";"360050397001";17;68;61;25;71;242
"937";"360050397002";143;93;6;2;55;299
"938";"360050398001";81;45;82;20;13;241
"939";"360050398002";25;3;52;23;11;114
"940";"360050398003";22;144;31;10;12;219
"941";"360050399011";76;26;20;0;54;176
"942";"360050399012";39;15;16;0;12;82
"943";"360050399013";53;45;30;11;40;179
"944";"360050399014";41;12;2;2;22;79
"945";"360050399015";140;50;56;23;10;279
"946";"360050399021";45;80;33;3;58;219
"947";"360050399022";193;183;7;10;10;403
"948";"360050399023";239;111;24;10;15;399
"949";"360050399024";67;15;7;0;12;101
"950";"360050399025";49;22;30;4;2;107
"951";"360050401001";101;15;7;0;7;130
"952";"360050401002";210;101;39;10;40;400
"953";"360050401003";180;46;16;7;25;274
"954";"360050401004";33;14;1;0;6;54
"955";"360050401005";485;139;19;4;14;661
"956";"360050403021";674;109;9;8;27;827
"957";"360050403022";18;29;3;2;2;54
"958";"360050403023";89;21;13;0;3;126
"959";"360050403031";379;82;20;14;36;531
"960";"360050403032";264;81;190;12;17;564
"961";"360050403033";125;160;32;13;16;346
"962";"360050403041";108;136;20;2;21;287
"963";"360050403042";196;88;17;1;25;327
"964";"360050403043";102;27;40;0;23;192
"965";"360050404001";106;13;317;30;24;490
"966";"360050404002";22;22;64;22;7;137
"967";"360050404003";35;3;85;7;2;132
"968";"360050405011";309;113;21;19;47;509
"969";"360050405012";25;42;17;5;18;107
"970";"360050405013";73;19;35;3;20;150
"971";"360050405021";63;106;25;2;10;206
"972";"360050405022";154;80;23;0;8;265
"973";"360050405023";89;78;47;22;16;252
"974";"360050405024";25;15;21;8;9;78
"975";"360050405025";98;25;36;2;6;167
"976";"360050405026";56;13;163;43;18;293
"977";"360050406001";309;15;157;18;49;548
"978";"360050406002";138;51;123;6;31;349
"979";"360050406003";56;31;121;8;46;262
"980";"360050407011";120;80;11;2;9;222
"981";"360050407012";20;27;13;6;16;82
"982";"360050407013";156;38;12;2;10;218
"983";"360050407021";53;17;21;2;15;108
"984";"360050407022";224;187;87;22;14;534
"985";"360050407023";350;51;21;4;9;435
"986";"360050407024";135;30;36;7;22;230
"987";"360050407025";94;5;33;0;6;138
"988";"360050408001";55;3;55;4;5;122
"989";"360050408002";408;66;66;3;19;562
"990";"360050408003";100;13;38;8;8;167
"991";"360050408004";209;17;132;11;33;402
"992";"360050409001";82;198;250;23;38;591
"993";"360050409002";52;154;56;11;6;279
"994";"360050411001";115;57;57;3;15;247
"995";"360050411002";74;15;59;8;23;179
"996";"360050411003";249;18;73;11;30;381
"997";"360050413001";111;467;210;8;55;851
"998";"360050413002";69;21;8;9;4;111
"999";"360050413003";65;64;68;4;5;206
"1000";"360050413004";37;20;18;5;6;86
"1001";"360050413005";56;51;13;2;5;127
"1002";"360050413006";111;17;73;6;5;212
"1003";"360050413007";115;7;49;2;11;184
"1004";"360050414001";38;7;277;116;17;455
"1005";"360050414002";72;34;85;35;24;250
"1006";"360050414003";123;50;112;65;27;377
"1007";"360050414004";35;59;158;68;25;345
"1008";"360050415001";161;46;86;6;15;314
"1009";"360050415002";133;39;29;1;1;203
"1010";"360050415003";45;7;108;0;5;165
"1011";"360050415004";20;11;22;7;6;66
"1012";"360050415005";157;12;54;5;4;232
"1013";"360050415006";310;62;34;2;10;418
"1014";"360050418001";73;37;109;18;13;250
"1015";"360050418002";101;21;105;46;17;290
"1016";"360050418003";29;38;64;30;13;174
"1017";"360050418004";78;4;16;33;10;141
"1018";"360050419001";108;15;121;1;13;258
"1019";"360050419002";73;41;43;0;8;165
"1020";"360050419003";80;12;25;1;8;126
"1021";"360050419004";74;19;65;10;26;194
"1022";"360050419005";59;12;22;4;22;119
"1023";"360050419006";95;30;33;2;14;174
"1024";"360050419007";38;14;97;1;4;154
"1025";"360050420001";69;28;54;11;19;181
"1026";"360050420002";160;11;120;19;15;325
"1027";"360050420003";176;20;89;12;22;319
"1028";"360050421001";15;19;26;2;12;74
"1029";"360050421002";200;92;23;1;17;333
"1030";"360050421003";39;13;15;2;24;93
"1031";"360050421004";301;99;25;5;8;438
"1032";"360050421005";44;18;6;0;8;76
"1033";"360050422001";70;19;306;43;59;497
"1034";"360050422002";40;19;123;6;33;221
"1035";"360050423001";207;63;45;1;9;325
"1036";"360050423002";152;37;46;2;16;253
"1037";"360050423003";51;20;69;9;24;173
"1038";"360050424001";30;4;130;23;11;198
"1039";"360050424002";40;12;157;16;13;238
"1040";"360050425001";39;13;28;3;17;100
"1041";"360050425002";351;272;97;6;21;747
"1042";"360050425003";216;51;122;2;36;427
"1043";"360050425004";76;8;43;1;17;145
"1044";"360050425005";116;51;31;12;30;240
"1045";"360050425006";16;9;30;0;14;69
"1046";"360050425007";540;176;89;1;27;833
"1047";"360050426001";53;12;120;75;15;275
"1048";"360050426002";62;12;224;98;25;421
"1049";"360050426003";16;5;127;19;7;174
"1050";"360050426004";19;6;73;57;10;165
"1051";"360050426005";30;5;64;21;6;126
"1052";"360050426006";37;3;100;26;22;188
"1053";"360050428001";33;8;102;36;20;199
"1054";"360050428002";34;7;128;123;12;304
"1055";"360050429011";246;37;145;8;19;455
"1056";"360050429012";36;2;41;2;11;92
"1057";"360050429013";70;62;55;1;19;207
"1058";"360050429021";365;215;267;25;51;923
"1059";"360050429022";32;23;147;17;23;242
"1060";"360050429023";79;18;60;1;10;168
"1061";"360050430001";11;9;96;44;33;193
"1062";"360050430002";28;2;33;29;25;117
"1063";"360050430003";12;4;135;39;8;198
"1064";"360050431001";27;39;3;1;4;74
"1065";"360050431002";75;32;11;3;12;133
"1066";"360050431003";49;27;18;2;13;109
"1067";"360050431004";218;63;44;3;17;345
"1068";"360050431005";1011;160;58;14;53;1296
"1069";"360050431006";170;31;43;5;12;261
"1070";"360050431007";199;22;34;4;23;282
"1071";"360050431008";178;94;32;5;5;314
"1072";"360050434001";95;54;175;23;58;405
"1073";"360050434002";30;26;46;17;21;140
"1074";"360050434003";34;28;154;27;13;256
"1075";"360050434004";166;9;76;36;30;317
"1076";"360050435001";535;184;392;104;164;1379
"1077";"360050436001";61;11;49;48;28;197
"1078";"360050436002";34;21;197;33;12;297
"1079";"360050442001";746;61;29;10;12;858
"1080";"360050442002";36;5;82;32;12;167
"1081";"360050442003";25;13;86;70;6;200
"1082";"360050442004";115;2;103;140;22;382
"1083";"360050442005";24;28;52;47;6;157
"1084";"360050444001";40;14;105;44;16;219
"1085";"360050444002";15;4;51;61;16;147
"1086";"360050444003";79;9;138;49;11;286
"1087";"360050444004";36;2;217;55;38;348
"1088";"360050448001";25;15;65;61;15;181
"1089";"360050448002";4;1;63;40;12;120
"1090";"360050449011";13;2;65;9;12;101
"1091";"360050449012";3;1;172;25;11;212
"1092";"360050449021";47;11;182;37;16;293
"1093";"360050449022";34;2;180;26;14;256
"1094";"360050451011";12;7;364;20;10;413
"1095";"360050451012";15;8;131;111;23;288
"1096";"360050451021";11;7;151;42;9;220
"1097";"360050451022";34;3;276;34;3;350
"1098";"360050456001";29;8;81;34;9;161
"1099";"360050456002";35;23;141;116;69;384
"1100";"360050456003";8;6;17;26;13;70
"1101";"360050458001";58;8;5;7;2;80
"1102";"360050458002";192;9;7;0;5;213
"1103";"360050458003";11;1;0;0;0;12
"1104";"360050458004";454;28;6;4;18;510
"1105";"360050460001";70;12;112;58;11;263
"1106";"360050460002";14;4;53;59;13;143
"1107";"360050462011";24;17;57;20;26;144
"1108";"360050462012";1;14;3;0;0;18
"1109";"360050462013";9;5;34;4;4;56
"1110";"360050462014";17;3;48;5;2;75
"1111";"360050462015";13;0;6;2;2;23
"1112";"360050462016";20;3;7;0;1;31
"1113";"360050462017";2;1;82;0;0;85
"1114";"360050462018";17;6;34;5;4;66
"1115";"360050462019";4;0;16;3;3;26
"1116";"360050462021";153;23;311;129;46;662
"1117";"360050462022";82;10;220;104;22;438
"1118";"360050462023";47;11;311;78;21;468
"1119";"360050462024";12;6;44;45;7;114
"1120";"360050462025";10;21;110;53;15;209
"1121";"360050462026";5;9;31;46;4;95
"1122";"360050484001";36;5;53;20;4;118
"1123";"360050484002";80;38;311;221;28;678
"1124";"360050484003";8;7;36;18;10;79
"1125";"360050484004";24;7;91;37;13;172
"1126";"360050504001";5;10;1;4;12;32
"1127";"360050516000";0;1;2;0;0;3
"1128";"360050516001";25;70;149;40;37;321
"1129";"360050516002";17;26;99;33;9;184
"1130";"360050516003";34;65;173;40;19;331
"1131";"360050516004";30;126;228;52;24;460
"1132";"360470001001";16;86;127;6;22;257
"1133";"360470001002";8;22;21;7;23;81
"1134";"360470001003";30;84;53;10;9;186
"1135";"360470001004";13;52;22;2;16;105
"1136";"360470002001";23;39;300;70;104;536
"1137";"360470003011";5;9;22;2;3;41
"1138";"360470003012";4;9;18;0;1;32
"1139";"360470003013";8;18;27;6;11;70
"1140";"360470003014";1;4;13;0;18;36
"1141";"360470003015";13;22;17;0;8;60
"1142";"360470005011";43;44;96;9;28;220
"1143";"360470005012";16;9;15;0;8;48
"1144";"360470005013";12;35;26;0;22;95
"1145";"360470005021";33;21;39;2;18;113
"1146";"360470005022";19;35;66;11;29;160
"1147";"360470007001";21;19;84;4;32;160
"1148";"360470007002";19;4;76;4;10;113
"1149";"360470007003";23;20;60;2;17;122
"1150";"360470009001";52;183;119;28;83;465
"1151";"360470009002";58;36;75;20;12;201
"1152";"360470011001";11;123;293;8;119;554
"1153";"360470013001";18;80;431;12;35;576
"1154";"360470013002";1;0;33;3;3;40
"1155";"360470015001";118;112;247;22;25;524
"1156";"360470015002";397;61;40;2;19;519
"1157";"360470015003";82;294;331;18;77;802
"1158";"360470018001";27;33;400;85;125;670
"1159";"360470020001";7;19;148;13;41;228
"1160";"360470020002";17;11;149;4;34;215
"1161";"360470021001";21;353;910;3;39;1326
"1162";"360470021002";42;61;322;9;53;487
"1163";"360470021003";101;352;302;14;35;804
"1164";"360470022001";77;36;285;21;45;464
"1165";"360470022002";44;15;110;18;38;225
"1166";"360470022003";63;27;365;71;21;547
"1167";"360470023001";119;46;18;1;10;194
"1168";"360470023002";139;37;7;0;4;187
"1169";"360470023003";2118;40;71;8;12;2249
"1170";"360470029011";597;36;20;6;7;666
"1171";"360470029012";116;63;44;11;18;252
"1172";"360470030001";6;16;162;8;15;207
"1173";"360470030002";20;2;39;0;8;69
"1174";"360470031001";31;85;64;10;11;201
"1175";"360470031002";1;19;15;2;7;44
"1176";"360470031003";2;15;29;3;18;67
"1177";"360470033001";20;19;31;5;18;93
"1178";"360470033002";165;226;210;11;138;750
"1179";"360470034001";27;32;115;11;35;220
"1180";"360470034002";40;13;291;19;49;412
"1181";"360470034003";17;13;162;4;11;207
"1182";"360470035001";20;108;60;6;69;263
"1183";"360470035002";27;57;52;1;8;145
"1184";"360470036001";40;14;212;6;17;289
"1185";"360470036002";188;85;262;14;9;558
"1186";"360470036003";33;6;301;13;12;365
"1187";"360470037001";51;300;523;9;106;989
"1188";"360470038001";38;21;357;18;28;462
"1189";"360470039001";55;47;269;33;48;452
"1190";"360470039002";104;25;117;5;27;278
"1191";"360470039003";10;37;165;16;67;295
"1192";"360470041001";18;66;534;6;49;673
"1193";"360470041002";16;27;71;7;19;140
"1194";"360470041003";20;17;132;5;11;185
"1195";"360470043001";1;1;2;0;0;4
"1196";"360470043002";47;79;112;9;20;267
"1197";"360470043003";14;39;83;20;15;171
"1198";"360470043004";46;165;139;7;32;389
"1199";"360470044001";10;12;252;42;32;348
"1200";"360470044002";54;13;125;16;26;234
"1201";"360470045001";14;31;157;21;20;243
"1202";"360470045002";15;17;49;8;17;106
"1203";"360470045003";9;16;30;8;12;75
"1204";"360470045004";16;13;23;7;6;65
"1205";"360470046001";19;15;164;32;21;251
"1206";"360470047001";35;61;162;27;36;321
"1207";"360470049001";10;5;229;0;7;251
"1208";"360470049002";4;3;14;2;9;32
"1209";"360470049003";9;1;17;1;7;35
"1210";"360470050001";30;7;70;3;5;115
"1211";"360470050002";21;9;99;18;7;154
"1212";"360470050003";18;6;126;5;10;165
"1213";"360470051001";5;11;61;3;10;90
"1214";"360470051002";10;11;27;8;14;70
"1215";"360470051003";19;14;65;6;13;117
"1216";"360470052011";24;20;157;2;6;209
"1217";"360470052021";9;3;42;6;6;66
"1218";"360470052022";47;7;109;16;16;195
"1219";"360470053001";44;58;187;51;102;442
"1220";"360470053002";50;80;107;22;35;294
"1221";"360470053003";36;34;82;24;32;208
"1222";"360470053004";15;21;88;7;62;193
"1223";"360470054001";44;16;63;15;23;161
"1224";"360470054002";16;6;87;11;9;129
"1225";"360470054003";95;23;81;6;15;220
"1226";"360470056011";38;9;109;14;21;191
"1227";"360470056012";85;16;189;10;18;318
"1228";"360470056021";49;26;203;16;21;315
"1229";"360470058001";15;83;114;14;41;267
"1230";"360470058002";53;26;215;24;54;372
"1231";"360470058003";14;0;57;1;8;80
"1232";"360470059001";162;80;95;20;38;395
"1233";"360470059002";15;36;328;247;75;701
"1234";"360470060001";91;48;118;7;34;298
"1235";"360470060002";14;31;128;19;17;209
"1236";"360470060003";21;9;57;8;12;107
"1237";"360470062001";50;18;74;6;18;166
"1238";"360470062002";31;59;54;6;19;169
"1239";"360470062003";16;25;75;5;9;130
"1240";"360470063001";27;10;78;5;13;133
"1241";"360470063002";27;13;99;16;13;168
"1242";"360470064001";23;20;134;17;38;232
"1243";"360470064002";19;4;182;35;88;328
"1244";"360470064003";51;40;90;15;29;225
"1245";"360470065001";9;3;22;5;6;45
"1246";"360470065002";4;7;7;1;6;25
"1247";"360470065003";9;5;34;1;5;54
"1248";"360470065004";16;3;11;2;6;38
"1249";"360470065005";3;4;24;3;16;50
"1250";"360470065006";46;40;63;9;15;173
"1251";"360470065007";6;9;18;1;26;60
"1252";"360470066001";38;87;130;28;32;315
"1253";"360470066002";60;111;114;26;23;334
"1254";"360470066003";49;59;234;16;30;388
"1255";"360470067001";1;8;8;1;6;24
"1256";"360470067002";3;11;17;7;14;52
"1257";"360470067003";17;8;46;4;5;80
"1258";"360470067004";67;43;72;13;11;206
"1259";"360470067005";4;5;33;6;10;58
"1260";"360470068001";453;41;70;4;30;598
"1261";"360470068002";99;48;64;14;48;273
"1262";"360470068003";8;68;248;6;22;352
"1263";"360470068004";60;18;183;14;24;299
"1264";"360470069001";32;205;47;5;15;304
"1265";"360470069002";23;41;55;11;19;149
"1266";"360470069003";11;34;44;14;19;122
"1267";"360470069004";59;39;37;13;27;175
"1268";"360470070001";32;5;367;34;18;456
"1269";"360470070002";36;7;109;8;42;202
"1270";"360470071001";14;39;35;2;10;100
"1271";"360470071002";21;51;92;43;25;232
"1272";"360470071003";140;70;10;0;3;223
"1273";"360470071004";291;101;28;1;9;430
"1274";"360470072001";79;37;315;26;55;512
"1275";"360470074001";46;21;142;5;32;246
"1276";"360470074002";47;52;26;7;50;182
"1277";"360470074003";22;27;51;7;23;130
"1278";"360470074004";14;10;12;2;17;55
"1279";"360470075001";25;39;66;6;15;151
"1280";"360470075002";16;53;36;6;15;126
"1281";"360470075003";6;66;73;8;23;176
"1282";"360470075004";32;19;15;0;23;89
"1283";"360470075005";9;31;66;23;15;144
"1284";"360470076001";62;46;50;10;39;207
"1285";"360470076002";13;16;5;10;50;94
"1286";"360470076003";37;19;104;6;30;196
"1287";"360470077001";47;64;389;20;34;554
"1288";"360470077002";48;20;143;22;30;263
"1289";"360470077003";10;67;114;9;45;245
"1290";"360470077004";18;17;15;15;22;87
"1291";"360470078001";55;39;168;8;32;302
"1292";"360470078002";210;54;12;4;44;324
"1293";"360470078003";40;23;47;2;27;139
"1294";"360470078004";22;11;23;6;30;92
"1295";"360470080001";54;71;27;11;57;220
"1296";"360470080002";107;109;22;9;23;270
"1297";"360470080003";34;12;49;8;24;127
"1298";"360470082001";28;58;46;29;39;200
"1299";"360470082002";52;103;97;15;36;303
"1300";"360470082003";48;22;57;22;17;166
"1301";"360470084001";10;82;125;14;28;259
"1302";"360470084002";40;37;31;5;64;177
"1303";"360470084003";22;24;68;10;74;198
"1304";"360470085001";139;44;17;4;8;212
"1305";"360470085002";86;39;11;3;7;146
"1306";"360470085003";164;57;11;3;19;254
"1307";"360470086001";11;1083;18;2;12;1126
"1308";"360470088001";56;134;86;19;69;364
"1309";"360470088002";46;81;118;2;27;274
"1310";"360470090001";65;47;222;16;73;423
"1311";"360470090002";98;68;184;31;56;437
"1312";"360470092001";296;77;48;7;38;466
"1313";"360470092002";55;65;95;2;42;259
"1314";"360470092003";112;13;15;5;33;178
"1315";"360470094001";31;12;55;7;33;138
"1316";"360470094002";154;14;94;3;67;332
"1317";"360470094003";31;53;72;9;32;197
"1318";"360470096001";52;135;68;5;28;288
"1319";"360470096002";21;40;49;3;46;159
"1320";"360470096003";44;168;54;3;30;299
"1321";"360470096004";59;56;47;4;35;201
"1322";"360470098001";42;44;93;8;40;227
"1323";"360470098002";55;31;109;2;37;234
"1324";"360470098003";16;20;51;1;30;118
"1325";"360470098004";41;31;56;3;46;177
"1326";"360470100001";17;31;33;5;32;118
"1327";"360470100002";61;14;47;2;20;144
"1328";"360470100003";18;31;16;3;36;104
"1329";"360470100004";56;67;42;2;35;202
"1330";"360470101001";64;76;156;18;45;359
"1331";"360470101002";52;17;127;24;71;291
"1332";"360470101003";32;42;179;22;39;314
"1333";"360470102001";20;19;115;9;53;216
"1334";"360470102002";35;30;62;2;25;154
"1335";"360470102003";27;31;66;7;30;161
"1336";"360470104001";21;48;158;5;58;290
"1337";"360470104002";34;14;123;8;40;219
"1338";"360470104003";28;46;184;2;57;317
"1339";"360470106001";13;5;260;2;58;338
"1340";"360470106002";16;9;104;5;34;168
"1341";"360470106003";31;4;76;0;27;138
"1342";"360470108001";20;18;132;2;58;230
"1343";"360470108002";25;10;65;5;42;147
"1344";"360470108003";4;1;165;4;58;232
"1345";"360470110001";22;29;318;39;45;453
"1346";"360470110002";124;16;339;33;36;548
"1347";"360470112001";67;51;128;23;36;305
"1348";"360470112002";24;8;41;5;10;88
"1349";"360470112003";25;7;74;8;12;126
"1350";"360470112004";47;53;41;4;30;175
"1351";"360470114001";7;11;37;3;10;68
"1352";"360470114002";4;5;151;7;19;186
"1353";"360470114003";18;7;119;6;25;175
"1354";"360470116001";33;52;110;4;18;217
"1355";"360470116002";32;6;114;2;46;200
"1356";"360470116003";13;7;113;5;11;149
"1357";"360470117001";21;16;179;23;35;274
"1358";"360470117002";26;29;120;13;33;221
"1359";"360470117003";37;267;135;17;39;495
"1360";"360470118001";80;26;103;15;32;256
"1361";"360470118002";7;8;133;9;32;189
"1362";"360470119001";19;56;342;28;89;534
"1363";"360470119002";57;817;323;51;75;1323
"1364";"360470119003";17;50;197;19;76;359
"1365";"360470120001";47;21;402;68;65;603
"1366";"360470121001";55;56;229;28;61;429
"1367";"360470121002";26;47;143;36;42;294
"1368";"360470122001";96;108;84;6;69;363
"1369";"360470122002";73;133;124;2;36;368
"1370";"360470122003";48;48;246;9;40;391
"1371";"360470126001";55;19;174;7;24;279
"1372";"360470126002";13;23;96;6;31;169
"1373";"360470126003";17;4;126;12;5;164
"1374";"360470127001";93;159;97;8;47;404
"1375";"360470127002";321;221;120;34;28;724
"1376";"360470127003";61;29;8;3;13;114
"1377";"360470128011";20;84;205;8;30;347
"1378";"360470129011";69;36;119;7;32;263
"1379";"360470129012";38;100;54;12;41;245
"1380";"360470129013";36;5;103;6;24;174
"1381";"360470129021";15;60;73;5;23;176
"1382";"360470129022";23;322;169;11;30;555
"1383";"360470129023";12;24;48;2;23;109
"1384";"360470130001";18;18;83;8;20;147
"1385";"360470130002";39;15;122;16;24;216
"1386";"360470130003";15;14;169;11;35;244
"1387";"360470130004";32;34;111;5;24;206
"1388";"360470131001";242;141;30;1;17;431
"1389";"360470131002";22;40;52;1;20;135
"1390";"360470131003";20;63;36;5;23;147
"1391";"360470131004";93;67;47;6;26;239
"1392";"360470132001";11;3;37;5;8;64
"1393";"360470132002";24;6;111;13;36;190
"1394";"360470133001";23;58;39;16;24;160
"1395";"360470133002";18;23;40;4;20;105
"1396";"360470133003";12;55;90;5;16;178
"1397";"360470133004";41;4;54;2;13;114
"1398";"360470134001";32;7;811;53;27;930
"1399";"360470134002";82;14;111;8;16;231
"1400";"360470134003";53;6;288;17;40;404
"1401";"360470135001";11;26;69;11;8;125
"1402";"360470135002";24;50;99;14;53;240
"1403";"360470135003";18;36;114;7;27;202
"1404";"360470136001";20;8;173;8;61;270
"1405";"360470136002";17;8;78;4;34;141
"1406";"360470136003";19;28;104;5;18;174
"1407";"360470136004";33;12;188;8;35;276
"1408";"360470137001";8;115;36;2;24;185
"1409";"360470137002";36;20;79;3;14;152
"1410";"360470137003";17;41;284;23;92;457
"1411";"360470138001";27;27;87;6;27;174
"1412";"360470138002";28;9;37;1;25;100
"1413";"360470138003";20;20;58;3;22;123
"1414";"360470139001";5;13;87;1;20;126
"1415";"360470139002";65;43;61;3;21;193
"1416";"360470139003";10;12;31;5;23;81
"1417";"360470139004";8;12;37;5;42;104
"1418";"360470140001";7;2;188;6;21;224
"1419";"360470140002";7;16;129;15;28;195
"1420";"360470141001";13;18;101;5;31;168
"1421";"360470141002";10;12;115;2;34;173
"1422";"360470141003";82;40;136;4;36;298
"1423";"360470142001";72;13;138;7;20;250
"1424";"360470142002";25;38;111;4;32;210
"1425";"360470142003";73;20;69;4;57;223
"1426";"360470143001";64;87;107;12;68;338
"1427";"360470143002";24;53;106;10;50;243
"1428";"360470143003";29;45;80;6;30;190
"1429";"360470145001";42;213;115;18;47;435
"1430";"360470145002";107;32;103;6;44;292
"1431";"360470145003";41;32;94;16;29;212
"1432";"360470145004";66;21;59;15;37;198
"1433";"360470147001";12;75;90;4;8;189
"1434";"360470147002";34;23;117;8;14;196
"1435";"360470148001";12;1;56;1;6;76
"1436";"360470148002";12;1;66;2;21;102
"1437";"360470149001";16;16;28;5;19;84
"1438";"360470149002";19;32;71;22;31;175
"1439";"360470149003";2;13;46;7;14;82
"1440";"360470149004";11;17;65;7;20;120
"1441";"360470149005";16;26;58;11;12;123
"1442";"360470150001";6;1;37;3;22;69
"1443";"360470150002";10;1;139;22;5;177
"1444";"360470151001";4;5;37;2;19;67
"1445";"360470151002";9;8;21;2;17;57
"1446";"360470151003";56;15;56;5;62;194
"1447";"360470151004";2;10;17;4;20;53
"1448";"360470152001";4;3;74;17;7;105
"1449";"360470152002";9;2;36;4;6;57
"1450";"360470152003";10;7;156;9;11;193
"1451";"360470153001";5;12;34;1;20;72
"1452";"360470153002";12;20;53;10;39;134
"1453";"360470153003";8;68;26;6;27;135
"1454";"360470153004";3;73;83;1;15;175
"1455";"360470154001";5;27;57;19;24;132
"1456";"360470155001";15;29;55;12;8;119
"1457";"360470155002";18;15;38;5;14;90
"1458";"360470155003";36;14;97;8;13;168
"1459";"360470155004";6;19;45;9;20;99
"1460";"360470157001";11;19;94;4;11;139
"1461";"360470157002";7;15;32;14;10;78
"1462";"360470157003";13;17;76;14;18;138
"1463";"360470157004";19;18;25;22;10;94
"1464";"360470159001";18;37;145;14;43;257
"1465";"360470159002";15;12;57;16;5;105
"1466";"360470159003";4;27;37;18;16;102
"1467";"360470159004";34;19;69;4;9;135
"1468";"360470159005";14;23;42;10;20;109
"1469";"360470160001";20;11;78;14;17;140
"1470";"360470160002";20;41;111;21;17;210
"1471";"360470160003";36;14;102;9;26;187
"1472";"360470160004";104;90;124;21;96;435
"1473";"360470161001";83;65;572;12;24;756
"1474";"360470161002";22;49;35;7;6;119
"1475";"360470161003";85;139;148;23;66;461
"1476";"360470162001";35;2;59;8;28;132
"1477";"360470162002";4;16;143;14;29;206
"1478";"360470163001";16;54;211;12;25;318
"1479";"360470163002";27;33;63;7;29;159
"1480";"360470163003";33;17;113;7;9;179
"1481";"360470164001";0;1;12;3;6;22
"1482";"360470165001";10;17;53;9;11;100
"1483";"360470165002";23;4;44;5;11;87
"1484";"360470165003";31;19;86;5;10;151
"1485";"360470165004";25;12;140;4;11;192
"1486";"360470166001";10;15;77;27;11;140
"1487";"360470166002";3;7;70;16;24;120
"1488";"360470167001";7;9;152;10;13;191
"1489";"360470167002";13;10;73;9;7;112
"1490";"360470167003";17;14;60;7;11;109
"1491";"360470167004";16;19;168;17;44;264
"1492";"360470168001";58;11;772;18;19;878
"1493";"360470169001";8;12;29;2;18;69
"1494";"360470169002";19;20;25;0;17;81
"1495";"360470169003";12;54;50;2;19;137
"1496";"360470169004";22;15;42;3;11;93
"1497";"360470169005";9;10;84;4;13;120
"1498";"360470170001";8;11;57;13;13;102
"1499";"360470170002";21;12;321;17;29;400
"1500";"360470170003";29;10;118;7;11;175
"1501";"360470171001";17;11;55;41;11;135
"1502";"360470171002";1;13;23;3;6;46
"1503";"360470171003";4;14;23;0;5;46
"1504";"360470171004";5;1;46;7;6;65
"1505";"360470172001";17;11;215;15;32;290
"1506";"360470172002";18;6;109;6;23;162
"1507";"360470174001";28;13;247;14;12;314
"1508";"360470174002";3;1;156;2;14;176
"1509";"360470175001";5;4;45;8;8;70
"1510";"360470176001";0;3;194;23;10;230
"1511";"360470176002";34;6;251;17;53;361
"1512";"360470177001";70;231;161;58;129;649
"1513";"360470178001";62;45;54;22;61;244
"1514";"360470178002";61;38;344;15;33;491
"1515";"360470179001";8;3;20;0;3;34
"1516";"360470179002";55;105;237;17;14;428
"1517";"360470179003";11;6;48;3;8;76
"1518";"360470180001";20;3;117;17;36;193
"1519";"360470180002";21;3;130;8;22;184
"1520";"360470181001";21;21;32;8;16;98
"1521";"360470181002";5;3;32;9;15;64
"1522";"360470181003";61;62;71;9;26;229
"1523";"360470181004";23;33;62;3;10;131
"1524";"360470182001";9;13;73;6;45;146
"1525";"360470182002";36;15;214;19;23;307
"1526";"360470183001";20;90;148;9;32;299
"1527";"360470183002";259;468;29;23;23;802
"1528";"360470183003";22;44;52;7;11;136
"1529";"360470184001";4;3;171;3;6;187
"1530";"360470184002";29;8;222;5;21;285
"1531";"360470185011";18;34;24;1;14;91
"1532";"360470185012";54;27;50;4;2;137
"1533";"360470185013";77;35;9;0;8;129
"1534";"360470185014";32;5;14;4;4;59
"1535";"360470186001";7;9;137;5;24;182
"1536";"360470186002";45;8;122;6;16;197
"1537";"360470187001";41;54;161;5;53;314
"1538";"360470188001";28;5;249;10;17;309
"1539";"360470188002";18;4;230;4;21;277
"1540";"360470190001";55;8;157;20;32;272
"1541";"360470190002";165;14;159;18;47;403
"1542";"360470190003";39;37;316;13;27;432
"1543";"360470191001";133;146;113;17;64;473
"1544";"360470191002";29;30;46;4;21;130
"1545";"360470191003";31;181;114;17;33;376
"1546";"360470192001";4;0;74;28;34;140
"1547";"360470192002";10;18;289;68;62;447
"1548";"360470193001";84;76;81;24;28;293
"1549";"360470193002";116;44;89;5;11;265
"1550";"360470193003";4;7;33;6;7;57
"1551";"360470193004";24;49;22;1;17;113
"1552";"360470194001";52;12;158;29;27;278
"1553";"360470194002";49;14;229;20;27;339
"1554";"360470194003";22;7;121;77;18;245
"1555";"360470195001";16;24;48;2;14;104
"1556";"360470195002";33;36;70;2;11;152
"1557";"360470195003";16;19;43;25;2;105
"1558";"360470195004";22;16;49;19;15;121
"1559";"360470196001";66;8;124;10;29;237
"1560";"360470196002";4;9;174;11;26;224
"1561";"360470196003";29;4;210;10;37;290
"1562";"360470197001";0;7;77;0;4;88
"1563";"360470197002";47;25;50;6;21;149
"1564";"360470197003";24;20;73;8;11;136
"1565";"360470197004";17;66;45;8;13;149
"1566";"360470198001";14;8;60;13;18;113
"1567";"360470198002";17;4;119;9;65;214
"1568";"360470199001";37;104;50;3;8;202
"1569";"360470199002";107;171;23;8;15;324
"1570";"360470199003";69;362;147;12;39;629
"1571";"360470199004";48;16;49;2;5;120
"1572";"360470200001";55;23;89;9;22;198
"1573";"360470200002";14;7;253;24;44;342
"1574";"360470201001";20;39;21;2;16;98
"1575";"360470201002";48;39;112;12;28;239
"1576";"360470201003";47;61;71;6;25;210
"1577";"360470201004";40;19;34;10;4;107
"1578";"360470202001";10;2;100;6;34;152
"1579";"360470202002";2;2;188;5;48;245
"1580";"360470203001";72;462;748;34;41;1357
"1581";"360470203002";40;73;169;18;20;320
"1582";"360470204001";3;8;201;2;22;236
"1583";"360470204002";1;4;146;5;39;195
"1584";"360470205001";47;133;357;14;25;576
"1585";"360470205002";42;185;105;20;11;363
"1586";"360470205003";32;29;79;14;25;179
"1587";"360470206001";12;2;120;10;21;165
"1588";"360470206002";15;4;208;28;39;294
"1589";"360470207001";66;82;115;55;18;336
"1590";"360470207002";100;218;119;9;26;472
"1591";"360470207003";4;11;85;1;5;106
"1592";"360470208001";3;0;154;2;12;171
"1593";"360470208002";28;2;71;4;37;142
"1594";"360470208003";6;3;191;9;42;251
"1595";"360470210001";17;11;146;3;41;218
"1596";"360470210002";18;5;134;8;38;203
"1597";"360470210003";58;13;29;5;47;152
"1598";"360470211001";21;49;44;10;10;134
"1599";"360470211002";90;229;813;75;116;1323
"1600";"360470212001";20;6;103;31;32;192
"1601";"360470212002";75;13;95;7;38;228
"1602";"360470212003";10;8;111;7;25;161
"1603";"360470213001";46;94;21;3;12;176
"1604";"360470213002";149;84;37;12;11;293
"1605";"360470213003";67;24;35;8;17;151
"1606";"360470214001";11;6;91;26;13;147
"1607";"360470214002";11;93;99;25;18;246
"1608";"360470215001";91;240;137;13;10;491
"1609";"360470215002";154;124;45;12;27;362
"1610";"360470215003";103;68;44;3;18;236
"1611";"360470215004";54;82;72;10;38;256
"1612";"360470216001";1;4;69;6;7;87
"1613";"360470216002";8;3;82;2;5;100
"1614";"360470216003";13;9;107;10;39;178
"1615";"360470217001";150;48;65;33;30;326
"1616";"360470217002";371;284;60;11;43;769
"1617";"360470218001";20;10;46;10;30;116
"1618";"360470218002";6;2;14;3;5;30
"1619";"360470218003";7;32;197;8;13;257
"1620";"360470219001";64;38;24;1;21;148
"1621";"360470219002";46;13;67;2;11;139
"1622";"360470219003";51;65;106;5;27;254
"1623";"360470220001";2;3;13;9;4;31
"1624";"360470220002";24;8;51;2;21;106
"1625";"360470220003";7;2;73;7;4;93
"1626";"360470220004";12;10;55;17;18;112
"1627";"360470221001";28;45;44;4;45;166
"1628";"360470221002";309;231;143;8;45;736
"1629";"360470221003";107;72;37;15;17;248
"1630";"360470222001";34;4;46;0;2;86
"1631";"360470222002";16;7;54;14;18;109
"1632";"360470222003";20;84;84;6;42;236
"1633";"360470224001";0;1;57;0;17;75
"1634";"360470224002";17;2;32;2;9;62
"1635";"360470224003";68;12;64;6;9;159
"1636";"360470224004";16;25;263;19;20;343
"1637";"360470226001";17;32;218;68;42;377
"1638";"360470226002";57;22;131;28;27;265
"1639";"360470227001";189;72;37;18;63;379
"1640";"360470227002";53;80;71;21;59;284
"1641";"360470227003";107;149;95;36;44;431
"1642";"360470227004";189;119;118;15;73;514
"1643";"360470228001";22;23;143;27;24;239
"1644";"360470228002";2;14;105;18;16;155
"1645";"360470228003";1;4;57;20;19;101
"1646";"360470229001";80;65;64;10;29;248
"1647";"360470229002";45;17;43;8;29;142
"1648";"360470229003";38;13;46;4;19;120
"1649";"360470229004";68;62;49;11;41;231
"1650";"360470230001";0;4;31;11;10;56
"1651";"360470230002";3;1;28;2;5;39
"1652";"360470230003";24;8;91;36;31;190
"1653";"360470231001";93;76;43;3;20;235
"1654";"360470231002";91;97;127;17;68;400
"1655";"360470231003";97;98;21;2;17;235
"1656";"360470232001";2;2;159;11;16;190
"1657";"360470232002";55;2;31;13;6;107
"1658";"360470232003";3;5;20;4;12;44
"1659";"360470232004";1;1;27;5;9;43
"1660";"360470232005";41;14;42;7;15;119
"1661";"360470233001";65;111;63;10;23;272
"1662";"360470233002";2127;41;44;11;10;2233
"1663";"360470233003";137;109;140;17;65;468
"1664";"360470234001";2;6;43;14;6;71
"1665";"360470234002";18;5;27;16;7;73
"1666";"360470234003";9;8;55;9;8;89
"1667";"360470235001";203;286;252;51;82;874
"1668";"360470235002";27;24;92;16;38;197
"1669";"360470236001";2;1;33;4;7;47
"1670";"360470236002";33;27;30;4;0;94
"1671";"360470236003";4;4;31;11;9;59
"1672";"360470236004";4;6;44;0;3;57
"1673";"360470238001";4;1;69;12;5;91
"1674";"360470238002";13;8;38;4;7;70
"1675";"360470238003";6;19;36;8;6;75
"1676";"360470240001";39;1;32;1;7;80
"1677";"360470240002";7;3;121;28;14;173
"1678";"360470240003";2;3;28;8;6;47
"1679";"360470241001";177;249;487;27;124;1064
"1680";"360470241002";81;35;80;15;50;261
"1681";"360470242001";7;2;176;53;19;257
"1682";"360470242002";1;3;53;8;15;80
"1683";"360470243001";109;158;47;7;45;366
"1684";"360470243002";130;25;80;14;13;262
"1685";"360470243003";71;41;47;17;31;207
"1686";"360470244001";20;5;97;11;18;151
"1687";"360470244002";5;10;85;4;14;118
"1688";"360470244003";4;3;93;27;39;166
"1689";"360470245001";50;25;41;69;55;240
"1690";"360470245002";113;38;30;3;50;234
"1691";"360470245003";42;35;10;5;19;111
"1692";"360470245004";35;14;31;4;58;142
"1693";"360470246001";13;5;72;12;19;121
"1694";"360470246002";32;45;162;13;15;267
"1695";"360470246003";45;19;140;6;16;226
"1696";"360470247001";38;146;54;4;73;315
"1697";"360470247002";50;152;132;16;67;417
"1698";"360470248001";9;2;103;9;24;147
"1699";"360470248002";86;70;294;17;50;517
"1700";"360470249001";54;88;42;17;30;231
"1701";"360470249002";90;27;26;14;31;188
"1702";"360470249003";69;38;33;5;20;165
"1703";"360470249004";28;36;4;0;91;159
"1704";"360470250001";9;14;223;52;43;341
"1705";"360470250002";9;26;179;18;13;245
"1706";"360470251001";103;136;46;32;37;354
"1707";"360470251002";138;57;53;9;24;281
"1708";"360470251003";111;48;37;4;31;231
"1709";"360470252001";24;11;149;2;10;196
"1710";"360470252002";95;6;168;2;16;287
"1711";"360470252003";11;4;410;8;12;445
"1712";"360470252004";37;4;160;1;28;230
"1713";"360470253001";76;34;55;9;32;206
"1714";"360470253002";108;16;43;5;18;190
"1715";"360470253003";93;66;46;9;38;252
"1716";"360470254001";12;4;72;6;16;110
"1717";"360470254002";21;30;159;26;45;281
"1718";"360470254003";24;21;211;10;19;285
"1719";"360470255001";155;44;16;3;6;224
"1720";"360470255002";529;43;12;2;13;599
"1721";"360470256001";13;14;232;6;47;312
"1722";"360470256002";19;3;119;2;32;175
"1723";"360470257001";44;16;147;12;36;255
"1724";"360470257002";30;42;62;5;14;153
"1725";"360470257003";39;65;85;8;34;231
"1726";"360470258001";49;10;453;8;18;538
"1727";"360470258002";17;10;224;2;27;280
"1728";"360470258003";62;13;96;14;23;208
"1729";"360470259011";279;206;213;65;51;814
"1730";"360470259021";163;23;49;5;14;254
"1731";"360470260001";13;10;65;3;28;119
"1732";"360470260002";10;3;44;3;8;68
"1733";"360470260003";26;16;259;12;29;342
"1734";"360470261001";159;87;172;12;22;452
"1735";"360470261002";97;53;60;9;25;244
"1736";"360470261003";181;104;51;46;22;404
"1737";"360470261004";126;143;66;18;54;407
"1738";"360470261005";99;61;118;30;30;338
"1739";"360470262001";14;22;294;41;22;393
"1740";"360470262002";8;26;273;34;29;370
"1741";"360470263001";207;47;108;20;45;427
"1742";"360470264001";8;4;107;2;16;137
"1743";"360470264002";9;13;112;2;17;153
"1744";"360470264003";36;15;380;17;48;496
"1745";"360470264004";33;9;51;3;14;110
"1746";"360470265001";120;22;68;11;17;238
"1747";"360470265002";112;61;37;9;20;239
"1748";"360470265003";41;37;107;68;11;264
"1749";"360470265004";118;31;111;53;19;332
"1750";"360470266001";9;5;104;1;29;148
"1751";"360470266002";36;0;152;8;21;217
"1752";"360470266003";11;10;102;7;26;156
"1753";"360470267001";62;41;14;21;23;161
"1754";"360470267002";40;50;40;27;21;178
"1755";"360470267003";51;110;62;10;29;262
"1756";"360470267004";94;278;12;12;16;412
"1757";"360470268001";25;1;49;3;8;86
"1758";"360470268002";8;2;52;4;13;79
"1759";"360470268003";18;1;210;17;20;266
"1760";"360470268004";10;2;40;2;10;64
"1761";"360470269001";70;95;26;8;29;228
"1762";"360470269002";9;40;31;4;34;118
"1763";"360470269003";67;95;64;21;63;310
"1764";"360470270001";19;1;115;8;22;165
"1765";"360470270002";36;4;177;19;7;243
"1766";"360470271001";184;62;300;110;82;738
"1767";"360470271002";137;18;195;18;26;394
"1768";"360470272001";37;3;100;9;3;152
"1769";"360470272002";37;8;107;15;8;175
"1770";"360470272003";72;10;134;14;12;242
"1771";"360470273001";21;9;31;13;13;87
"1772";"360470273002";50;20;61;6;19;156
"1773";"360470273003";46;64;58;30;37;235
"1774";"360470274001";3;3;170;6;22;204
"1775";"360470274002";16;34;218;14;24;306
"1776";"360470275001";88;77;12;4;16;197
"1777";"360470275002";52;45;23;24;18;162
"1778";"360470275003";35;410;41;10;11;507
"1779";"360470275004";39;121;40;9;34;243
"1780";"360470276001";31;23;74;1;17;146
"1781";"360470276002";35;1;177;1;11;225
"1782";"360470276003";23;18;247;38;18;344
"1783";"360470277001";180;47;17;4;13;261
"1784";"360470277002";143;39;24;11;17;234
"1785";"360470277003";82;57;14;8;17;178
"1786";"360470277004";214;12;23;10;14;273
"1787";"360470278001";85;24;210;7;27;353
"1788";"360470278002";78;28;210;13;55;384
"1789";"360470279001";77;62;29;9;37;214
"1790";"360470279002";46;75;31;11;17;180
"1791";"360470279003";41;81;57;21;23;223
"1792";"360470279004";116;65;104;20;26;331
"1793";"360470280001";7;3;105;12;3;130
"1794";"360470280002";18;9;280;8;13;328
"1795";"360470281001";141;31;99;19;25;315
"1796";"360470281002";78;319;67;4;22;490
"1797";"360470281003";143;155;225;23;221;767
"1798";"360470282001";67;1;204;8;10;290
"1799";"360470282002";12;13;257;8;13;303
"1800";"360470282003";6;1;124;3;7;141
"1801";"360470283001";79;187;92;33;29;420
"1802";"360470283002";138;66;173;11;27;415
"1803";"360470283003";78;24;68;17;19;206
"1804";"360470284001";17;1;332;3;7;360
"1805";"360470284002";32;5;228;4;30;299
"1806";"360470284003";9;4;181;3;45;242
"1807";"360470285011";43;34;91;11;86;265
"1808";"360470285021";451;68;49;6;16;590
"1809";"360470286001";36;9;7;0;10;62
"1810";"360470286002";25;3;10;2;2;42
"1811";"360470286003";24;8;2;1;1;36
"1812";"360470286004";3;3;111;0;19;136
"1813";"360470286005";11;9;184;6;11;221
"1814";"360470287001";84;310;83;21;114;612
"1815";"360470287002";52;15;90;11;33;201
"1816";"360470287003";92;63;13;45;30;243
"1817";"360470288001";19;1;211;13;21;265
"1818";"360470288002";25;11;65;1;19;121
"1819";"360470288003";29;2;105;6;16;158
"1820";"360470289001";87;153;26;8;69;343
"1821";"360470289002";122;38;75;24;23;282
"1822";"360470289003";59;32;36;8;26;161
"1823";"360470289004";104;33;30;20;18;205
"1824";"360470290001";78;5;90;19;12;204
"1825";"360470290002";68;2;107;1;9;187
"1826";"360470290003";42;3;194;13;47;299
"1827";"360470291001";145;77;65;8;33;328
"1828";"360470291002";69;24;63;5;28;189
"1829";"360470291003";27;19;18;8;16;88
"1830";"360470292001";21;9;140;8;24;202
"1831";"360470292002";64;22;320;1;20;427
"1832";"360470293001";22;14;8;4;5;53
"1833";"360470293002";56;17;5;8;3;89
"1834";"360470293003";74;19;52;9;23;177
"1835";"360470293004";26;17;23;10;22;98
"1836";"360470294001";21;13;187;19;31;271
"1837";"360470295001";393;198;136;3;38;768
"1838";"360470295002";22;56;26;9;29;142
"1839";"360470295003";34;15;24;12;16;101
"1840";"360470295004";42;9;27;1;12;91
"1841";"360470296001";45;5;382;17;8;457
"1842";"360470296002";34;13;118;17;24;206
"1843";"360470296003";50;11;162;5;9;237
"1844";"360470296004";22;4;166;11;9;212
"1845";"360470297001";24;118;47;6;32;227
"1846";"360470297002";76;134;45;14;10;279
"1847";"360470297003";20;8;52;10;6;96
"1848";"360470298001";6;7;324;10;14;361
"1849";"360470298002";13;5;164;11;45;238
"1850";"360470298003";4;4;99;1;21;129
"1851";"360470299001";109;16;85;13;42;265
"1852";"360470299002";39;30;41;28;19;157
"1853";"360470300001";29;22;319;3;32;405
"1854";"360470300002";16;11;251;29;28;335
"1855";"360470301001";99;49;65;43;46;302
"1856";"360470301002";106;6;35;22;24;193
"1857";"360470301003";53;29;76;57;37;252
"1858";"360470302001";13;3;299;21;44;380
"1859";"360470302002";22;10;175;11;19;237
"1860";"360470302003";12;13;189;31;13;258
"1861";"360470303001";118;34;122;31;25;330
"1862";"360470303002";83;23;98;32;19;255
"1863";"360470303003";255;124;86;85;19;569
"1864";"360470304001";24;10;313;55;39;441
"1865";"360470304002";26;9;233;8;25;301
"1866";"360470304003";27;7;95;16;22;167
"1867";"360470305001";39;1473;739;105;161;2517
"1868";"360470305002";184;132;247;12;32;607
"1869";"360470305003";53;105;73;7;30;268
"1870";"360470305004";273;60;63;28;16;440
"1871";"360470306001";20;12;195;58;32;317
"1872";"360470307001";149;6;11;6;1;173
"1873";"360470307002";120;20;14;6;14;174
"1874";"360470307003";154;88;273;37;66;618
"1875";"360470308001";175;43;230;81;58;587
"1876";"360470309001";95;50;110;11;38;304
"1877";"360470309002";123;16;88;21;15;263
"1878";"360470311001";119;13;122;14;77;345
"1879";"360470311002";115;436;54;26;60;691
"1880";"360470311003";64;18;23;16;38;159
"1881";"360470313001";88;18;48;9;38;201
"1882";"360470313002";24;100;48;26;21;219
"1883";"360470313003";76;34;29;4;20;163
"1884";"360470313004";37;19;117;11;37;221
"1885";"360470314000";0;0;0;0;1;1
"1886";"360470314001";9;10;118;13;17;167
"1887";"360470314002";17;31;293;15;26;382
"1888";"360470314003";5;2;5;3;6;21
"1889";"360470314004";178;17;388;16;63;662
"1890";"360470315001";106;187;70;3;65;431
"1891";"360470315002";129;84;60;13;45;331
"1892";"360470315003";164;207;61;15;36;483
"1893";"360470315004";114;166;29;22;57;388
"1894";"360470317011";126;369;88;12;56;651
"1895";"360470317012";64;246;52;5;48;415
"1896";"360470317013";74;69;33;12;37;225
"1897";"360470317021";113;83;20;3;38;257
"1898";"360470317022";105;17;21;11;19;173
"1899";"360470317023";185;56;62;3;43;349
"1900";"360470319001";132;51;57;15;29;284
"1901";"360470319002";23;102;69;15;20;229
"1902";"360470319003";43;16;110;36;17;222
"1903";"360470321001";96;166;31;6;46;345
"1904";"360470321002";103;111;53;6;44;317
"1905";"360470321003";84;64;29;6;25;208
"1906";"360470321004";129;43;83;31;23;309
"1907";"360470323001";108;42;86;19;40;295
"1908";"360470323002";61;60;93;13;24;251
"1909";"360470323003";93;13;105;15;40;266
"1910";"360470325001";46;244;51;10;28;379
"1911";"360470325002";168;35;187;5;19;414
"1912";"360470325003";364;67;98;12;16;557
"1913";"360470326001";42;43;72;13;42;212
"1914";"360470326002";72;45;32;5;23;177
"1915";"360470326003";113;19;3;0;11;146
"1916";"360470326004";14;28;39;1;14;96
"1917";"360470326005";40;13;102;115;16;286
"1918";"360470327001";40;67;47;14;9;177
"1919";"360470327002";111;134;60;18;40;363
"1920";"360470327003";24;119;62;14;49;268
"1921";"360470328001";23;13;38;5;15;94
"1922";"360470328002";52;8;26;1;11;98
"1923";"360470328003";105;8;4;0;5;122
"1924";"360470328004";30;1;48;9;13;101
"1925";"360470329001";133;56;143;13;19;364
"1926";"360470329002";207;15;34;25;10;291
"1927";"360470329003";180;670;11;2;17;880
"1928";"360470329004";93;431;18;6;48;596
"1929";"360470330001";98;4;5;1;18;126
"1930";"360470330002";14;6;17;4;14;55
"1931";"360470330003";190;33;8;11;51;293
"1932";"360470331001";198;9;47;8;4;266
"1933";"360470331002";131;71;57;9;12;280
"1934";"360470331003";4;7;105;4;8;128
"1935";"360470333001";68;11;52;2;10;143
"1936";"360470333002";37;8;112;16;10;183
"1937";"360470333003";45;7;24;23;7;106
"1938";"360470335001";28;14;212;23;14;291
"1939";"360470335002";14;1;67;3;5;90
"1940";"360470335003";12;29;89;12;9;151
"1941";"360470336001";13;0;19;1;42;75
"1942";"360470336002";7;7;14;1;26;55
"1943";"360470336003";4;0;0;1;7;12
"1944";"360470336004";17;3;10;2;12;44
"1945";"360470336005";7;10;19;7;33;76
"1946";"360470337001";61;26;62;6;14;169
"1947";"360470337002";67;21;63;30;33;214
"1948";"360470337003";105;40;115;20;15;295
"1949";"360470339001";104;45;132;35;19;335
"1950";"360470339002";102;58;52;15;32;259
"1951";"360470339003";63;48;15;5;14;145
"1952";"360470339004";95;7;31;3;6;142
"1953";"360470340001";31;23;37;3;17;111
"1954";"360470340002";0;6;6;2;3;17
"1955";"360470341001";49;54;20;11;9;143
"1956";"360470341002";93;16;25;4;5;143
"1957";"360470341003";93;22;32;13;10;170
"1958";"360470342001";223;23;16;0;31;293
"1959";"360470342002";87;28;30;2;20;167
"1960";"360470342003";91;31;14;1;16;153
"1961";"360470342004";10;4;7;1;3;25
"1962";"360470343001";294;14;14;10;20;352
"1963";"360470343002";28;8;70;17;24;147
"1964";"360470343003";91;288;39;16;18;452
"1965";"360470345001";99;64;103;13;16;295
"1966";"360470345002";102;65;112;47;28;354
"1967";"360470347001";30;22;51;10;6;119
"1968";"360470347002";120;22;69;4;16;231
"1969";"360470347003";179;72;82;19;23;375
"1970";"360470348001";42;36;439;195;75;787
"1971";"360470348002";40;7;155;8;72;282
"1972";"360470349001";128;109;25;0;44;306
"1973";"360470349002";46;17;164;12;24;263
"1974";"360470349003";62;50;161;7;31;311
"1975";"360470349004";93;11;31;5;19;159
"1976";"360470350001";2;1;0;0;2;5
"1977";"360470350002";7;22;53;48;42;172
"1978";"360470351001";131;147;56;15;44;393
"1979";"360470351002";92;42;110;2;53;299
"1980";"360470351003";201;118;77;22;43;461
"1981";"360470352001";18;124;67;4;58;271
"1982";"360470353001";134;103;92;13;25;367
"1983";"360470353002";173;117;82;3;40;415
"1984";"360470353003";195;16;72;10;18;311
"1985";"360470354001";16;7;41;5;9;78
"1986";"360470354002";383;9;53;5;11;461
"1987";"360470354003";9;7;21;1;9;47
"1988";"360470355001";405;68;70;26;26;595
"1989";"360470355002";75;35;34;1;23;168
"1990";"360470355003";91;24;33;8;11;167
"1991";"360470356011";4;4;15;3;1;27
"1992";"360470356021";9;6;45;0;5;65
"1993";"360470356022";8;2;25;0;6;41
"1994";"360470356023";30;7;50;0;17;104
"1995";"360470357001";233;86;106;21;28;474
"1996";"360470359001";123;94;261;9;29;516
"1997";"360470359002";58;35;56;13;13;175
"1998";"360470359003";92;100;61;6;27;286
"1999";"360470359004";250;12;57;5;6;330
"2000";"360470360011";28;120;157;0;31;336
"2001";"360470360012";23;9;31;1;43;107
"2002";"360470360013";22;10;24;1;10;67
"2003";"360470360021";60;203;17;2;36;318
"2004";"360470360022";232;29;35;1;57;354
"2005";"360470361001";34;8;136;15;12;205
"2006";"360470361002";20;14;76;44;39;193
"2007";"360470361003";69;30;21;30;6;156
"2008";"360470362001";62;18;182;12;62;336
"2009";"360470362002";50;5;169;5;61;290
"2010";"360470362003";41;7;118;3;19;188
"2011";"360470363001";67;26;34;13;23;163
"2012";"360470363002";402;47;118;44;23;634
"2013";"360470363003";89;13;97;27;22;248
"2014";"360470363004";60;10;41;27;8;146
"2015";"360470364001";44;21;226;2;37;330
"2016";"360470364002";25;5;273;6;19;328
"2017";"360470365011";21;3;444;10;7;485
"2018";"360470365012";93;18;297;52;30;490
"2019";"360470365021";56;72;182;147;63;520
"2020";"360470366001";28;15;99;8;23;173
"2021";"360470366002";151;28;77;6;24;286
"2022";"360470366003";38;3;52;3;16;112
"2023";"360470367001";130;126;285;219;40;800
"2024";"360470367002";14;15;48;99;15;191
"2025";"360470369001";85;17;48;78;45;273
"2026";"360470369002";46;27;53;32;71;229
"2027";"360470369003";88;105;70;35;32;330
"2028";"360470369004";86;19;275;29;58;467
"2029";"360470370001";16;17;122;37;22;214
"2030";"360470370002";7;7;60;24;9;107
"2031";"360470370003";9;7;203;15;31;265
"2032";"360470370004";8;0;53;9;14;84
"2033";"360470371001";37;51;91;14;29;222
"2034";"360470371002";49;31;44;25;8;157
"2035";"360470371003";15;9;140;2;16;182
"2036";"360470371004";23;25;159;8;29;244
"2037";"360470371005";10;15;43;13;26;107
"2038";"360470373001";43;46;37;14;50;190
"2039";"360470373002";37;9;105;18;20;189
"2040";"360470373003";146;182;39;7;23;397
"2041";"360470373004";111;229;46;24;22;432
"2042";"360470374011";29;7;213;23;18;290
"2043";"360470374012";39;6;220;8;15;288
"2044";"360470374013";59;7;168;28;8;270
"2045";"360470374021";17;5;1112;44;10;1188
"2046";"360470374022";39;36;61;11;4;151
"2047";"360470374023";26;6;24;0;3;59
"2048";"360470374024";11;11;110;8;14;154
"2049";"360470375001";59;40;19;17;14;149
"2050";"360470375002";260;134;103;20;47;564
"2051";"360470375003";88;94;17;5;46;250
"2052";"360470377001";51;304;34;9;13;411
"2053";"360470377002";101;93;32;23;37;286
"2054";"360470377003";114;78;48;3;27;270
"2055";"360470377004";44;28;40;15;39;166
"2056";"360470379001";49;31;28;2;26;136
"2057";"360470379002";123;47;168;29;36;403
"2058";"360470379003";78;24;90;33;33;258
"2059";"360470381001";101;25;61;8;23;218
"2060";"360470381002";140;37;17;14;25;233
"2061";"360470381003";60;53;48;23;42;226
"2062";"360470381004";64;92;20;17;24;217
"2063";"360470382001";9;11;141;3;11;175
"2064";"360470382002";95;20;127;9;6;257
"2065";"360470382003";25;9;12;6;4;56
"2066";"360470383001";132;36;136;10;37;351
"2067";"360470383002";121;190;32;29;32;404
"2068";"360470383003";23;35;58;10;38;164
"2069";"360470383004";39;8;10;6;18;81
"2070";"360470385001";60;29;79;10;33;211
"2071";"360470385002";91;18;43;21;16;189
"2072";"360470385003";79;63;63;13;30;248
"2073";"360470385004";23;24;92;8;15;162
"2074";"360470386001";70;9;343;116;53;591
"2075";"360470386002";60;20;148;42;53;323
"2076";"360470387001";71;185;84;15;68;423
"2077";"360470387002";13;15;80;13;12;133
"2078";"360470387003";34;16;57;19;27;153
"2079";"360470387004";54;50;89;9;33;235
"2080";"360470388001";149;3;77;2;4;235
"2081";"360470388002";11;1;84;3;4;103
"2082";"360470388003";7;16;282;15;9;329
"2083";"360470388004";3;1;56;14;9;83
"2084";"360470389001";157;76;66;22;83;404
"2085";"360470389002";284;242;72;14;65;677
"2086";"360470389003";80;158;44;3;118;403
"2087";"360470390001";17;3;178;19;19;236
"2088";"360470390002";2;0;93;19;9;123
"2089";"360470391001";79;90;82;5;48;304
"2090";"360470391002";489;76;154;13;90;822
"2091";"360470392001";26;4;141;29;21;221
"2092";"360470392002";24;7;67;28;12;138
"2093";"360470393001";142;66;99;25;41;373
"2094";"360470393002";113;89;78;5;131;416
"2095";"360470393003";375;125;100;12;84;696
"2096";"360470394001";12;86;94;12;18;222
"2097";"360470394002";10;4;44;1;11;70
"2098";"360470394003";5;3;75;16;9;108
"2099";"360470395001";144;516;182;4;40;886
"2100";"360470395002";64;94;57;27;67;309
"2101";"360470395003";86;78;86;17;45;312
"2102";"360470396001";2;8;68;11;5;94
"2103";"360470396002";16;2;62;31;19;130
"2104";"360470397001";259;85;120;19;54;537
"2105";"360470397002";136;95;102;13;30;376
"2106";"360470397003";84;94;76;2;72;328
"2107";"360470398001";27;11;405;123;75;641
"2108";"360470398002";16;16;126;59;21;238
"2109";"360470399001";341;59;144;19;31;594
"2110";"360470399002";166;59;57;38;23;343
"2111";"360470399003";42;29;31;22;22;146
"2112";"360470400001";16;12;155;46;74;303
"2113";"360470400002";14;0;96;3;16;129
"2114";"360470400003";13;33;207;24;33;310
"2115";"360470401001";32;18;60;13;14;137
"2116";"360470401002";119;100;146;23;42;430
"2117";"360470401003";177;48;227;11;53;516
"2118";"360470402001";21;33;222;20;25;321
"2119";"360470402002";69;74;275;17;58;493
"2120";"360470403001";101;45;106;69;45;366
"2121";"360470403002";78;21;117;18;45;279
"2122";"360470403003";52;31;59;26;24;192
"2123";"360470404001";12;3;258;7;22;302
"2124";"360470404002";4;11;166;18;37;236
"2125";"360470405001";53;33;134;204;54;478
"2126";"360470405002";24;33;26;31;17;131
"2127";"360470406001";29;3;294;19;12;357
"2128";"360470406002";33;4;184;4;9;234
"2129";"360470406003";25;4;134;11;14;188
"2130";"360470407001";0;1;3;9;1;14
"2131";"360470408001";6;40;47;2;21;116
"2132";"360470408002";32;12;215;10;12;281
"2133";"360470408003";23;9;144;16;17;209
"2134";"360470409001";117;80;117;33;51;398
"2135";"360470409002";101;111;65;12;28;317
"2136";"360470409003";39;27;75;17;28;186
"2137";"360470410001";37;205;509;15;37;803
"2138";"360470410002";8;2;141;11;14;176
"2139";"360470411001";84;74;111;4;28;301
"2140";"360470411002";138;28;125;6;23;320
"2141";"360470411003";84;26;34;6;15;165
"2142";"360470412001";20;9;232;18;44;323
"2143";"360470412002";28;24;720;32;25;829
"2144";"360470413001";173;37;96;34;18;358
"2145";"360470413002";138;36;98;7;18;297
"2146";"360470413003";95;36;178;27;20;356
"2147";"360470414011";14;12;94;6;13;139
"2148";"360470414012";6;5;93;9;10;123
"2149";"360470414021";60;9;17;7;11;104
"2150";"360470414022";7;2;41;14;11;75
"2151";"360470415001";111;163;101;5;22;402
"2152";"360470415002";188;135;110;28;24;485
"2153";"360470415003";40;17;62;26;8;153
"2154";"360470416001";74;2;161;4;20;261
"2155";"360470416002";25;1;50;6;17;99
"2156";"360470417001";57;47;35;9;6;154
"2157";"360470417002";32;24;21;15;7;99
"2158";"360470417003";123;78;51;10;30;292
"2159";"360470417004";62;160;34;15;27;298
"2160";"360470418001";22;15;92;5;24;158
"2161";"360470418002";27;5;41;1;7;81
"2162";"360470419001";148;121;238;42;43;592
"2163";"360470419002";147;161;76;18;12;414
"2164";"360470419003";60;13;31;15;13;132
"2165";"360470420001";5;20;90;13;12;140
"2166";"360470420002";4;8;51;12;17;92
"2167";"360470421001";85;43;115;21;30;294
"2168";"360470421002";90;70;91;18;37;306
"2169";"360470421003";83;53;119;33;70;358
"2170";"360470421004";131;89;223;35;77;555
"2171";"360470422001";93;5;123;9;15;245
"2172";"360470422002";6;8;186;33;24;257
"2173";"360470422003";72;4;70;6;20;172
"2174";"360470423001";131;112;99;8;80;430
"2175";"360470423002";175;171;215;11;70;642
"2176";"360470423003";98;61;66;24;30;279
"2177";"360470424001";14;10;166;13;23;226
"2178";"360470424002";63;33;248;10;30;384
"2179";"360470424003";26;12;114;12;22;186
"2180";"360470425001";67;133;49;6;26;281
"2181";"360470425002";89;102;257;4;48;500
"2182";"360470425003";118;299;94;28;31;570
"2183";"360470426001";33;5;184;5;11;238
"2184";"360470426002";10;43;358;22;53;486
"2185";"360470426003";2;4;120;24;17;167
"2186";"360470427001";172;360;45;6;61;644
"2187";"360470427002";168;187;71;5;100;531
"2188";"360470427003";375;240;61;19;44;739
"2189";"360470427004";73;55;82;9;35;254
"2190";"360470428001";14;11;267;14;20;326
"2191";"360470428002";49;21;332;21;28;451
"2192";"360470428003";103;39;140;8;10;300
"2193";"360470429001";191;163;77;1;117;549
"2194";"360470429002";167;90;31;6;66;360
"2195";"360470429003";143;178;25;15;85;446
"2196";"360470429004";437;607;62;7;67;1180
"2197";"360470430001";13;6;136;4;15;174
"2198";"360470430002";42;14;1078;25;9;1168
"2199";"360470430003";43;16;328;10;84;481
"2200";"360470431001";86;86;132;10;77;391
"2201";"360470431002";177;154;47;7;67;452
"2202";"360470431003";115;142;27;20;63;367
"2203";"360470431004";428;572;67;16;84;1167
"2204";"360470432001";23;11;861;19;32;946
"2205";"360470432002";39;43;182;16;51;331
"2206";"360470432003";20;45;337;15;34;451
"2207";"360470433001";46;88;29;7;12;182
"2208";"360470433002";74;54;45;3;86;262
"2209";"360470433003";145;105;31;8;60;349
"2210";"360470434001";47;3;213;13;35;311
"2211";"360470434002";21;2;247;10;21;301
"2212";"360470434003";59;19;577;5;31;691
"2213";"360470435001";144;224;42;4;28;442
"2214";"360470435002";159;203;57;10;36;465
"2215";"360470435003";102;89;46;16;24;277
"2216";"360470436001";54;6;336;13;10;419
"2217";"360470436002";6;7;86;1;33;133
"2218";"360470436003";40;4;121;4;19;188
"2219";"360470437001";79;97;66;2;17;261
"2220";"360470437002";174;140;52;5;24;395
"2221";"360470437003";219;101;64;9;37;430
"2222";"360470437004";141;320;48;12;29;550
"2223";"360470438001";29;9;112;10;19;179
"2224";"360470438002";21;15;239;29;69;373
"2225";"360470439001";184;199;142;14;67;606
"2226";"360470439002";90;29;158;6;41;324
"2227";"360470439003";110;135;508;6;94;853
"2228";"360470440001";24;2;106;7;11;150
"2229";"360470440002";12;6;204;13;6;241
"2230";"360470440003";68;8;305;27;44;452
"2231";"360470441001";132;201;115;11;124;583
"2232";"360470441002";115;73;115;12;73;388
"2233";"360470441003";135;151;72;1;34;393
"2234";"360470442001";28;27;122;93;15;285
"2235";"360470442002";16;1;116;14;3;150
"2236";"360470443001";30;11;32;9;14;96
"2237";"360470443002";132;46;113;3;80;374
"2238";"360470443003";87;87;53;4;64;295
"2239";"360470443004";38;34;44;0;34;150
"2240";"360470444001";2;1;66;7;3;79
"2241";"360470444002";13;2;82;2;7;106
"2242";"360470444003";32;10;113;4;13;172
"2243";"360470445001";59;30;123;10;47;269
"2244";"360470445002";83;227;219;69;114;712
"2245";"360470445003";174;621;132;13;53;993
"2246";"360470446001";12;4;115;12;17;160
"2247";"360470446002";5;6;244;16;14;285
"2248";"360470447001";124;277;207;5;64;677
"2249";"360470447002";72;231;221;23;68;615
"2250";"360470448001";4;10;101;29;19;163
"2251";"360470448002";35;9;72;10;14;140
"2252";"360470449001";17;28;12;3;16;76
"2253";"360470449002";340;326;20;10;13;709
"2254";"360470449003";19;43;148;72;42;324
"2255";"360470449004";17;212;489;161;155;1034
"2256";"360470450001";13;28;222;63;8;334
"2257";"360470452001";3;5;131;9;11;159
"2258";"360470452002";47;7;48;15;24;141
"2259";"360470453001";115;123;200;54;116;608
"2260";"360470453002";128;333;178;29;110;778
"2261";"360470454001";24;81;103;12;19;239
"2262";"360470454002";2;5;69;12;2;90
"2263";"360470456001";17;60;158;14;40;289
"2264";"360470456002";82;11;161;12;11;277
"2265";"360470458001";15;6;86;6;20;133
"2266";"360470458002";2;1;39;24;7;73
"2267";"360470460001";43;7;194;9;15;268
"2268";"360470460002";22;30;122;15;31;220
"2269";"360470460003";3;18;136;11;44;212
"2270";"360470462011";30;4;262;44;15;355
"2271";"360470462012";17;12;153;35;13;230
"2272";"360470462021";8;2;56;4;2;72
"2273";"360470462022";23;5;146;52;28;254
"2274";"360470464001";7;14;45;11;19;96
"2275";"360470464002";6;0;47;4;14;71
"2276";"360470468001";25;81;218;18;25;367
"2277";"360470470001";1;7;70;6;22;106
"2278";"360470470002";6;6;126;29;7;174
"2279";"360470472001";2;0;11;1;6;20
"2280";"360470472002";3;46;102;7;18;176
"2281";"360470472003";1;0;40;22;5;68
"2282";"360470474001";3;9;35;6;8;61
"2283";"360470474002";0;1;18;6;4;29
"2284";"360470476001";5;16;52;23;18;114
"2285";"360470476002";0;4;23;1;5;33
"2286";"360470476003";2;2;71;14;1;90
"2287";"360470477001";176;42;263;45;60;586
"2288";"360470477002";190;108;154;18;54;524
"2289";"360470478001";24;39;213;45;48;369
"2290";"360470478002";10;3;46;11;8;78
"2291";"360470478003";67;4;149;39;14;273
"2292";"360470480001";14;3;191;7;23;238
"2293";"360470480002";28;20;417;69;61;595
"2294";"360470481001";14;21;66;6;34;141
"2295";"360470481002";40;75;92;15;55;277
"2296";"360470481003";120;34;114;5;54;327
"2297";"360470482001";56;22;253;53;30;414
"2298";"360470482002";18;5;116;33;29;201
"2299";"360470482003";47;18;192;4;22;283
"2300";"360470482004";197;10;637;3;13;860
"2301";"360470484001";85;25;242;24;19;395
"2302";"360470484002";19;15;193;11;25;263
"2303";"360470484003";23;12;85;3;13;136
"2304";"360470485001";142;124;578;69;166;1079
"2305";"360470485002";265;359;321;64;102;1111
"2306";"360470486001";19;55;110;10;68;262
"2307";"360470486002";157;24;143;29;30;383
"2308";"360470486003";23;149;228;9;37;446
"2309";"360470488001";46;18;108;8;25;205
"2310";"360470488002";10;0;316;7;26;359
"2311";"360470488003";13;10;121;7;15;166
"2312";"360470489001";287;71;9;0;3;370
"2313";"360470489002";129;2;1;0;11;143
"2314";"360470489003";229;5;5;6;7;252
"2315";"360470490001";54;43;126;15;17;255
"2316";"360470490002";125;28;244;45;25;467
"2317";"360470490003";30;12;162;8;24;236
"2318";"360470491001";11;71;9;7;4;102
"2319";"360470491002";61;182;26;17;136;422
"2320";"360470491003";181;152;51;15;78;477
"2321";"360470491004";27;15;13;1;11;67
"2322";"360470492001";25;45;101;77;30;278
"2323";"360470492002";28;42;178;39;83;370
"2324";"360470492003";11;11;191;65;30;308
"2325";"360470493001";134;82;23;7;16;262
"2326";"360470493002";243;200;92;4;79;618
"2327";"360470493003";41;74;70;4;50;239
"2328";"360470493004";47;39;25;0;20;131
"2329";"360470493005";102;182;16;5;68;373
"2330";"360470494001";73;26;162;14;17;292
"2331";"360470494002";40;6;120;20;19;205
"2332";"360470494003";12;10;83;3;5;113
"2333";"360470494004";4;7;45;3;12;71
"2334";"360470495001";34;36;93;11;36;210
"2335";"360470495002";65;93;205;15;53;431
"2336";"360470495003";111;177;149;6;86;529
"2337";"360470496001";81;26;161;10;71;349
"2338";"360470496002";19;21;123;13;40;216
"2339";"360470496003";77;20;103;11;42;253
"2340";"360470497001";21;17;167;13;38;256
"2341";"360470497002";37;26;110;13;81;267
"2342";"360470497003";49;42;93;16;67;267
"2343";"360470498001";82;88;82;23;27;302
"2344";"360470498002";34;70;198;26;9;337
"2345";"360470498003";7;7;207;42;11;274
"2346";"360470499001";31;10;24;6;27;98
"2347";"360470499002";38;43;122;15;43;261
"2348";"360470500001";5;15;59;9;7;95
"2349";"360470500002";69;43;60;12;35;219
"2350";"360470500003";18;13;88;13;10;142
"2351";"360470501001";44;9;37;4;21;115
"2352";"360470501002";44;36;24;1;23;128
"2353";"360470501003";126;364;103;14;103;710
"2354";"360470502021";16;3;38;3;14;74
"2355";"360470502022";10;19;105;8;35;177
"2356";"360470503001";81;66;79;25;41;292
"2357";"360470503002";95;100;294;10;70;569
"2358";"360470503003";77;32;100;23;46;278
"2359";"360470504001";5;16;34;14;13;82
"2360";"360470504002";52;48;195;20;26;341
"2361";"360470504003";59;35;143;45;60;342
"2362";"360470505001";96;78;10;12;18;214
"2363";"360470505002";285;178;63;13;71;610
"2364";"360470505003";98;114;31;10;50;303
"2365";"360470506001";64;70;42;4;28;208
"2366";"360470506002";133;43;80;17;17;290
"2367";"360470506003";70;41;48;11;28;198
"2368";"360470506004";78;19;55;17;56;225
"2369";"360470507001";59;27;273;171;132;662
"2370";"360470508011";83;56;12;12;9;172
"2371";"360470508012";120;88;27;11;80;326
"2372";"360470508031";171;217;130;14;61;593
"2373";"360470508041";183;89;74;20;28;394
"2374";"360470508042";233;151;140;36;27;587
"2375";"360470508043";210;52;48;12;14;336
"2376";"360470509001";9;121;91;38;25;284
"2377";"360470509002";3;15;135;24;12;189
"2378";"360470510011";74;32;85;37;11;239
"2379";"360470510012";238;168;45;29;90;570
"2380";"360470510021";419;171;50;40;36;716
"2381";"360470510022";130;91;51;17;33;322
"2382";"360470510023";82;35;81;22;3;223
"2383";"360470511001";12;76;22;5;12;127
"2384";"360470511002";247;182;86;46;62;623
"2385";"360470511003";51;191;65;12;34;353
"2386";"360470512001";150;56;105;72;19;402
"2387";"360470512002";171;39;47;93;13;363
"2388";"360470512003";100;65;66;78;10;319
"2389";"360470512004";61;85;71;44;10;271
"2390";"360470513001";136;107;231;24;67;565
"2391";"360470513002";61;77;137;20;39;334
"2392";"360470513003";268;358;237;31;101;995
"2393";"360470513004";22;83;102;18;16;241
"2394";"360470514001";23;17;114;23;22;199
"2395";"360470514002";148;65;84;3;33;333
"2396";"360470514003";195;65;91;1;19;371
"2397";"360470514004";83;32;71;43;23;252
"2398";"360470515001";241;165;95;19;60;580
"2399";"360470516011";124;29;56;7;11;227
"2400";"360470516012";251;67;81;5;10;414
"2401";"360470516013";219;440;190;26;105;980
"2402";"360470516021";183;142;51;20;28;424
"2403";"360470516022";260;539;64;34;87;984
"2404";"360470517001";78;93;88;2;27;288
"2405";"360470517002";79;166;56;15;63;379
"2406";"360470518001";87;6;159;5;6;263
"2407";"360470518002";45;20;152;18;6;241
"2408";"360470518003";36;18;31;3;9;97
"2409";"360470519001";178;114;150;3;56;501
"2410";"360470519002";88;46;161;8;64;367
"2411";"360470519003";151;232;156;25;95;659
"2412";"360470520001";49;13;89;19;23;193
"2413";"360470520002";84;27;116;23;54;304
"2414";"360470520003";25;19;29;2;4;79
"2415";"360470523001";218;389;46;10;57;720
"2416";"360470523002";96;314;15;5;24;454
"2417";"360470523003";132;62;48;6;38;286
"2418";"360470523004";73;97;31;3;13;217
"2419";"360470523005";57;120;16;3;35;231
"2420";"360470525001";221;99;115;11;131;577
"2421";"360470525002";31;51;31;4;33;150
"2422";"360470526001";82;40;85;78;44;329
"2423";"360470526002";141;15;215;25;39;435
"2424";"360470526003";1;2;54;5;9;71
"2425";"360470527001";77;96;113;17;25;328
"2426";"360470527002";83;93;28;6;12;222
"2427";"360470527003";43;90;45;11;41;230
"2428";"360470527004";24;56;31;8;59;178
"2429";"360470527005";60;326;23;19;20;448
"2430";"360470527006";106;578;67;4;28;783
"2431";"360470527007";106;95;41;0;9;251
"2432";"360470528001";60;22;141;12;8;243
"2433";"360470528002";21;10;211;31;31;304
"2434";"360470529001";1;5;53;3;22;84
"2435";"360470529002";6;100;28;21;17;172
"2436";"360470529003";19;23;27;18;56;143
"2437";"360470530001";53;10;58;23;13;157
"2438";"360470530002";58;9;102;4;12;185
"2439";"360470530003";56;14;262;25;45;402
"2440";"360470531001";19;12;27;7;20;85
"2441";"360470531002";13;14;16;0;14;57
"2442";"360470531003";0;2;2;0;1;5
"2443";"360470531004";2;1;20;2;2;27
"2444";"360470532001";66;29;135;11;34;275
"2445";"360470532002";11;18;99;19;18;165
"2446";"360470533001";1;0;3;0;5;9
"2447";"360470533002";0;1;1;2;3;7
"2448";"360470533003";0;2;8;7;5;22
"2449";"360470533004";3;15;4;0;7;29
"2450";"360470533005";3;5;21;21;5;55
"2451";"360470534001";23;10;135;3;22;193
"2452";"360470534002";21;0;45;4;13;83
"2453";"360470534003";353;6;38;4;18;419
"2454";"360470534004";7;6;41;13;24;91
"2455";"360470535001";9;3;4;3;11;30
"2456";"360470535002";0;0;36;5;3;44
"2457";"360470535003";1;6;13;14;7;41
"2458";"360470535004";3;28;27;4;9;71
"2459";"360470537001";1;4;22;1;5;33
"2460";"360470537002";4;4;68;16;10;102
"2461";"360470538001";52;31;142;4;19;248
"2462";"360470538002";152;27;140;8;20;347
"2463";"360470538003";47;52;158;8;27;292
"2464";"360470539001";1;3;31;24;3;62
"2465";"360470539002";36;1;74;0;5;116
"2466";"360470542001";42;10;212;3;18;285
"2467";"360470542002";25;45;131;28;32;261
"2468";"360470542003";3;0;74;7;4;88
"2469";"360470543001";7;32;96;6;11;152
"2470";"360470543002";56;32;142;33;54;317
"2471";"360470544001";68;10;203;8;7;296
"2472";"360470544002";32;2;316;14;8;372
"2473";"360470544003";4;3;102;8;9;126
"2474";"360470545001";3;1;15;44;5;68
"2475";"360470545002";0;13;15;7;5;40
"2476";"360470545003";54;16;5;1;12;88
"2477";"360470545004";0;3;1;0;0;4
"2478";"360470545005";78;29;25;3;9;144
"2479";"360470545006";99;14;9;9;5;136
"2480";"360470546001";14;10;112;3;1;140
"2481";"360470546002";86;13;206;8;31;344
"2482";"360470546003";71;6;137;13;7;234
"2483";"360470547001";73;66;45;6;10;200
"2484";"360470547002";9;11;105;2;18;145
"2485";"360470547003";49;74;184;14;21;342
"2486";"360470548001";35;3;47;28;9;122
"2487";"360470548002";5;1;133;118;3;260
"2488";"360470549001";42;86;84;8;32;252
"2489";"360470549002";136;250;245;25;117;773
"2490";"360470550001";41;2;130;21;8;202
"2491";"360470550002";18;2;109;28;18;175
"2492";"360470550003";37;30;86;4;23;180
"2493";"360470551001";86;295;235;19;50;685
"2494";"360470551002";48;77;38;7;57;227
"2495";"360470551003";204;205;94;6;48;557
"2496";"360470551004";65;129;21;9;22;246
"2497";"360470552001";78;6;110;3;22;219
"2498";"360470552002";10;21;95;15;23;164
"2499";"360470552003";29;13;141;5;27;215
"2500";"360470553001";94;229;59;9;82;473
"2501";"360470553002";99;117;97;21;71;405
"2502";"360470553003";86;202;124;13;73;498
"2503";"360470554001";144;36;133;18;85;416
"2504";"360470554002";52;12;96;10;28;198
"2505";"360470554003";12;21;66;6;30;135
"2506";"360470555001";488;866;595;23;179;2151
"2507";"360470556001";27;11;121;6;13;178
"2508";"360470556002";21;4;133;8;5;171
"2509";"360470556003";39;2;97;25;20;183
"2510";"360470557001";38;12;76;5;15;146
"2511";"360470557002";172;409;249;20;55;905
"2512";"360470558001";13;3;146;4;13;179
"2513";"360470558002";27;317;155;10;23;532
"2514";"360470560001";3;4;153;53;15;228
"2515";"360470560002";26;8;83;6;8;131
"2516";"360470560003";18;5;93;22;7;145
"2517";"360470561001";79;69;179;27;44;398
"2518";"360470561002";6;6;39;9;19;79
"2519";"360470561003";26;160;133;11;80;410
"2520";"360470561004";37;27;79;10;21;174
"2521";"360470562001";3;0;98;38;12;151
"2522";"360470562002";6;0;171;59;6;242
"2523";"360470563001";127;138;211;23;39;538
"2524";"360470563002";149;221;80;10;44;504
"2525";"360470563003";51;31;97;17;35;231
"2526";"360470563004";27;152;136;5;39;359
"2527";"360470564001";14;3;47;13;6;83
"2528";"360470564002";44;4;46;10;4;108
"2529";"360470564003";3;1;28;14;6;52
"2530";"360470565001";54;316;427;20;77;894
"2531";"360470565002";30;76;54;7;28;195
"2532";"360470565003";64;115;42;10;84;315
"2533";"360470566001";51;5;69;23;22;170
"2534";"360470566002";16;3;58;29;33;139
"2535";"360470568001";3;6;105;19;13;146
"2536";"360470568002";0;0;34;30;3;67
"2537";"360470569001";67;249;32;13;104;465
"2538";"360470569002";45;34;125;14;63;281
"2539";"360470570001";9;5;41;8;4;67
"2540";"360470570002";7;4;18;13;6;48
"2541";"360470570003";1;5;13;11;4;34
"2542";"360470570004";30;20;121;49;24;244
"2543";"360470571001";61;283;72;4;52;472
"2544";"360470571002";21;13;47;12;25;118
"2545";"360470571003";26;24;42;14;65;171
"2546";"360470571004";11;12;42;5;36;106
"2547";"360470572001";323;115;71;48;8;565
"2548";"360470572002";201;68;39;31;22;361
"2549";"360470573001";11;70;81;11;18;191
"2550";"360470573002";84;8;20;4;13;129
"2551";"360470573003";34;29;34;6;9;112
"2552";"360470574001";16;35;81;86;10;228
"2553";"360470574002";3;1;51;16;14;85
"2554";"360470575001";49;52;47;14;23;185
"2555";"360470575002";40;109;62;6;35;252
"2556";"360470575003";29;25;88;8;36;186
"2557";"360470575004";67;31;54;11;37;200
"2558";"360470576001";18;6;109;20;40;193
"2559";"360470576002";18;4;85;27;22;156
"2560";"360470578001";21;16;331;22;34;424
"2561";"360470578002";93;19;146;16;34;308
"2562";"360470579001";55;68;101;4;22;250
"2563";"360470579002";25;33;380;54;66;558
"2564";"360470580001";78;6;82;6;35;207
"2565";"360470580002";52;10;120;8;29;219
"2566";"360470582001";48;8;126;7;24;213
"2567";"360470582002";2;3;38;11;12;66
"2568";"360470582003";68;15;99;16;19;217
"2569";"360470584001";81;11;241;13;35;381
"2570";"360470584002";58;12;340;16;28;454
"2571";"360470586001";24;8;48;12;22;114
"2572";"360470586002";9;3;138;2;23;175
"2573";"360470588001";54;8;243;68;27;400
"2574";"360470588002";44;6;21;3;14;88
"2575";"360470589001";18;12;158;22;30;240
"2576";"360470589002";34;75;43;12;21;185
"2577";"360470590001";27;79;217;45;40;408
"2578";"360470591001";26;9;37;17;14;103
"2579";"360470591002";36;43;35;10;27;151
"2580";"360470591003";11;16;74;22;22;145
"2581";"360470591004";10;56;25;7;18;116
"2582";"360470592001";33;4;98;10;15;160
"2583";"360470592002";34;11;164;16;19;244
"2584";"360470592003";28;9;58;0;21;116
"2585";"360470593001";20;12;53;9;21;115
"2586";"360470593002";51;43;29;16;35;174
"2587";"360470594011";1;1;64;23;7;96
"2588";"360470594012";16;2;172;44;31;265
"2589";"360470594013";13;12;175;155;43;398
"2590";"360470594014";13;7;175;48;43;286
"2591";"360470594015";30;4;82;6;30;152
"2592";"360470594016";73;7;90;27;22;219
"2593";"360470594021";10;21;59;17;36;143
"2594";"360470594022";72;4;253;126;14;469
"2595";"360470594023";58;3;159;39;15;274
"2596";"360470594024";17;0;90;37;15;159
"2597";"360470596001";10;5;23;15;4;57
"2598";"360470596002";2;1;7;5;0;15
"2599";"360470596003";22;31;462;68;19;602
"2600";"360470598001";45;12;83;35;9;184
"2601";"360470598002";24;3;99;64;20;210
"2602";"360470600001";27;35;161;41;16;280
"2603";"360470600002";14;7;308;93;17;439
"2604";"360470600003";57;10;291;147;28;533
"2605";"360470600004";23;3;63;18;17;124
"2606";"360470600005";41;8;56;5;28;138
"2607";"360470606001";77;20;131;11;51;290
"2608";"360470606002";31;3;157;5;21;217
"2609";"360470608001";20;18;164;53;56;311
"2610";"360470608002";23;13;155;19;15;225
"2611";"360470608003";75;96;155;10;33;369
"2612";"360470610021";21;13;77;2;17;130
"2613";"360470610022";168;36;31;2;17;254
"2614";"360470610031";8;1;39;2;18;68
"2615";"360470610032";53;7;81;4;39;184
"2616";"360470610041";43;40;108;8;39;238
"2617";"360470610042";38;3;108;4;27;180
"2618";"360470610043";19;13;167;10;11;220
"2619";"360470610044";24;5;25;2;6;62
"2620";"360470610045";42;3;31;0;13;89
"2621";"360470612001";38;70;125;12;29;274
"2622";"360470616001";32;30;104;16;217;399
"2623";"360470620001";8;26;59;3;18;114
"2624";"360470620002";5;10;56;3;16;90
"2625";"360470622001";46;9;166;35;22;278
"2626";"360470622002";42;74;413;96;41;666
"2627";"360470626001";24;1;122;25;18;190
"2628";"360470626002";21;20;167;68;41;317
"2629";"360470628001";22;4;65;76;18;185
"2630";"360470628002";23;24;124;65;34;270
"2631";"360470628003";11;4;49;44;21;129
"2632";"360470628004";6;1;63;49;26;145
"2633";"360470632001";19;1;17;16;19;72
"2634";"360470632002";8;1;22;15;8;54
"2635";"360470636001";17;6;163;39;19;244
"2636";"360470638001";3;0;92;22;7;124
"2637";"360470638002";9;0;50;54;11;124
"2638";"360470640001";7;6;42;17;9;81
"2639";"360470640002";13;5;128;32;7;185
"2640";"360470642001";127;19;117;63;20;346
"2641";"360470642002";45;5;71;13;9;143
"2642";"360470644001";21;14;105;28;20;188
"2643";"360470644002";11;5;74;38;8;136
"2644";"360470646001";4;8;126;40;31;209
"2645";"360470646002";8;14;114;48;21;205
"2646";"360470648001";16;5;147;136;20;324
"2647";"360470648002";1;7;91;44;6;149
"2648";"360470650001";2;5;116;21;13;157
"2649";"360470650002";23;6;105;110;28;272
"2650";"360470652001";15;82;183;67;40;387
"2651";"360470654001";1;2;60;16;5;84
"2652";"360470654002";4;5;99;17;18;143
"2653";"360470656001";18;26;94;9;16;163
"2654";"360470656002";7;3;63;20;7;100
"2655";"360470658001";11;9;55;25;21;121
"2656";"360470658002";28;5;75;33;23;164
"2657";"360470660001";1;2;74;32;18;127
"2658";"360470660002";23;16;47;30;8;124
"2659";"360470662001";23;10;174;49;57;313
"2660";"360470666001";19;69;47;29;42;206
"2661";"360470670001";13;1;109;45;10;178
"2662";"360470670002";49;14;237;161;38;499
"2663";"360470672001";50;39;207;231;36;563
"2664";"360470674001";8;3;85;79;24;199
"2665";"360470674002";54;7;195;186;25;467
"2666";"360470676001";23;2;74;76;6;181
"2667";"360470676002";9;22;131;82;29;273
"2668";"360470678001";34;3;186;130;12;365
"2669";"360470678002";46;6;181;123;12;368
"2670";"360470680001";13;9;103;104;12;241
"2671";"360470680002";11;61;167;69;15;323
"2672";"360470682001";52;16;139;122;12;341
"2673";"360470682002";58;9;93;137;6;303
"2674";"360470686001";17;3;112;51;18;201
"2675";"360470686002";30;5;45;120;19;219
"2676";"360470688001";12;5;87;40;13;157
"2677";"360470688002";11;5;35;22;14;87
"2678";"360470690001";22;4;97;54;6;183
"2679";"360470690002";45;26;188;111;13;383
"2680";"360470692001";15;18;199;271;33;536
"2681";"360470692002";26;5;133;106;9;279
"2682";"360470696011";112;26;184;135;32;489
"2683";"360470696012";86;10;310;117;36;559
"2684";"360470696021";19;11;155;76;15;276
"2685";"360470696022";56;69;145;146;53;469
"2686";"360470696023";58;19;232;127;39;475
"2687";"360470698001";19;2;40;26;5;92
"2688";"360470698002";34;51;181;103;43;412
"2689";"360470700001";5;1;31;14;10;61
"2690";"360470700002";11;5;109;58;19;202
"2691";"360470702011";12;9;41;44;18;124
"2692";"360470702012";1;1;17;44;23;86
"2693";"360470702013";19;3;3;9;17;51
"2694";"360470702014";21;6;232;61;18;338
"2695";"360470702015";53;6;258;74;29;420
"2696";"360470702021";0;2;3;2;10;17
"2697";"360470706001";24;9;105;35;57;230
"2698";"360470706002";27;31;74;41;55;228
"2699";"360470720001";40;5;209;270;39;563
"2700";"360470722001";31;30;222;115;54;452
"2701";"360470722002";11;4;153;196;24;388
"2702";"360470724001";14;7;34;31;11;97
"2703";"360470724002";36;15;74;68;19;212
"2704";"360470726001";21;17;208;158;40;444
"2705";"360470728001";75;16;127;33;29;280
"2706";"360470728002";34;15;66;110;16;241
"2707";"360470730001";40;65;140;155;24;424
"2708";"360470730002";18;4;86;43;21;172
"2709";"360470732001";100;16;98;18;26;258
"2710";"360470732002";30;14;84;81;15;224
"2711";"360470734001";14;5;44;12;9;84
"2712";"360470734002";11;4;129;28;14;186
"2713";"360470736001";188;2;25;50;3;268
"2714";"360470736002";25;7;57;50;14;153
"2715";"360470736003";19;11;60;19;43;152
"2716";"360470738001";35;19;121;29;23;227
"2717";"360470738002";47;1;309;25;6;388
"2718";"360470738003";19;6;319;40;16;400
"2719";"360470740001";34;19;273;131;37;494
"2720";"360470740002";57;31;188;39;33;348
"2721";"360470742001";55;16;264;45;22;402
"2722";"360470742002";121;97;113;11;34;376
"2723";"360470744001";7;9;145;19;10;190
"2724";"360470744002";10;6;197;29;7;249
"2725";"360470746001";56;6;215;41;14;332
"2726";"360470746002";4;10;220;29;25;288
"2727";"360470748001";75;8;129;36;28;276
"2728";"360470748002";1;2;71;15;3;92
"2729";"360470750001";10;4;107;12;74;207
"2730";"360470750002";220;8;93;3;31;355
"2731";"360470752001";1;0;176;26;11;214
"2732";"360470754001";3;3;36;21;7;70
"2733";"360470754002";1;2;59;12;10;84
"2734";"360470756001";3;4;170;28;16;221
"2735";"360470756002";6;1;48;16;1;72
"2736";"360470758001";3;10;90;13;4;120
"2737";"360470758002";204;1;112;10;18;345
"2738";"360470760001";0;1;52;9;1;63
"2739";"360470760002";49;2;41;12;10;114
"2740";"360470760003";37;3;50;5;12;107
"2741";"360470762001";37;8;21;7;7;80
"2742";"360470762002";22;11;124;4;11;172
"2743";"360470762003";255;11;55;1;16;338
"2744";"360470764001";115;3;118;9;13;258
"2745";"360470764002";38;6;62;11;13;130
"2746";"360470764003";41;97;115;14;31;298
"2747";"360470766001";143;12;590;18;17;780
"2748";"360470768001";6;24;158;44;8;240
"2749";"360470768002";136;13;518;8;14;689
"2750";"360470768003";21;17;281;5;26;350
"2751";"360470770001";40;39;108;44;15;246
"2752";"360470770002";67;62;500;137;53;819
"2753";"360470772001";41;11;322;55;12;441
"2754";"360470772002";156;41;133;17;10;357
"2755";"360470774001";15;6;54;15;33;123
"2756";"360470774002";96;17;172;7;42;334
"2757";"360470776001";33;11;17;17;7;85
"2758";"360470776002";18;6;46;4;10;84
"2759";"360470776003";13;2;96;32;14;157
"2760";"360470780001";18;5;50;31;8;112
"2761";"360470780002";24;8;102;72;12;218
"2762";"360470782001";94;12;91;79;18;294
"2763";"360470782002";560;77;152;51;53;893
"2764";"360470784001";67;17;141;35;24;284
"2765";"360470784002";32;6;156;21;11;226
"2766";"360470786001";102;9;50;10;32;203
"2767";"360470786002";133;21;89;20;64;327
"2768";"360470786003";117;6;257;16;28;424
"2769";"360470788001";172;68;108;47;28;423
"2770";"360470788002";40;11;101;37;20;209
"2771";"360470788003";5;69;119;106;23;322
"2772";"360470790001";106;118;79;26;23;352
"2773";"360470790002";82;54;125;38;37;336
"2774";"360470790003";67;54;74;33;23;251
"2775";"360470790004";92;28;89;40;11;260
"2776";"360470792001";301;73;354;69;14;811
"2777";"360470792002";108;70;114;47;16;355
"2778";"360470792003";101;83;154;99;66;503
"2779";"360470794001";55;139;152;63;78;487
"2780";"360470794002";43;28;75;35;53;234
"2781";"360470796011";99;261;141;8;64;573
"2782";"360470796012";202;51;191;13;31;488
"2783";"360470796021";321;192;151;26;74;764
"2784";"360470796022";187;110;97;61;64;519
"2785";"360470798011";91;109;91;16;21;328
"2786";"360470798012";72;91;82;13;63;321
"2787";"360470798021";172;75;47;4;57;355
"2788";"360470798022";538;934;8;4;59;1543
"2789";"360470798023";354;856;219;53;45;1527
"2790";"360470800001";342;185;167;13;34;741
"2791";"360470800002";48;69;105;19;37;278
"2792";"360470800003";59;61;44;5;31;200
"2793";"360470802001";184;301;161;26;43;715
"2794";"360470802002";95;114;94;12;44;359
"2795";"360470802003";169;65;134;21;28;417
"2796";"360470804001";127;140;85;11;30;393
"2797";"360470804002";86;111;42;5;18;262
"2798";"360470804003";42;61;118;24;44;289
"2799";"360470806001";76;55;214;25;25;395
"2800";"360470806002";120;46;140;27;55;388
"2801";"360470808001";65;44;62;42;40;253
"2802";"360470810001";59;40;172;28;17;316
"2803";"360470810002";50;12;133;47;15;257
"2804";"360470814001";77;11;99;59;32;278
"2805";"360470814002";73;51;186;36;36;382
"2806";"360470816001";95;7;167;19;38;326
"2807";"360470816002";99;43;99;21;50;312
"2808";"360470818001";452;34;97;13;51;647
"2809";"360470818002";35;34;57;10;29;165
"2810";"360470818003";77;38;116;3;23;257
"2811";"360470820001";253;116;192;6;37;604
"2812";"360470820002";182;124;117;17;35;475
"2813";"360470820003";129;30;149;8;71;387
"2814";"360470822001";66;27;81;1;22;197
"2815";"360470822002";309;423;55;9;22;818
"2816";"360470822003";540;145;137;3;20;845
"2817";"360470822004";127;132;126;18;30;433
"2818";"360470824001";53;4;135;22;30;244
"2819";"360470824002";50;33;59;20;19;181
"2820";"360470824003";135;17;196;77;18;443
"2821";"360470824004";209;38;251;17;65;580
"2822";"360470826001";55;31;138;21;33;278
"2823";"360470826002";43;14;154;34;37;282
"2824";"360470826003";376;136;110;58;43;723
"2825";"360470826004";29;62;67;49;31;238
"2826";"360470828001";57;40;26;7;41;171
"2827";"360470828002";50;65;129;26;42;312
"2828";"360470828003";67;115;286;38;89;595
"2829";"360470830001";140;14;234;55;19;462
"2830";"360470830002";15;12;165;42;9;243
"2831";"360470830003";110;4;60;32;5;211
"2832";"360470830004";144;4;15;4;8;175
"2833";"360470832001";17;9;89;48;7;170
"2834";"360470832002";34;6;147;43;15;245
"2835";"360470834001";60;1;51;34;60;206
"2836";"360470834002";14;5;80;31;12;142
"2837";"360470836001";34;7;103;50;17;211
"2838";"360470836002";4;9;59;34;18;124
"2839";"360470838001";10;6;72;52;21;161
"2840";"360470838002";12;4;50;19;29;114
"2841";"360470840001";70;11;147;113;24;365
"2842";"360470840002";24;12;122;79;12;249
"2843";"360470846001";50;24;116;119;7;316
"2844";"360470846002";59;30;113;127;37;366
"2845";"360470848001";23;5;91;43;13;175
"2846";"360470848002";29;8;107;47;23;214
"2847";"360470850001";51;3;108;169;25;356
"2848";"360470852001";2;0;4;12;0;18
"2849";"360470854001";69;10;56;44;11;190
"2850";"360470854002";40;2;118;60;33;253
"2851";"360470856001";58;49;83;7;17;214
"2852";"360470856002";71;12;56;23;8;170
"2853";"360470856003";73;14;144;20;24;275
"2854";"360470858001";30;8;65;19;23;145
"2855";"360470858002";149;26;89;21;28;313
"2856";"360470860001";42;20;56;21;39;178
"2857";"360470860002";78;13;205;18;37;351
"2858";"360470860003";34;19;48;5;15;121
"2859";"360470862001";12;2;85;7;16;122
"2860";"360470862002";13;5;158;14;20;210
"2861";"360470862003";16;12;44;6;31;109
"2862";"360470864001";37;8;114;91;13;263
"2863";"360470864002";13;25;110;57;30;235
"2864";"360470866001";39;17;235;43;13;347
"2865";"360470866002";42;26;77;15;16;176
"2866";"360470866003";77;46;43;9;16;191
"2867";"360470868001";28;16;72;22;19;157
"2868";"360470868002";70;65;152;38;25;350
"2869";"360470868003";68;50;62;62;78;320
"2870";"360470870001";25;9;56;21;19;130
"2871";"360470870002";43;60;103;11;21;238
"2872";"360470870003";6;6;42;9;12;75
"2873";"360470872001";7;13;27;14;5;66
"2874";"360470872002";27;4;65;20;16;132
"2875";"360470872003";53;15;44;28;29;169
"2876";"360470874011";215;65;218;72;10;580
"2877";"360470874012";92;208;202;22;36;560
"2878";"360470876001";67;106;205;44;16;438
"2879";"360470876002";28;5;60;45;7;145
"2880";"360470878001";33;23;82;54;24;216
"2881";"360470878002";6;16;27;29;9;87
"2882";"360470878003";36;21;76;22;38;193
"2883";"360470880001";36;50;159;66;21;332
"2884";"360470880002";12;46;2;3;5;68
"2885";"360470880003";74;14;99;14;24;225
"2886";"360470882001";44;16;107;7;9;183
"2887";"360470882002";54;16;51;18;15;154
"2888";"360470882003";47;13;61;38;20;179
"2889";"360470882004";75;18;141;31;34;299
"2890";"360470884001";175;61;65;16;30;347
"2891";"360470884002";41;28;84;11;20;184
"2892";"360470884003";68;15;131;59;16;289
"2893";"360470886001";115;5;117;27;15;279
"2894";"360470886002";74;28;114;27;17;260
"2895";"360470886003";79;14;170;44;21;328
"2896";"360470888001";52;23;218;32;22;347
"2897";"360470888002";29;8;103;54;1;195
"2898";"360470888003";53;8;78;37;28;204
"2899";"360470890001";43;2;71;15;10;141
"2900";"360470890002";43;16;94;23;13;189
"2901";"360470890003";13;3;40;21;6;83
"2902";"360470890004";52;29;93;16;46;236
"2903";"360470890005";22;3;75;2;17;119
"2904";"360470890006";32;1;21;0;14;68
"2905";"360470892001";44;6;34;7;13;104
"2906";"360470892002";87;141;48;2;18;296
"2907";"360470892003";147;11;41;12;30;241
"2908";"360470892004";50;17;39;12;12;130
"2909";"360470894001";18;1;55;19;17;110
"2910";"360470894002";18;30;78;25;12;163
"2911";"360470894003";53;30;39;6;19;147
"2912";"360470894004";27;14;63;13;20;137
"2913";"360470896001";99;28;92;41;7;267
"2914";"360470896002";328;70;208;56;56;718
"2915";"360470896003";125;36;55;22;18;256
"2916";"360470898001";40;8;63;20;23;154
"2917";"360470898002";78;36;143;28;38;323
"2918";"360470900001";9;1;54;11;13;88
"2919";"360470900002";6;8;14;6;7;41
"2920";"360470900003";110;40;35;11;12;208
"2921";"360470900004";17;10;82;4;13;126
"2922";"360470900005";103;28;57;13;15;216
"2923";"360470900006";34;21;71;28;7;161
"2924";"360470900007";27;3;11;6;7;54
"2925";"360470902001";58;23;10;4;14;109
"2926";"360470902002";3;5;7;4;2;21
"2927";"360470902003";13;10;20;13;2;58
"2928";"360470902004";65;4;65;34;13;181
"2929";"360470902005";25;4;37;14;19;99
"2930";"360470906001";191;27;22;2;361;603
"2931";"360470906002";89;19;63;52;49;272
"2932";"360470906003";98;17;6;2;11;134
"2933";"360470908001";179;97;125;112;61;574
"2934";"360470908002";20;11;13;14;7;65
"2935";"360470908003";183;36;37;10;28;294
"2936";"360470910001";57;62;3;9;4;135
"2937";"360470910002";224;56;15;3;7;305
"2938";"360470910003";25;2;6;6;12;51
"2939";"360470910004";53;3;32;22;14;124
"2940";"360470912001";69;9;68;35;1;182
"2941";"360470912002";78;20;10;11;7;126
"2942";"360470912003";92;11;15;9;10;137
"2943";"360470916001";30;13;15;14;12;84
"2944";"360470916002";26;14;62;41;12;155
"2945";"360470916003";14;16;132;22;14;198
"2946";"360470916004";58;99;171;36;31;395
"2947";"360470918001";41;23;39;12;18;133
"2948";"360470918002";13;5;77;46;14;155
"2949";"360470920001";10;6;16;16;3;51
"2950";"360470920002";128;23;42;15;13;221
"2951";"360470920003";15;15;60;28;31;149
"2952";"360470922001";75;10;47;22;13;167
"2953";"360470922002";40;22;118;91;12;283
"2954";"360470924001";55;34;60;14;68;231
"2955";"360470924002";50;24;105;15;27;221
"2956";"360470924003";16;9;20;3;5;53
"2957";"360470928001";57;8;144;44;11;264
"2958";"360470928002";25;6;240;194;24;489
"2959";"360470930001";18;2;141;17;11;189
"2960";"360470930002";12;5;152;94;16;279
"2961";"360470932001";52;8;219;218;38;535
"2962";"360470934001";11;6;78;31;9;135
"2963";"360470934002";24;11;85;56;29;205
"2964";"360470936001";26;2;35;24;13;100
"2965";"360470936002";63;23;99;94;21;300
"2966";"360470938001";29;11;75;18;29;162
"2967";"360470938002";21;0;114;37;25;197
"2968";"360470944011";22;2;16;53;2;95
"2969";"360470944012";22;15;94;65;22;218
"2970";"360470944013";102;36;57;73;156;424
"2971";"360470944014";13;3;22;22;11;71
"2972";"360470944021";112;65;16;9;17;219
"2973";"360470946001";4;4;79;34;10;131
"2974";"360470946002";14;1;54;20;6;95
"2975";"360470946003";17;31;146;255;20;469
"2976";"360470950001";116;21;177;32;25;371
"2977";"360470950002";31;1;68;105;14;219
"2978";"360470954001";9;14;105;63;12;203
"2979";"360470954002";27;7;68;54;7;163
"2980";"360470954003";36;11;185;69;23;324
"2981";"360470956001";20;6;69;61;12;168
"2982";"360470956002";40;6;244;54;30;374
"2983";"360470958001";53;8;155;98;15;329
"2984";"360470958002";46;7;393;138;30;614
"2985";"360470960001";10;15;114;209;37;385
"2986";"360470962001";65;80;172;98;36;451
"2987";"360470964001";57;19;94;77;11;258
"2988";"360470964002";88;52;180;70;29;419
"2989";"360470966001";3;3;126;31;29;192
"2990";"360470966002";12;4;89;35;22;162
"2991";"360470968001";22;21;62;12;44;161
"2992";"360470968002";17;7;206;31;24;285
"2993";"360470970001";21;3;120;65;43;252
"2994";"360470970002";38;7;107;78;5;235
"2995";"360470974001";21;8;92;44;25;190
"2996";"360470974002";66;32;224;29;27;378
"2997";"360470982001";130;29;13;27;14;213
"2998";"360470982002";51;30;15;20;6;122
"2999";"360470984001";42;5;142;54;16;259
"3000";"360470986001";36;4;44;30;34;148
"3001";"360470986002";53;16;71;65;5;210
"3002";"360470988001";43;1;67;58;21;190
"3003";"360470988002";44;5;97;25;11;182
"3004";"360470990001";26;10;212;52;34;334
"3005";"360470992001";74;24;324;87;31;540
"3006";"360470994001";67;20;168;72;26;353
"3007";"360470996001";80;13;166;66;13;338
"3008";"360470996002";83;1;169;38;17;308
"3009";"360470998001";45;3;301;35;17;401
"3010";"360470998002";22;23;342;85;11;483
"3011";"360471004001";31;3;204;47;14;299
"3012";"360471006001";7;2;140;23;26;198
"3013";"360471006002";55;5;266;38;13;377
"3014";"360471008001";16;5;90;70;17;198
"3015";"360471008002";7;1;106;70;7;191
"3016";"360471010001";73;38;115;58;28;312
"3017";"360471010002";62;9;116;99;17;303
"3018";"360471012001";13;5;138;45;16;217
"3019";"360471012002";23;13;74;32;25;167
"3020";"360471014001";48;7;76;34;12;177
"3021";"360471014002";97;11;30;33;11;182
"3022";"360471016001";32;7;111;57;12;219
"3023";"360471018001";35;28;50;74;17;204
"3024";"360471020001";31;7;116;53;14;221
"3025";"360471022001";111;15;188;100;49;463
"3026";"360471024001";54;6;121;94;30;305
"3027";"360471026001";66;12;259;66;37;440
"3028";"360471028000";0;0;0;1;0;1
"3029";"360471028001";24;22;83;62;39;230
"3030";"360471028002";15;8;71;44;21;159
"3031";"360471034001";283;45;36;13;19;396
"3032";"360471058011";13;4;0;3;7;27
"3033";"360471058012";13;3;56;26;17;115
"3034";"360471058013";75;10;5;8;2;100
"3035";"360471058041";9;1;37;3;8;58
"3036";"360471058042";32;10;10;7;2;61
"3037";"360471058043";12;1;12;3;1;29
"3038";"360471058044";65;3;28;15;13;124
"3039";"360471070001";75;43;156;319;33;626
"3040";"360471078001";45;40;211;21;20;337
"3041";"360471078002";12;36;43;20;8;119
"3042";"360471078003";5;4;58;20;8;95
"3043";"360471078004";19;18;9;12;2;60
"3044";"360471098001";195;18;114;78;30;435
"3045";"360471098002";29;14;281;440;43;807
"3046";"360471104001";20;41;252;126;61;500
"3047";"360471104002";169;24;106;146;38;483
"3048";"360471104003";44;7;61;15;11;138
"3049";"360471104004";18;7;69;45;20;159
"3050";"360471106001";264;7;15;5;7;298
"3051";"360471106002";120;37;2;3;7;169
"3052";"360471110001";147;42;5;14;11;219
"3053";"360471110002";416;21;4;3;2;446
"3054";"360471116001";35;15;76;31;21;178
"3055";"360471116002";72;38;257;117;61;545
"3056";"360471118001";61;19;95;50;22;247
"3057";"360471118002";268;25;201;49;30;573
"3058";"360471120001";20;15;68;16;22;141
"3059";"360471120002";144;72;117;32;43;408
"3060";"360471122001";86;64;209;98;35;492
"3061";"360471122002";56;27;186;31;23;323
"3062";"360471124001";33;5;69;45;34;186
"3063";"360471124002";19;28;45;37;50;179
"3064";"360471124003";65;38;67;29;24;223
"3065";"360471126001";19;8;25;32;26;110
"3066";"360471126002";39;8;43;15;27;132
"3067";"360471126003";60;13;87;21;72;253
"3068";"360471128001";38;20;99;36;37;230
"3069";"360471128002";40;68;84;11;47;250
"3070";"360471128003";161;26;76;37;40;340
"3071";"360471130001";21;2;14;12;2;51
"3072";"360471130002";92;15;63;11;10;191
"3073";"360471130003";61;11;42;49;25;188
"3074";"360471130004";13;8;112;66;25;224
"3075";"360471132001";21;22;111;75;28;257
"3076";"360471132002";61;8;95;48;13;225
"3077";"360471134001";33;12;17;9;18;89
"3078";"360471134002";45;25;15;10;5;100
"3079";"360471134003";16;3;21;34;7;81
"3080";"360471142011";32;9;172;28;28;269
"3081";"360471142012";38;24;196;167;35;460
"3082";"360471142021";72;48;362;69;26;577
"3083";"360471142022";47;19;66;22;28;182
"3084";"360471144001";36;26;191;144;56;453
"3085";"360471144002";99;23;44;26;53;245
"3086";"360471144003";3;3;62;53;19;140
"3087";"360471144004";27;9;31;8;8;83
"3088";"360471146001";56;55;314;50;63;538
"3089";"360471146002";81;177;178;63;71;570
"3090";"360471150001";54;44;117;56;49;320
"3091";"360471150002";81;3;103;41;19;247
"3092";"360471150003";29;21;124;50;36;260
"3093";"360471152001";31;18;111;150;40;350
"3094";"360471152002";97;21;122;114;9;363
"3095";"360471152003";57;14;46;38;36;191
"3096";"360471156001";34;7;118;9;23;191
"3097";"360471156002";182;11;11;8;7;219
"3098";"360471156003";264;21;4;4;1;294
"3099";"360471156004";78;197;57;9;31;372
"3100";"360471158001";35;17;103;8;22;185
"3101";"360471158002";33;26;68;22;13;162
"3102";"360471158003";84;11;49;14;38;196
"3103";"360471160001";7;3;25;41;20;96
"3104";"360471160002";50;28;27;18;15;138
"3105";"360471160003";40;28;69;34;16;187
"3106";"360471162001";45;8;33;25;14;125
"3107";"360471162002";12;7;20;22;7;68
"3108";"360471162003";8;2;157;36;11;214
"3109";"360471164001";72;26;72;56;22;248
"3110";"360471164002";50;16;76;20;15;177
"3111";"360471164003";27;5;86;17;19;154
"3112";"360471166001";27;20;84;20;40;191
"3113";"360471166002";51;13;94;48;30;236
"3114";"360471166003";66;23;113;48;49;299
"3115";"360471168001";99;58;163;166;67;553
"3116";"360471168002";38;24;210;56;61;389
"3117";"360471170001";50;82;107;20;33;292
"3118";"360471170002";75;58;117;81;60;391
"3119";"360471172011";108;21;362;65;187;743
"3120";"360471172012";63;39;99;18;61;280
"3121";"360471172021";57;21;149;14;26;267
"3122";"360471172022";72;28;180;64;45;389
"3123";"360471174001";246;239;181;93;48;807
"3124";"360471174002";58;134;288;64;112;656
"3125";"360471176011";179;17;363;38;189;786
"3126";"360471176012";185;151;158;20;38;552
"3127";"360471176021";80;175;301;54;54;664
"3128";"360471176022";104;125;182;38;67;516
"3129";"360471178001";57;64;176;119;99;515
"3130";"360471180001";92;292;63;28;27;502
"3131";"360471182011";100;49;285;27;26;487
"3132";"360471182012";31;27;235;91;43;427
"3133";"360471182021";83;170;101;23;37;414
"3134";"360471182022";31;42;150;44;25;292
"3135";"360471184001";96;115;133;44;54;442
"3136";"360471184002";84;73;138;77;92;464
"3137";"360471184003";53;40;124;42;51;310
"3138";"360471186001";40;13;259;65;25;402
"3139";"360471186002";44;14;200;58;38;354
"3140";"360471188001";145;253;125;9;47;579
"3141";"360471188002";58;45;57;16;78;254
"3142";"360471188003";37;37;94;16;94;278
"3143";"360471190001";59;13;209;67;24;372
"3144";"360471190002";56;29;92;11;61;249
"3145";"360471192001";181;34;200;76;39;530
"3146";"360471192002";115;40;194;76;42;467
"3147";"360471192003";28;16;143;69;33;289
"3148";"360471194001";56;16;94;40;33;239
"3149";"360471194002";69;18;247;51;49;434
"3150";"360471194003";107;24;170;45;36;382
"3151";"360471196001";47;27;214;119;39;446
"3152";"360471196002";33;36;170;53;57;349
"3153";"360471196003";62;25;274;21;34;416
"3154";"360471196004";70;24;263;53;42;452
"3155";"360471198001";21;17;103;21;62;224
"3156";"360471198002";26;6;95;51;34;212
"3157";"360471198003";35;37;206;212;104;594
"3158";"360471200001";36;11;96;33;28;204
"3159";"360471200002";70;15;203;42;32;362
"3160";"360471202001";52;15;57;15;23;162
"3161";"360471202002";16;75;43;9;11;154
"3162";"360471208001";25;15;186;24;40;290
"3163";"360471208002";120;45;240;35;47;487
"3164";"360471208003";41;2;1;3;6;53
"3165";"360471208004";9;0;2;1;0;12
"3166";"360471208005";108;23;178;95;26;430
"3167";"360471210001";82;9;9;6;1;107
"3168";"360471210002";67;2;3;3;1;76
"3169";"360471214001";175;49;8;3;5;240
"3170";"360471214002";35;9;6;9;5;64
"3171";"360471220001";154;47;264;132;35;632
"3172";"360471220002";338;77;345;174;57;991
"3173";"360471237001";28;57;116;22;36;259
"3174";"360471237002";14;9;126;9;30;188
"3175";"360471237003";39;37;185;27;111;399
"3176";"360471502001";12;8;118;20;17;175
"3177";"360471502002";4;8;61;10;14;97
"3178";"360471502003";13;50;114;11;22;210
"3179";"360471522001";50;19;213;104;51;437
"3180";"360471522002";20;23;280;49;38;410
"3181";"360471522003";41;19;178;42;32;312
"3182";"360594043002";0;20;0;0;4;24
"3183";"360594043003";0;0;3;1;0;4
"3184";"360610001001";0;0;0;0;1;1
"3185";"360610002011";52;11;33;9;20;125
"3186";"360610002012";48;26;68;9;13;164
"3187";"360610002020";1;1;1;0;1;4
"3188";"360610002021";95;108;42;19;29;293
"3189";"360610002022";30;8;16;5;5;64
"3190";"360610002023";342;57;6;0;7;412
"3191";"360610002024";126;18;17;1;4;166
"3192";"360610002025";23;63;46;8;19;159
"3193";"360610006001";24;49;33;10;61;177
"3194";"360610006002";342;57;69;2;22;492
"3195";"360610006003";31;59;54;8;78;230
"3196";"360610006004";22;27;20;1;34;104
"3197";"360610006005";189;79;175;2;5;450
"3198";"360610006006";23;60;118;2;6;209
"3199";"360610007001";142;418;339;13;443;1355
"3200";"360610008001";54;29;193;1;85;362
"3201";"360610008002";42;21;71;6;35;175
"3202";"360610008003";39;16;18;4;37;114
"3203";"360610008004";9;7;2;0;8;26
"3204";"360610008005";9;24;10;0;59;102
"3205";"360610008006";49;283;119;12;151;614
"3206";"360610009001";50;259;486;15;386;1196
"3207";"360610010011";7;23;31;10;15;86
"3208";"360610010021";99;2;21;2;6;130
"3209";"360610010022";51;3;1;0;0;55
"3210";"360610010023";137;8;40;11;4;200
"3211";"360610012001";184;57;27;4;22;294
"3212";"360610012002";24;13;36;1;4;78
"3213";"360610012003";29;23;117;2;6;177
"3214";"360610013001";13;50;98;5;387;553
"3215";"360610013002";69;147;306;14;214;750
"3216";"360610014011";10;82;47;4;20;163
"3217";"360610014012";5;27;19;2;4;57
"3218";"360610014021";96;88;127;8;57;376
"3219";"360610014022";163;278;252;10;108;811
"3220";"360610015010";0;0;0;0;3;3
"3221";"360610015011";57;188;155;5;407;812
"3222";"360610015012";17;36;113;3;41;210
"3223";"360610015013";19;97;86;15;58;275
"3224";"360610015021";140;287;316;14;919;1676
"3225";"360610015022";68;192;85;7;113;465
"3226";"360610016001";32;59;153;6;76;326
"3227";"360610016002";22;25;13;6;51;117
"3228";"360610016003";23;57;79;2;71;232
"3229";"360610016004";168;126;19;4;147;464
"3230";"360610016005";74;624;253;6;186;1143
"3231";"360610018001";123;140;17;2;71;353
"3232";"360610018002";71;280;16;10;129;506
"3233";"360610018003";133;267;59;7;132;598
"3234";"360610018004";25;59;17;7;22;130
"3235";"360610018005";47;96;51;3;160;357
"3236";"360610018006";30;309;1;0;49;389
"3237";"360610018007";51;215;8;11;69;354
"3238";"360610020001";116;6;5;0;7;134
"3239";"360610020002";70;32;2;6;7;117
"3240";"360610020003";52;25;61;8;2;148
"3241";"360610021001";263;142;267;11;446;1129
"3242";"360610021002";34;81;108;13;194;430
"3243";"360610022011";222;56;266;8;49;601
"3244";"360610022012";118;168;185;2;56;529
"3245";"360610022013";337;16;27;6;13;399
"3246";"360610022014";8;1;8;0;5;22
"3247";"360610022021";560;374;116;16;102;1168
"3248";"360610024000";0;1;0;0;0;1
"3249";"360610024001";884;111;18;4;20;1037
"3250";"360610024002";213;75;8;1;2;299
"3251";"360610025001";108;57;14;1;17;197
"3252";"360610025002";88;13;23;0;13;137
"3253";"360610025003";44;3;6;0;1;54
"3254";"360610026011";464;363;38;13;69;947
"3255";"360610026012";237;235;93;15;52;632
"3256";"360610026021";171;71;100;26;44;412
"3257";"360610026022";427;179;115;21;58;800
"3258";"360610027001";10;28;114;11;47;210
"3259";"360610028001";47;18;9;5;20;99
"3260";"360610028002";86;75;84;15;27;287
"3261";"360610028003";129;287;33;26;35;510
"3262";"360610028004";132;174;49;7;38;400
"3263";"360610029001";16;70;84;3;39;212
"3264";"360610029002";41;91;36;2;98;268
"3265";"360610029003";30;59;33;0;44;166
"3266";"360610029004";34;76;262;4;35;411
"3267";"360610030011";102;424;114;6;90;736
"3268";"360610030012";108;326;59;13;155;661
"3269";"360610030013";174;74;335;10;44;637
"3270";"360610030014";128;137;107;9;51;432
"3271";"360610030021";160;147;133;15;78;533
"3272";"360610030022";181;209;32;4;76;502
"3273";"360610031001";44;216;637;14;297;1208
"3274";"360610032001";190;298;86;29;112;715
"3275";"360610032002";82;224;18;8;77;409
"3276";"360610032003";25;131;26;5;54;241
"3277";"360610032004";86;50;20;11;28;195
"3278";"360610032005";81;87;28;7;41;244
"3279";"360610032006";252;136;33;13;77;511
"3280";"360610032007";96;129;26;24;45;320
"3281";"360610033001";161;227;179;15;175;757
"3282";"360610033002";35;62;87;6;75;265
"3283";"360610033003";30;164;100;4;61;359
"3284";"360610034001";146;175;107;16;106;550
"3285";"360610034002";282;396;43;37;58;816
"3286";"360610034003";248;548;90;49;138;1073
"3287";"360610034004";161;122;197;22;189;691
"3288";"360610036011";25;61;25;0;17;128
"3289";"360610036012";29;284;75;6;72;466
"3290";"360610036013";71;166;58;7;88;390
"3291";"360610036021";91;119;65;13;112;400
"3292";"360610036022";37;172;61;17;60;347
"3293";"360610037001";35;155;250;9;50;499
"3294";"360610037002";33;42;131;6;45;257
"3295";"360610037003";22;208;160;11;91;492
"3296";"360610038001";151;358;40;7;98;654
"3297";"360610038002";57;19;5;1;22;104
"3298";"360610038003";90;139;43;14;55;341
"3299";"360610038004";141;59;10;6;59;275
"3300";"360610038005";164;40;9;15;64;292
"3301";"360610038006";78;51;3;9;28;169
"3302";"360610038007";112;86;36;30;82;346
"3303";"360610039001";84;336;91;2;63;576
"3304";"360610039002";14;57;36;1;8;116
"3305";"360610039003";16;12;7;2;6;43
"3306";"360610039004";38;107;74;4;79;302
"3307";"360610040001";217;82;77;13;49;438
"3308";"360610040002";71;36;36;9;22;174
"3309";"360610040003";88;58;17;7;45;215
"3310";"360610040004";188;29;28;5;22;272
"3311";"360610040005";99;42;29;9;73;252
"3312";"360610040006";87;35;90;18;46;276
"3313";"360610041001";66;53;25;3;67;214
"3314";"360610041002";44;114;33;3;30;224
"3315";"360610041003";42;48;13;4;72;179
"3316";"360610041004";82;136;19;2;65;304
"3317";"360610041005";66;53;32;8;51;210
"3318";"360610041006";36;103;56;5;49;249
"3319";"360610042001";92;130;278;17;97;614
"3320";"360610042002";29;88;46;6;41;210
"3321";"360610043001";142;184;71;12;205;614
"3322";"360610043002";46;126;25;5;78;280
"3323";"360610043003";91;134;227;12;129;593
"3324";"360610044001";40;10;29;2;21;102
"3325";"360610044002";56;7;55;1;2;121
"3326";"360610044003";8;3;5;2;8;26
"3327";"360610044004";20;2;11;0;57;90
"3328";"360610044005";5;6;11;0;2;24
"3329";"360610044006";10;3;2;1;2;18
"3330";"360610044007";17;12;147;2;51;229
"3331";"360610044008";9;5;12;2;31;59
"3332";"360610045001";121;212;208;10;138;689
"3333";"360610047001";40;184;34;2;23;283
"3334";"360610047002";165;335;76;11;208;795
"3335";"360610048001";6;11;21;1;12;51
"3336";"360610048002";27;5;11;1;7;51
"3337";"360610048003";11;15;9;0;10;45
"3338";"360610048004";68;46;13;2;33;162
"3339";"360610048005";71;78;15;7;78;249
"3340";"360610048006";101;18;25;1;24;169
"3341";"360610048007";0;4;4;1;13;22
"3342";"360610049001";123;381;224;18;178;924
"3343";"360610049002";142;103;40;10;47;342
"3344";"360610049003";99;120;52;3;25;299
"3345";"360610050001";18;41;22;3;13;97
"3346";"360610050002";22;35;33;4;41;135
"3347";"360610050003";17;111;47;7;75;257
"3348";"360610050004";8;40;19;5;67;139
"3349";"360610050005";24;31;19;6;32;112
"3350";"360610052001";48;242;107;14;152;563
"3351";"360610052002";58;518;106;20;173;875
"3352";"360610054001";64;109;86;9;158;426
"3353";"360610054002";14;24;34;0;60;132
"3354";"360610054003";27;39;9;12;83;170
"3355";"360610055011";21;125;34;2;98;280
"3356";"360610055012";0;21;25;3;9;58
"3357";"360610055013";4;13;12;3;13;45
"3358";"360610055021";31;67;45;4;43;190
"3359";"360610055022";93;339;99;13;188;732
"3360";"360610056001";41;74;131;6;118;370
"3361";"360610056002";10;221;27;4;112;374
"3362";"360610056003";38;19;28;3;48;136
"3363";"360610057001";6;47;75;3;91;222
"3364";"360610057002";36;98;38;6;145;323
"3365";"360610058001";77;366;192;10;407;1052
"3366";"360610059001";7;22;10;2;50;91
"3367";"360610059002";3;71;23;2;28;127
"3368";"360610059003";40;99;9;3;68;219
"3369";"360610059004";10;8;9;1;32;60
"3370";"360610059005";9;18;14;1;14;56
"3371";"360610060001";203;16;20;7;14;260
"3372";"360610060002";12;9;18;1;21;61
"3373";"360610060003";0;0;6;1;3;10
"3374";"360610061001";67;95;300;13;74;549
"3375";"360610061002";14;46;61;1;41;163
"3376";"360610061003";56;271;333;18;195;873
"3377";"360610062001";3;50;235;2;137;427
"3378";"360610062002";11;11;26;2;15;65
"3379";"360610063001";68;57;136;10;115;386
"3380";"360610063002";28;16;63;12;42;161
"3381";"360610063003";42;24;34;2;30;132
"3382";"360610063004";24;42;6;1;30;103
"3383";"360610063005";13;37;20;2;48;120
"3384";"360610064001";16;32;25;6;42;121
"3385";"360610064002";340;22;62;4;14;442
"3386";"360610064003";6;41;26;1;13;87
"3387";"360610064004";53;39;100;6;49;247
"3388";"360610064005";23;15;26;1;24;89
"3389";"360610064006";8;16;36;3;45;108
"3390";"360610065001";59;275;44;19;195;592
"3391";"360610065002";70;371;55;10;45;551
"3392";"360610065003";39;193;50;14;36;332
"3393";"360610065004";116;320;27;9;219;691
"3394";"360610065005";79;318;41;1;40;479
"3395";"360610066001";110;249;39;1;38;437
"3396";"360610066002";108;65;15;1;37;226
"3397";"360610066003";53;117;44;1;71;286
"3398";"360610066004";64;8;36;1;21;130
"3399";"360610066005";48;105;22;1;29;205
"3400";"360610066006";6;8;26;2;16;58
"3401";"360610066007";33;9;26;0;16;84
"3402";"360610066008";77;86;135;3;111;412
"3403";"360610066009";20;22;45;2;47;136
"3404";"360610067001";68;238;31;10;59;406
"3405";"360610067002";108;147;91;11;60;417
"3406";"360610067003";60;67;98;14;42;281
"3407";"360610067004";54;61;73;16;46;250
"3408";"360610068001";24;90;173;1;68;356
"3409";"360610068002";18;22;18;1;57;116
"3410";"360610068003";76;104;8;1;21;210
"3411";"360610068004";290;72;39;7;27;435
"3412";"360610068005";15;21;44;1;22;103
"3413";"360610068006";103;126;28;3;45;305
"3414";"360610069001";44;114;162;9;80;409
"3415";"360610070001";108;97;18;1;42;266
"3416";"360610070002";54;80;44;4;54;236
"3417";"360610070003";62;27;60;5;51;205
"3418";"360610070004";5;9;38;0;23;75
"3419";"360610070005";4;3;9;0;4;20
"3420";"360610070006";111;6;29;0;26;172
"3421";"360610071001";8;20;28;4;85;145
"3422";"360610071002";13;14;61;4;56;148
"3423";"360610071003";25;62;28;2;49;166
"3424";"360610071004";67;41;21;8;24;161
"3425";"360610071005";43;91;15;5;81;235
"3426";"360610072001";4;13;13;0;9;39
"3427";"360610072002";76;98;88;11;128;401
"3428";"360610072003";22;60;80;11;157;330
"3429";"360610072004";48;186;75;9;76;394
"3430";"360610072005";20;30;10;0;72;132
"3431";"360610072006";22;14;9;0;18;63
"3432";"360610072007";11;15;10;0;11;47
"3433";"360610073001";58;18;12;14;16;118
"3434";"360610073002";42;73;18;8;13;154
"3435";"360610073003";102;88;32;9;19;250
"3436";"360610073004";116;255;29;13;44;457
"3437";"360610073005";54;11;32;3;6;106
"3438";"360610073006";52;174;44;12;40;322
"3439";"360610074001";36;62;68;3;95;264
"3440";"360610074002";9;79;24;0;54;166
"3441";"360610074003";33;114;373;1;151;672
"3442";"360610075001";19;56;56;4;31;166
"3443";"360610075002";20;24;41;12;10;107
"3444";"360610075003";32;158;41;17;26;274
"3445";"360610076001";54;125;159;10;244;592
"3446";"360610076002";21;85;189;9;111;415
"3447";"360610077001";66;438;64;7;106;681
"3448";"360610077002";38;41;11;3;11;104
"3449";"360610077003";58;138;40;2;122;360
"3450";"360610077004";23;55;27;2;66;173
"3451";"360610077005";51;27;13;10;48;149
"3452";"360610078001";16;43;6;1;10;76
"3453";"360610078002";18;106;6;0;12;142
"3454";"360610078003";10;32;3;1;7;53
"3455";"360610078004";55;42;28;1;44;170
"3456";"360610078005";28;10;22;2;17;79
"3457";"360610078006";26;88;9;0;11;134
"3458";"360610078007";27;43;18;0;1;89
"3459";"360610079001";8;123;45;4;57;237
"3460";"360610079002";28;18;16;2;10;74
"3461";"360610079003";37;90;44;8;19;198
"3462";"360610079004";10;19;19;9;22;79
"3463";"360610080001";38;82;20;1;61;202
"3464";"360610080002";23;151;34;7;70;285
"3465";"360610080003";45;12;18;6;7;88
"3466";"360610080004";34;32;10;0;16;92
"3467";"360610080005";18;17;20;2;16;73
"3468";"360610081001";36;34;29;5;73;177
"3469";"360610081002";54;50;44;5;40;193
"3470";"360610081003";17;42;40;5;79;183
"3471";"360610081004";34;59;33;26;193;345
"3472";"360610081005";54;26;29;25;21;155
"3473";"360610081006";95;80;45;5;42;267
"3474";"360610082001";23;229;63;7;157;479
"3475";"360610082002";9;55;14;0;93;171
"3476";"360610082003";28;22;10;1;20;81
"3477";"360610083001";111;169;213;7;88;588
"3478";"360610083002";22;99;534;5;32;692
"3479";"360610083003";163;111;92;4;41;411
"3480";"360610084001";3;27;30;1;52;113
"3481";"360610084002";45;166;222;5;184;622
"3482";"360610086011";9;12;43;0;38;102
"3483";"360610086012";42;20;107;2;20;191
"3484";"360610086020";0;0;1;0;0;1
"3485";"360610086021";1;10;31;0;10;52
"3486";"360610086031";5;4;8;2;25;44
"3487";"360610086032";3;4;12;0;5;24
"3488";"360610086033";1;3;16;3;11;34
"3489";"360610086034";38;5;49;4;7;103
"3490";"360610087001";64;127;92;9;65;357
"3491";"360610087002";56;100;10;18;22;206
"3492";"360610087003";38;28;12;16;31;125
"3493";"360610087004";59;143;22;10;32;266
"3494";"360610087005";31;27;16;9;19;102
"3495";"360610088001";15;63;164;1;65;308
"3496";"360610088002";24;75;19;2;12;132
"3497";"360610088003";11;12;7;1;16;47
"3498";"360610088004";3;21;9;0;3;36
"3499";"360610088005";28;5;87;0;5;125
"3500";"360610088006";2;6;11;1;20;40
"3501";"360610088007";10;3;7;0;2;22
"3502";"360610089001";71;114;21;3;13;222
"3503";"360610089002";60;54;60;15;40;229
"3504";"360610089003";157;32;61;3;15;268
"3505";"360610089004";29;36;27;3;20;115
"3506";"360610089005";38;23;14;1;22;98
"3507";"360610090001";29;31;222;0;54;336
"3508";"360610090002";67;17;51;0;6;141
"3509";"360610090003";4;28;101;0;14;147
"3510";"360610090004";26;29;35;1;7;98
"3511";"360610090005";33;30;32;0;20;115
"3512";"360610090006";17;8;12;0;13;50
"3513";"360610091001";112;304;124;30;309;879
"3514";"360610091002";90;115;50;22;57;334
"3515";"360610091003";58;51;6;15;70;200
"3516";"360610091004";35;52;6;19;89;201
"3517";"360610092001";37;250;137;5;316;745
"3518";"360610093001";21;22;23;5;23;94
"3519";"360610093002";42;104;30;25;61;262
"3520";"360610093003";6;10;11;2;6;35
"3521";"360610093004";10;0;1;0;6;17
"3522";"360610093005";28;18;7;14;35;102
"3523";"360610093006";192;42;21;0;32;287
"3524";"360610093007";36;4;14;4;25;83
"3525";"360610094001";5;25;148;3;374;555
"3526";"360610095001";90;153;136;15;334;728
"3527";"360610095002";54;50;72;17;133;326
"3528";"360610096001";12;152;171;10;522;867
"3529";"360610097001";7;21;83;7;31;149
"3530";"360610097002";68;24;34;2;48;176
"3531";"360610097003";1;0;4;0;1;6
"3532";"360610097004";621;30;35;11;32;729
"3533";"360610098001";12;69;53;1;29;164
"3534";"360610098002";46;76;83;3;25;233
"3535";"360610098003";91;51;27;5;23;197
"3536";"360610098004";22;5;46;1;24;98
"3537";"360610098005";12;9;10;1;6;38
"3538";"360610098006";40;86;105;1;54;286
"3539";"360610098007";30;17;93;1;11;152
"3540";"360610099001";324;510;883;20;410;2147
"3541";"360610100001";11;130;114;7;66;328
"3542";"360610100002";18;30;75;5;64;192
"3543";"360610101001";43;108;123;9;535;818
"3544";"360610102001";11;37;188;10;582;828
"3545";"360610103001";96;125;153;8;130;512
"3546";"360610104001";16;107;233;7;764;1127
"3547";"360610106011";642;7;20;2;18;689
"3548";"360610106012";25;22;37;0;14;98
"3549";"360610106013";18;5;18;0;5;46
"3550";"360610106014";0;8;13;0;4;25
"3551";"360610106015";4;1;5;0;7;17
"3552";"360610106016";1;4;53;3;5;66
"3553";"360610106020";0;0;0;0;3;3
"3554";"360610106021";10;13;7;2;28;60
"3555";"360610106022";20;53;57;12;70;212
"3556";"360610106023";1;7;15;2;18;43
"3557";"360610108001";30;32;21;0;20;103
"3558";"360610108002";16;29;21;4;12;82
"3559";"360610108003";8;21;37;2;15;83
"3560";"360610108004";5;6;8;1;6;26
"3561";"360610108005";107;8;25;6;16;162
"3562";"360610108006";33;40;41;4;40;158
"3563";"360610108007";15;36;41;6;50;148
"3564";"360610109001";21;368;138;4;431;962
"3565";"360610110001";7;41;34;3;24;109
"3566";"360610110002";14;22;26;0;24;86
"3567";"360610110003";38;78;37;10;53;216
"3568";"360610110004";13;68;32;1;30;144
"3569";"360610110005";22;160;16;0;17;215
"3570";"360610110006";48;92;71;8;93;312
"3571";"360610111001";65;134;109;3;122;433
"3572";"360610111002";23;34;35;3;89;184
"3573";"360610111003";40;39;40;1;30;150
"3574";"360610112011";12;28;71;2;144;257
"3575";"360610112021";4;56;106;1;122;289
"3576";"360610112031";11;11;16;4;138;180
"3577";"360610112032";2;4;17;5;71;99
"3578";"360610113001";14;263;266;9;758;1310
"3579";"360610114011";2;16;17;1;31;67
"3580";"360610114012";0;8;48;2;52;110
"3581";"360610114021";28;35;59;1;120;243
"3582";"360610114022";12;21;37;6;100;176
"3583";"360610115001";22;128;61;6;185;402
"3584";"360610115002";41;133;64;8;141;387
"3585";"360610116001";2;19;37;1;37;96
"3586";"360610116002";10;11;32;2;14;69
"3587";"360610116003";14;15;8;0;12;49
"3588";"360610117000";0;1;0;0;0;1
"3589";"360610117001";22;74;45;14;31;186
"3590";"360610118001";6;4;7;0;6;23
"3591";"360610118002";0;6;10;0;6;22
"3592";"360610118003";4;7;25;1;10;47
"3593";"360610118004";33;34;99;8;36;210
"3594";"360610118005";19;3;18;5;19;64
"3595";"360610118006";71;12;69;0;25;177
"3596";"360610118007";5;10;14;1;8;38
"3597";"360610118008";1;3;38;0;17;59
"3598";"360610119001";11;128;100;5;103;347
"3599";"360610119002";139;69;51;3;82;344
"3600";"360610120001";1;11;32;5;22;71
"3601";"360610120002";2;6;41;9;96;154
"3602";"360610120003";6;20;39;3;34;102
"3603";"360610120004";5;15;54;2;101;177
"3604";"360610121001";55;86;31;11;98;281
"3605";"360610121002";23;12;20;12;10;77
"3606";"360610121003";37;35;24;6;79;181
"3607";"360610121004";59;88;63;5;83;298
"3608";"360610121005";80;91;13;5;40;229
"3609";"360610121006";42;42;7;7;50;148
"3610";"360610122001";13;11;24;4;14;66
"3611";"360610122002";21;5;20;8;13;67
"3612";"360610122003";3;6;9;4;26;48
"3613";"360610122004";3;13;16;0;25;57
"3614";"360610124001";63;23;18;7;43;154
"3615";"360610124002";24;5;35;1;10;75
"3616";"360610124003";4;8;13;0;12;37
"3617";"360610124004";30;33;45;4;6;118
"3618";"360610124005";11;1;11;0;9;32
"3619";"360610124006";9;12;14;0;12;47
"3620";"360610124007";0;7;7;4;4;22
"3621";"360610124008";0;2;8;0;2;12
"3622";"360610125001";34;134;67;7;178;420
"3623";"360610125002";37;218;98;5;94;452
"3624";"360610126001";59;91;95;5;39;289
"3625";"360610126002";18;13;33;2;34;100
"3626";"360610126003";2;2;33;1;5;43
"3627";"360610126004";20;20;91;3;10;144
"3628";"360610126005";6;11;33;3;27;80
"3629";"360610126006";42;21;28;2;21;114
"3630";"360610126007";31;8;25;4;11;79
"3631";"360610126008";21;8;71;0;35;135
"3632";"360610127001";40;24;36;2;33;135
"3633";"360610127002";120;162;67;10;70;429
"3634";"360610127003";114;86;22;2;53;277
"3635";"360610127004";101;300;449;10;90;950
"3636";"360610127005";5;36;136;4;45;226
"3637";"360610128001";14;21;50;6;21;112
"3638";"360610128002";5;12;27;1;9;54
"3639";"360610128003";11;12;35;9;20;87
"3640";"360610128004";5;9;53;11;44;122
"3641";"360610128005";12;12;28;3;15;70
"3642";"360610129001";140;266;148;42;111;707
"3643";"360610129002";228;218;280;12;97;835
"3644";"360610130001";11;18;42;1;11;83
"3645";"360610130002";11;11;49;1;18;90
"3646";"360610130003";5;20;32;1;29;87
"3647";"360610130004";3;3;49;1;28;84
"3648";"360610131001";10;127;138;5;75;355
"3649";"360610131002";34;166;70;11;101;382
"3650";"360610132001";38;6;24;3;13;84
"3651";"360610132002";58;33;31;1;19;142
"3652";"360610132003";18;36;29;2;13;98
"3653";"360610132004";105;46;46;6;29;232
"3654";"360610132005";56;15;10;1;16;98
"3655";"360610132006";37;8;30;0;11;86
"3656";"360610132007";46;11;13;4;11;85
"3657";"360610133001";112;13;20;1;27;173
"3658";"360610133002";78;77;80;5;114;354
"3659";"360610133003";107;439;62;13;70;691
"3660";"360610133004";46;79;39;2;43;209
"3661";"360610133005";98;68;72;2;48;288
"3662";"360610134001";27;72;18;1;12;130
"3663";"360610134002";12;7;12;2;3;36
"3664";"360610134003";31;13;21;0;12;77
"3665";"360610134004";3;8;4;1;12;28
"3666";"360610134005";34;209;30;0;19;292
"3667";"360610134006";18;21;17;6;67;129
"3668";"360610134007";40;83;37;8;25;193
"3669";"360610134008";21;19;26;1;143;210
"3670";"360610134009";12;23;16;1;20;72
"3671";"360610135001";179;110;146;12;119;566
"3672";"360610135002";73;105;155;9;87;429
"3673";"360610136001";123;31;20;2;17;193
"3674";"360610136002";29;11;28;1;17;86
"3675";"360610136003";43;10;41;2;14;110
"3676";"360610136004";21;9;54;1;29;114
"3677";"360610136005";4;12;23;1;52;92
"3678";"360610136006";29;3;18;4;6;60
"3679";"360610136007";39;30;20;5;14;108
"3680";"360610136008";75;25;18;5;13;136
"3681";"360610137001";6;21;33;0;39;99
"3682";"360610137002";12;35;334;0;52;433
"3683";"360610137003";14;249;155;5;116;539
"3684";"360610137004";7;58;311;5;93;474
"3685";"360610137005";3;14;29;4;25;75
"3686";"360610137006";29;314;53;5;48;449
"3687";"360610138001";38;26;13;6;8;91
"3688";"360610138002";72;38;12;0;17;139
"3689";"360610138003";40;11;32;8;13;104
"3690";"360610138004";68;120;22;5;43;258
"3691";"360610138005";52;23;21;1;11;108
"3692";"360610138006";131;15;17;3;14;180
"3693";"360610138007";11;3;20;5;11;50
"3694";"360610138008";198;10;52;0;10;270
"3695";"360610138009";23;20;18;0;16;77
"3696";"360610139001";20;53;18;3;43;137
"3697";"360610139002";17;59;16;2;34;128
"3698";"360610139003";93;88;114;6;52;353
"3699";"360610139004";35;20;41;2;16;114
"3700";"360610139005";20;145;53;0;26;244
"3701";"360610139006";6;25;17;3;25;76
"3702";"360610139007";34;19;105;0;48;206
"3703";"360610140001";18;19;10;4;21;72
"3704";"360610140002";72;25;13;5;19;134
"3705";"360610140003";10;13;30;2;37;92
"3706";"360610140004";4;7;36;5;13;65
"3707";"360610140005";15;15;43;9;13;95
"3708";"360610140006";10;3;19;1;7;40
"3709";"360610142001";6;2;11;0;13;32
"3710";"360610142002";9;18;19;6;10;62
"3711";"360610142003";4;10;11;2;6;33
"3712";"360610142004";3;11;42;0;15;71
"3713";"360610142005";7;25;13;1;8;54
"3714";"360610142006";26;131;15;0;9;181
"3715";"360610143001";26;723;173;3;416;1341
"3716";"360610144011";8;4;19;0;4;35
"3717";"360610144012";7;5;7;0;8;27
"3718";"360610144013";16;13;5;1;11;46
"3719";"360610144014";23;29;11;2;8;73
"3720";"360610144021";10;7;24;2;11;54
"3721";"360610144022";27;8;5;1;9;50
"3722";"360610144023";29;11;10;1;3;54
"3723";"360610144024";197;27;49;3;23;299
"3724";"360610144025";29;16;19;1;6;71
"3725";"360610145001";15;15;239;5;29;303
"3726";"360610145002";4;7;14;2;9;36
"3727";"360610145003";9;78;228;8;598;921
"3728";"360610145004";2;25;102;0;34;163
"3729";"360610146011";18;30;26;10;27;111
"3730";"360610146012";21;112;10;9;24;176
"3731";"360610146013";21;106;17;7;28;179
"3732";"360610146014";78;92;30;2;27;229
"3733";"360610146021";15;34;24;3;17;93
"3734";"360610146022";13;28;39;0;16;96
"3735";"360610146023";43;41;13;1;11;109
"3736";"360610146024";40;29;11;1;14;95
"3737";"360610146025";9;45;30;5;11;100
"3738";"360610146026";43;19;26;5;22;115
"3739";"360610147001";8;12;66;2;36;124
"3740";"360610148011";20;17;19;2;18;76
"3741";"360610148012";13;32;89;2;73;209
"3742";"360610148021";62;19;29;4;20;134
"3743";"360610148022";18;33;50;4;102;207
"3744";"360610148023";9;34;28;0;21;92
"3745";"360610148024";10;34;19;3;8;74
"3746";"360610148025";0;10;12;1;21;44
"3747";"360610149001";4;76;80;7;455;622
"3748";"360610149002";9;20;154;0;10;193
"3749";"360610149003";23;22;116;2;102;265
"3750";"360610149004";2;13;48;1;263;327
"3751";"360610149005";2;4;26;0;206;238
"3752";"360610150011";2;5;12;16;8;43
"3753";"360610150012";4;11;20;3;18;56
"3754";"360610150021";5;6;52;1;11;75
"3755";"360610150022";32;8;16;1;5;62
"3756";"360610150023";6;4;19;1;3;33
"3757";"360610150024";9;22;28;0;12;71
"3758";"360610151001";78;142;15;3;8;246
"3759";"360610151002";475;38;31;0;7;551
"3760";"360610151003";36;40;29;6;13;124
"3761";"360610151004";55;52;132;11;46;296
"3762";"360610152001";38;8;1;0;8;55
"3763";"360610152002";297;40;26;0;10;373
"3764";"360610152003";2;8;24;1;10;45
"3765";"360610152004";9;13;8;0;17;47
"3766";"360610152005";15;4;24;2;7;52
"3767";"360610152006";8;16;20;1;23;68
"3768";"360610153001";36;17;31;0;86;170
"3769";"360610153002";25;19;33;1;301;379
"3770";"360610153003";11;23;63;1;407;505
"3771";"360610153004";9;22;70;2;64;167
"3772";"360610153005";30;13;13;1;17;74
"3773";"360610153006";62;34;328;14;23;461
"3774";"360610153007";17;65;236;5;30;353
"3775";"360610154001";76;78;23;1;37;215
"3776";"360610154002";19;7;9;3;5;43
"3777";"360610154003";32;20;18;3;19;92
"3778";"360610154004";24;15;21;0;16;76
"3779";"360610154005";117;33;9;4;9;172
"3780";"360610154006";77;17;13;5;11;123
"3781";"360610154007";4;12;22;0;11;49
"3782";"360610154008";48;21;36;9;17;131
"3783";"360610154009";5;9;16;0;12;42
"3784";"360610155001";4;3;6;4;12;29
"3785";"360610155002";1;7;31;0;9;48
"3786";"360610155003";0;4;3;0;6;13
"3787";"360610155004";0;0;16;0;1;17
"3788";"360610155005";2;1;10;0;1;14
"3789";"360610155006";23;39;52;4;24;142
"3790";"360610156011";130;17;33;6;8;194
"3791";"360610156012";24;43;55;10;16;148
"3792";"360610156013";22;22;14;8;24;90
"3793";"360610156014";5;8;11;0;19;43
"3794";"360610156021";132;53;83;3;53;324
"3795";"360610157001";25;50;35;7;9;126
"3796";"360610157002";12;39;22;0;38;111
"3797";"360610157003";22;21;30;6;15;94
"3798";"360610157004";25;7;28;4;25;89
"3799";"360610157005";58;52;13;3;19;145
"3800";"360610157006";28;99;15;15;49;206
"3801";"360610157007";8;78;20;23;71;200
"3802";"360610157008";16;14;9;5;23;67
"3803";"360610158011";19;122;60;4;20;225
"3804";"360610158012";73;36;7;0;21;137
"3805";"360610158013";7;8;10;0;18;43
"3806";"360610158014";5;12;18;1;14;50
"3807";"360610158021";37;30;50;1;14;132
"3808";"360610158022";69;60;50;0;17;196
"3809";"360610159001";22;7;128;2;7;166
"3810";"360610159002";15;3;89;6;37;150
"3811";"360610159003";10;5;21;0;11;47
"3812";"360610159004";14;38;16;1;75;144
"3813";"360610159005";41;60;28;1;94;224
"3814";"360610159006";47;42;27;4;74;194
"3815";"360610159007";15;19;12;3;53;102
"3816";"360610160011";12;7;16;0;12;47
"3817";"360610160012";2;5;21;0;11;39
"3818";"360610160013";1;1;15;0;11;28
"3819";"360610160014";12;6;16;1;4;39
"3820";"360610160021";9;6;82;2;8;107
"3821";"360610160022";6;125;14;0;8;153
"3822";"360610161001";30;40;14;5;14;103
"3823";"360610161002";17;4;46;1;7;75
"3824";"360610161003";26;26;53;6;27;138
"3825";"360610161004";23;46;154;3;9;235
"3826";"360610161005";44;24;118;2;44;232
"3827";"360610161006";55;32;12;0;7;106
"3828";"360610162001";9;12;10;4;3;38
"3829";"360610162002";22;4;5;5;3;39
"3830";"360610162003";192;27;16;3;6;244
"3831";"360610162004";116;121;20;0;20;277
"3832";"360610162005";102;65;38;4;12;221
"3833";"360610163000";0;0;1;0;3;4
"3834";"360610163001";17;12;48;3;12;92
"3835";"360610163002";17;34;83;0;5;139
"3836";"360610163003";54;39;16;6;57;172
"3837";"360610163004";15;25;20;0;34;94
"3838";"360610163005";6;67;26;1;73;173
"3839";"360610164001";40;34;24;3;16;117
"3840";"360610164002";123;181;42;1;22;369
"3841";"360610164003";132;18;14;2;8;174
"3842";"360610164004";45;55;12;0;4;116
"3843";"360610165001";17;12;64;6;40;139
"3844";"360610165002";17;6;18;1;4;46
"3845";"360610165003";15;27;17;4;11;74
"3846";"360610165004";56;42;75;3;7;183
"3847";"360610165005";29;41;24;1;12;107
"3848";"360610166001";104;104;13;3;19;243
"3849";"360610166002";58;58;137;2;18;273
"3850";"360610166003";83;95;22;3;10;213
"3851";"360610166004";66;79;14;3;13;175
"3852";"360610166005";104;81;20;1;7;213
"3853";"360610166006";308;116;25;2;14;465
"3854";"360610167001";15;18;76;1;6;116
"3855";"360610167002";6;16;16;2;7;47
"3856";"360610167003";13;29;21;0;99;162
"3857";"360610167004";50;68;53;3;28;202
"3858";"360610167005";13;42;21;5;49;130
"3859";"360610168001";231;43;54;0;12;340
"3860";"360610168002";191;51;52;1;31;326
"3861";"360610168003";19;22;43;3;32;119
"3862";"360610169001";18;41;22;1;21;103
"3863";"360610169002";73;113;30;2;7;225
"3864";"360610169003";58;65;27;1;40;191
"3865";"360610169004";81;25;98;9;23;236
"3866";"360610169005";36;9;42;10;7;104
"3867";"360610169006";32;2;15;6;4;59
"3868";"360610170001";11;10;93;2;8;124
"3869";"360610170002";584;59;41;1;25;710
"3870";"360610170003";48;155;135;6;33;377
"3871";"360610170004";19;58;71;8;16;172
"3872";"360610170005";84;157;130;5;16;392
"3873";"360610171001";24;18;41;6;57;146
"3874";"360610171002";55;47;43;2;95;242
"3875";"360610171003";10;19;23;4;32;88
"3876";"360610171004";8;16;10;1;0;35
"3877";"360610171005";18;25;24;7;10;84
"3878";"360610171006";6;12;14;0;6;38
"3879";"360610172001";65;164;48;7;48;332
"3880";"360610172002";157;27;4;2;11;201
"3881";"360610172003";50;38;128;0;6;222
"3882";"360610172004";170;195;66;2;35;468
"3883";"360610172005";18;23;21;2;32;96
"3884";"360610173001";23;35;18;3;12;91
"3885";"360610173002";7;11;11;0;12;41
"3886";"360610173003";126;46;27;23;21;243
"3887";"360610173004";47;49;60;4;10;170
"3888";"360610173005";7;13;10;3;9;42
"3889";"360610173006";50;16;23;1;7;97
"3890";"360610173007";20;11;31;3;15;80
"3891";"360610174011";96;33;14;4;15;162
"3892";"360610174012";179;61;27;5;35;307
"3893";"360610174013";74;113;19;0;28;234
"3894";"360610174021";128;126;97;10;36;397
"3895";"360610175001";14;32;21;1;24;92
"3896";"360610175002";5;25;59;1;7;97
"3897";"360610175003";48;15;16;0;23;102
"3898";"360610175004";6;14;22;5;26;73
"3899";"360610175005";11;15;16;2;14;58
"3900";"360610175006";34;30;30;8;15;117
"3901";"360610175007";14;37;27;3;42;123
"3902";"360610177001";50;39;20;5;7;121
"3903";"360610177002";65;29;15;0;2;111
"3904";"360610177003";30;33;10;0;6;79
"3905";"360610177004";1940;76;10;4;8;2038
"3906";"360610177005";27;42;12;2;8;91
"3907";"360610177006";181;10;13;4;2;210
"3908";"360610177007";23;11;14;0;10;58
"3909";"360610177008";43;16;14;0;10;83
"3910";"360610178001";106;102;38;6;20;272
"3911";"360610178002";45;122;114;4;20;305
"3912";"360610178003";210;191;71;12;29;513
"3913";"360610179001";32;32;32;8;22;126
"3914";"360610179002";25;6;34;2;13;80
"3915";"360610179003";27;19;5;1;6;58
"3916";"360610179004";35;72;15;1;21;144
"3917";"360610179005";15;4;7;6;19;51
"3918";"360610179006";97;165;24;8;42;336
"3919";"360610179007";14;20;20;5;19;78
"3920";"360610180001";240;214;40;5;27;526
"3921";"360610180002";193;168;182;7;28;578
"3922";"360610180003";209;112;76;4;40;441
"3923";"360610180004";78;14;7;3;1;103
"3924";"360610181001";16;15;24;6;19;80
"3925";"360610181002";17;14;13;1;10;55
"3926";"360610181003";30;35;17;4;13;99
"3927";"360610181004";27;7;10;2;3;49
"3928";"360610181005";10;7;18;0;12;47
"3929";"360610181006";11;6;4;1;11;33
"3930";"360610182001";105;178;11;0;31;325
"3931";"360610182002";183;72;22;3;24;304
"3932";"360610182003";60;154;40;2;106;362
"3933";"360610182004";132;28;43;3;7;213
"3934";"360610182005";219;73;13;1;17;323
"3935";"360610183001";43;98;21;11;20;193
"3936";"360610183002";3;7;3;3;4;20
"3937";"360610183003";112;23;1;0;9;145
"3938";"360610183004";18;42;29;0;32;121
"3939";"360610183005";8;65;12;1;36;122
"3940";"360610183006";74;106;42;0;49;271
"3941";"360610183007";30;37;42;3;29;141
"3942";"360610184001";169;182;124;27;49;551
"3943";"360610184002";15;31;23;2;7;78
"3944";"360610184003";140;45;16;2;4;207
"3945";"360610184004";167;30;19;4;7;227
"3946";"360610185001";12;16;13;6;3;50
"3947";"360610185002";29;49;69;3;20;170
"3948";"360610185003";9;3;3;0;4;19
"3949";"360610186001";274;41;40;6;8;369
"3950";"360610186002";178;275;65;11;46;575
"3951";"360610186003";395;247;20;16;6;684
"3952";"360610187001";44;55;22;7;23;151
"3953";"360610187002";50;9;19;3;10;91
"3954";"360610187003";23;21;21;2;11;78
"3955";"360610187004";16;30;17;7;17;87
"3956";"360610187005";21;92;32;1;20;166
"3957";"360610187006";25;48;61;9;22;165
"3958";"360610188001";130;86;95;0;11;322
"3959";"360610188002";98;299;113;4;29;543
"3960";"360610188003";94;228;44;4;32;402
"3961";"360610188004";258;41;32;3;39;373
"3962";"360610189001";57;57;36;2;17;169
"3963";"360610189002";155;81;42;4;32;314
"3964";"360610189003";295;30;26;2;8;361
"3965";"360610189004";50;79;21;1;24;175
"3966";"360610189005";61;42;54;2;30;189
"3967";"360610189006";410;148;51;0;10;619
"3968";"360610190001";142;436;103;20;71;772
"3969";"360610191001";49;54;28;2;4;137
"3970";"360610191002";16;104;53;2;23;198
"3971";"360610191003";44;11;4;0;3;62
"3972";"360610191004";123;13;16;4;8;164
"3973";"360610191005";73;164;52;6;48;343
"3974";"360610191006";87;66;35;9;39;236
"3975";"360610192001";480;212;89;3;22;806
"3976";"360610192002";64;121;12;0;3;200
"3977";"360610193001";50;201;17;0;20;288
"3978";"360610193002";107;200;22;0;9;338
"3979";"360610193003";130;75;16;5;12;238
"3980";"360610193004";64;63;40;2;19;188
"3981";"360610193005";81;150;21;2;28;282
"3982";"360610193006";63;106;36;3;28;236
"3983";"360610194001";353;56;40;3;32;484
"3984";"360610194002";47;47;225;4;21;344
"3985";"360610194003";52;36;72;0;98;258
"3986";"360610194004";72;25;162;5;44;308
"3987";"360610195001";25;25;22;0;14;86
"3988";"360610195002";32;301;19;3;21;376
"3989";"360610195003";126;224;45;10;54;459
"3990";"360610195004";22;51;14;2;9;98
"3991";"360610195005";59;21;26;0;25;131
"3992";"360610196001";187;39;45;1;13;285
"3993";"360610196002";33;69;58;13;38;211
"3994";"360610196003";62;92;113;6;157;430
"3995";"360610197011";46;101;204;4;119;474
"3996";"360610197021";172;107;183;8;40;510
"3997";"360610198001";37;162;117;8;105;429
"3998";"360610198002";2;37;18;3;23;83
"3999";"360610199001";26;21;38;4;42;131
"4000";"360610199002";12;25;29;1;40;107
"4001";"360610199003";42;11;10;4;5;72
"4002";"360610199004";18;10;10;4;10;52
"4003";"360610199005";52;16;50;0;38;156
"4004";"360610199006";25;47;27;4;66;169
"4005";"360610200001";247;60;19;2;31;359
"4006";"360610200002";154;309;139;11;131;744
"4007";"360610201011";10;6;29;2;18;65
"4008";"360610201021";291;171;64;3;24;553
"4009";"360610201022";132;192;30;0;32;386
"4010";"360610201023";6;101;15;0;6;128
"4011";"360610201024";52;80;15;3;25;175
"4012";"360610203001";6;14;9;3;4;36
"4013";"360610203002";0;9;36;1;14;60
"4014";"360610205001";12;16;30;9;11;78
"4015";"360610205002";18;8;9;1;8;44
"4016";"360610205003";3;6;66;1;15;91
"4017";"360610206001";171;197;73;14;46;501
"4018";"360610206002";235;199;115;64;93;706
"4019";"360610207011";14;11;40;4;3;72
"4020";"360610207012";16;9;30;0;3;58
"4021";"360610208001";98;104;36;5;36;279
"4022";"360610208002";184;259;71;9;42;565
"4023";"360610208003";100;73;110;4;35;322
"4024";"360610209011";72;37;22;2;59;192
"4025";"360610209012";127;105;16;1;14;263
"4026";"360610210001";98;13;46;3;9;169
"4027";"360610210002";68;33;19;0;40;160
"4028";"360610210003";164;72;26;0;9;271
"4029";"360610210004";338;39;17;8;27;429
"4030";"360610211001";32;41;72;2;15;162
"4031";"360610211002";25;46;34;1;45;151
"4032";"360610211003";138;256;136;10;31;571
"4033";"360610211004";56;23;5;2;13;99
"4034";"360610211005";51;27;10;0;13;101
"4035";"360610211006";6;28;33;3;3;73
"4036";"360610211007";33;34;22;1;8;98
"4037";"360610212001";71;169;86;3;23;352
"4038";"360610212002";4;3;4;1;12;24
"4039";"360610212003";7;28;15;8;6;64
"4040";"360610212004";42;113;22;2;30;209
"4041";"360610213031";51;36;22;11;27;147
"4042";"360610213032";68;13;92;1;34;208
"4043";"360610213033";198;164;7;1;23;393
"4044";"360610213034";140;122;16;0;37;315
"4045";"360610214001";35;51;63;5;19;173
"4046";"360610214002";99;52;11;6;21;189
"4047";"360610215001";114;105;29;4;32;284
"4048";"360610215002";609;328;72;6;50;1065
"4049";"360610216001";147;350;50;7;43;597
"4050";"360610216002";43;95;29;2;15;184
"4051";"360610216003";104;293;69;11;14;491
"4052";"360610216004";171;269;199;2;21;662
"4053";"360610216005";213;300;91;3;37;644
"4054";"360610217031";21;74;82;7;23;207
"4055";"360610218001";54;108;54;2;32;250
"4056";"360610218002";598;871;160;7;46;1682
"4057";"360610218003";160;568;200;4;40;972
"4058";"360610218004";316;775;74;22;93;1280
"4059";"360610219001";192;133;90;12;54;481
"4060";"360610219002";112;582;33;11;20;758
"4061";"360610219003";303;12;6;9;13;343
"4062";"360610219004";116;13;86;3;8;226
"4063";"360610220001";60;85;30;6;19;200
"4064";"360610220002";142;281;40;10;24;497
"4065";"360610220003";84;72;9;0;7;172
"4066";"360610220004";93;204;25;5;19;346
"4067";"360610220005";156;158;29;7;34;384
"4068";"360610221021";98;86;18;10;37;249
"4069";"360610221022";53;50;68;7;29;207
"4070";"360610222001";103;106;87;26;86;408
"4071";"360610222002";82;517;49;15;59;722
"4072";"360610223011";162;142;18;5;56;383
"4073";"360610223012";385;1174;72;5;238;1874
"4074";"360610223013";169;174;33;8;32;416
"4075";"360610223014";142;88;10;2;36;278
"4076";"360610223021";79;132;107;1;26;345
"4077";"360610224001";89;108;16;4;25;242
"4078";"360610224002";87;144;98;6;59;394
"4079";"360610224003";991;230;25;9;8;1263
"4080";"360610224004";294;25;19;7;12;357
"4081";"360610225001";505;993;52;3;39;1592
"4082";"360610225002";158;54;55;3;40;310
"4083";"360610225003";169;531;47;4;65;816
"4084";"360610225004";65;111;14;0;11;201
"4085";"360610225005";503;439;27;9;43;1021
"4086";"360610226001";118;360;80;5;33;596
"4087";"360610226002";65;114;76;9;54;318
"4088";"360610226003";133;210;141;13;46;543
"4089";"360610227001";137;54;272;7;51;521
"4090";"360610227002";89;23;76;8;32;228
"4091";"360610227003";279;230;72;9;29;619
"4092";"360610228001";149;358;73;4;44;628
"4093";"360610228002";35;48;21;2;31;137
"4094";"360610228003";108;126;23;10;34;301
"4095";"360610228004";31;57;33;7;18;146
"4096";"360610229001";44;12;5;4;26;91
"4097";"360610229002";129;635;29;0;24;817
"4098";"360610229003";378;486;33;2;71;970
"4099";"360610229004";241;392;48;2;24;707
"4100";"360610229005";190;370;26;3;46;635
"4101";"360610230001";161;128;13;1;20;323
"4102";"360610230002";336;209;27;6;24;602
"4103";"360610230003";133;87;132;2;27;381
"4104";"360610230004";216;212;67;8;25;528
"4105";"360610230005";303;89;10;1;8;411
"4106";"360610231001";189;158;53;7;39;446
"4107";"360610231002";219;157;58;1;29;464
"4108";"360610231003";327;170;78;5;53;633
"4109";"360610232001";73;28;57;3;27;188
"4110";"360610232002";339;142;32;2;21;536
"4111";"360610232003";733;42;18;3;19;815
"4112";"360610232004";416;210;26;5;46;703
"4113";"360610233001";304;375;35;5;75;794
"4114";"360610233002";200;361;46;4;29;640
"4115";"360610233003";351;228;33;3;26;641
"4116";"360610234001";397;764;104;26;30;1321
"4117";"360610234002";570;223;95;20;24;932
"4118";"360610235011";101;43;31;2;10;187
"4119";"360610235012";264;388;94;4;61;811
"4120";"360610235013";109;51;15;6;6;187
"4121";"360610235014";142;51;52;8;15;268
"4122";"360610235021";224;193;35;12;43;507
"4123";"360610236000";0;0;0;0;3;3
"4124";"360610236001";211;45;51;6;38;351
"4125";"360610236002";232;60;27;0;15;334
"4126";"360610236003";73;80;2;2;8;165
"4127";"360610236004";223;36;24;4;19;306
"4128";"360610237001";444;876;58;1;50;1429
"4129";"360610237002";553;699;84;11;33;1380
"4130";"360610237003";231;206;40;8;38;523
"4131";"360610238011";50;17;5;3;29;104
"4132";"360610238021";4;3;2;0;4;13
"4133";"360610238022";3;0;3;0;10;16
"4134";"360610239001";185;53;39;9;33;319
"4135";"360610239002";237;636;12;0;30;915
"4136";"360610240001";2;7;9;2;22;42
"4137";"360610241001";85;131;37;6;22;281
"4138";"360610241002";106;40;44;1;17;208
"4139";"360610241003";104;182;9;3;19;317
"4140";"360610241004";668;320;21;0;34;1043
"4141";"360610241005";161;107;10;5;11;294
"4142";"360610242001";134;43;199;10;31;417
"4143";"360610242002";75;32;50;4;23;184
"4144";"360610242003";36;22;199;13;43;313
"4145";"360610243011";115;116;22;0;26;279
"4146";"360610243012";151;85;49;15;41;341
"4147";"360610243013";25;58;17;2;11;113
"4148";"360610243021";610;49;33;9;16;717
"4149";"360610243023";501;5;9;2;8;525
"4150";"360610245001";415;297;47;1;25;785
"4151";"360610245002";80;149;9;2;19;259
"4152";"360610245003";233;332;9;2;40;616
"4153";"360610245004";289;165;39;6;50;549
"4154";"360610245005";85;131;60;4;25;305
"4155";"360610245006";199;332;42;6;29;608
"4156";"360610245007";190;426;15;3;35;669
"4157";"360610247001";107;411;62;3;13;596
"4158";"360610247002";70;360;46;5;31;512
"4159";"360610247003";108;206;4;0;14;332
"4160";"360610247004";151;154;31;0;24;360
"4161";"360610247005";41;52;35;5;17;150
"4162";"360610249001";68;353;50;4;23;498
"4163";"360610251001";134;90;82;7;66;379
"4164";"360610251002";101;112;75;0;49;337
"4165";"360610253001";76;305;30;4;18;433
"4166";"360610253002";149;596;12;4;24;785
"4167";"360610253003";151;470;25;5;23;674
"4168";"360610253004";125;165;31;5;128;454
"4169";"360610253005";356;199;31;4;25;615
"4170";"360610253006";160;65;102;12;33;372
"4171";"360610255001";26;27;37;13;11;114
"4172";"360610255002";120;91;162;3;31;407
"4173";"360610255003";359;88;29;6;11;493
"4174";"360610255004";59;14;13;0;22;108
"4175";"360610257001";89;139;192;16;78;514
"4176";"360610257002";20;113;40;3;14;190
"4177";"360610257003";135;211;23;3;59;431
"4178";"360610259001";303;262;169;17;45;796
"4179";"360610259002";87;278;257;4;17;643
"4180";"360610261001";295;630;37;10;55;1027
"4181";"360610261002";118;772;23;1;36;950
"4182";"360610261003";66;21;7;2;8;104
"4183";"360610261004";260;280;5;2;38;585
"4184";"360610261005";115;510;247;6;27;905
"4185";"360610261006";82;416;13;4;22;537
"4186";"360610261007";117;453;15;5;38;628
"4187";"360610263001";130;301;57;4;30;522
"4188";"360610263002";914;237;6;4;24;1185
"4189";"360610263003";251;433;21;3;31;739
"4190";"360610263004";110;389;47;3;34;583
"4191";"360610263005";228;101;12;3;24;368
"4192";"360610265001";86;121;6;1;11;225
"4193";"360610265002";366;56;54;3;73;552
"4194";"360610265003";30;61;153;3;8;255
"4195";"360610265004";427;169;26;2;43;667
"4196";"360610265005";41;11;10;3;28;93
"4197";"360610267001";144;109;34;5;15;307
"4198";"360610269001";229;336;22;11;19;617
"4199";"360610269002";165;170;26;5;22;388
"4200";"360610269003";15;91;37;0;24;167
"4201";"360610269004";160;589;49;3;78;879
"4202";"360610269005";219;221;33;13;38;524
"4203";"360610269006";206;420;13;11;18;668
"4204";"360610271001";221;234;15;3;21;494
"4205";"360610271002";70;569;54;18;54;765
"4206";"360610271003";130;302;72;12;32;548
"4207";"360610271004";439;57;72;6;14;588
"4208";"360610271005";69;13;56;3;5;146
"4209";"360610273001";90;150;121;3;22;386
"4210";"360610273002";41;28;52;3;23;147
"4211";"360610273003";50;127;44;11;35;267
"4212";"360610273004";55;41;22;1;10;129
"4213";"360610275001";4;23;19;0;4;50
"4214";"360610275002";23;1;10;1;1;36
"4215";"360610277001";219;408;59;7;20;713
"4216";"360610277002";155;189;5;2;19;370
"4217";"360610277003";87;354;13;6;13;473
"4218";"360610277004";62;95;2;2;5;166
"4219";"360610279001";85;71;56;3;19;234
"4220";"360610279002";1094;263;29;4;31;1421
"4221";"360610279003";306;309;25;9;15;664
"4222";"360610279004";566;468;59;15;19;1127
"4223";"360610279005";50;208;151;4;19;432
"4224";"360610279006";194;129;13;0;4;340
"4225";"360610279007";58;48;73;1;3;183
"4226";"360610281001";36;6;37;1;3;83
"4227";"360610281002";113;96;176;3;28;416
"4228";"360610283001";23;385;85;0;14;507
"4229";"360610283002";794;626;132;15;32;1599
"4230";"360610283003";139;166;67;1;9;382
"4231";"360610283004";240;881;256;3;17;1397
"4232";"360610285001";228;837;717;7;56;1845
"4233";"360610285002";392;401;47;12;32;884
"4234";"360610285003";82;588;36;13;7;726
"4235";"360610285004";262;696;44;12;15;1029
"4236";"360610287001";120;411;120;3;53;707
"4237";"360610287002";163;117;278;2;6;566
"4238";"360610287003";331;613;116;5;40;1105
"4239";"360610291001";191;250;9;7;28;485
"4240";"360610291002";71;235;24;1;14;345
"4241";"360610291003";371;181;22;13;7;594
"4242";"360610291004";181;329;33;0;18;561
"4243";"360610291005";124;281;32;0;17;454
"4244";"360610291006";205;204;17;0;24;450
"4245";"360610291007";350;698;69;3;37;1157
"4246";"360610293001";427;667;60;21;34;1209
"4247";"360610293002";219;272;13;4;41;549
"4248";"360610293003";239;306;61;9;50;665
"4249";"360610293004";149;584;43;2;271;1049
"4250";"360610293005";199;356;10;2;18;585
"4251";"360610295001";79;413;139;15;23;669
"4252";"360610295002";120;625;129;2;42;918
"4253";"360610295003";160;180;65;2;27;434
"4254";"360610295004";426;144;78;7;30;685
"4255";"360610297001";47;352;77;17;40;533
"4256";"360610299000";0;1;0;0;0;1
"4257";"360610299001";871;63;38;4;25;1001
"4258";"360610299002";99;229;188;96;60;672
"4259";"360610303001";181;720;62;14;45;1022
"4260";"360610303002";181;169;116;10;40;516
"4261";"360610303003";74;463;135;16;53;741
"4262";"360610307001";214;256;141;50;25;686
"4263";"360610307002";3;30;35;3;5;76
"4264";"360610307003";192;311;49;0;23;575
"4265";"360610309001";520;267;89;1;29;906
"4266";"360610309002";138;122;60;0;29;349
"4267";"360610309003";299;139;41;3;16;498
"4268";"360610309004";286;233;194;2;22;737
"4269";"360610311000";0;0;0;0;1;1
"4270";"360610311001";93;190;39;4;29;355
"4271";"360610317030";0;1;0;0;6;7
"4272";"360610317031";6;33;392;4;19;454
"4273";"360610317032";17;57;511;6;25;616
"4274";"360610317041";23;55;56;3;21;158
"4275";"360610317042";10;20;16;3;3;52
"4276";"360610317043";13;11;156;4;10;194
"4277";"360610317044";42;56;157;12;28;295
"4278";"360610319001";2;12;17;0;27;58
"4279";"360810001001";496;361;1198;62;53;2170
"4280";"360810002001";135;18;427;102;98;780
"4281";"360810002002";186;23;232;29;52;522
"4282";"360810004001";117;59;198;36;65;475
"4283";"360810004002";153;46;292;73;33;597
"4284";"360810004003";53;21;508;119;34;735
"4285";"360810006001";62;37;273;45;31;448
"4286";"360810006002";54;7;221;103;30;415
"4287";"360810006003";100;209;343;244;30;926
"4288";"360810007001";47;59;369;17;37;529
"4289";"360810007002";29;67;165;11;31;303
"4290";"360810007003";27;51;598;31;59;766
"4291";"360810007004";39;180;1263;97;64;1643
"4292";"360810008001";262;24;286;62;56;690
"4293";"360810008002";137;22;478;51;52;740
"4294";"360810010001";52;44;133;27;33;289
"4295";"360810010002";147;20;370;49;50;636
"4296";"360810012001";52;46;171;35;48;352
"4297";"360810012002";33;13;189;49;29;313
"4298";"360810012003";134;14;186;51;75;460
"4299";"360810014001";127;25;679;72;23;926
"4300";"360810014002";91;11;188;88;30;408
"4301";"360810014003";128;18;448;40;95;729
"4302";"360810016001";86;23;145;51;57;362
"4303";"360810016002";214;58;249;53;38;612
"4304";"360810018001";137;49;139;19;52;396
"4305";"360810018002";119;73;251;94;41;578
"4306";"360810019001";94;162;1715;181;176;2328
"4307";"360810020001";82;48;242;52;34;458
"4308";"360810022001";63;30;163;30;39;325
"4309";"360810022002";102;36;63;25;21;247
"4310";"360810024001";40;7;183;56;31;317
"4311";"360810024002";58;14;231;77;46;426
"4312";"360810025001";74;30;31;0;4;139
"4313";"360810025002";166;23;4;1;5;199
"4314";"360810025003";314;23;2;1;12;352
"4315";"360810025004";101;32;3;3;6;145
"4316";"360810025005";37;9;11;3;7;67
"4317";"360810025006";65;22;16;2;11;116
"4318";"360810026001";37;16;187;41;29;310
"4319";"360810026002";116;204;89;27;46;482
"4320";"360810028001";213;55;149;101;76;594
"4321";"360810028002";72;38;228;92;46;476
"4322";"360810030001";70;13;249;32;68;432
"4323";"360810031001";55;157;170;13;12;407
"4324";"360810031002";36;43;225;62;56;422
"4325";"360810032001";119;89;172;95;41;516
"4326";"360810033001";70;230;520;27;39;886
"4327";"360810033002";21;13;354;60;36;484
"4328";"360810033003";11;19;201;95;33;359
"4329";"360810033004";17;18;262;27;26;350
"4330";"360810034001";24;87;217;74;53;455
"4331";"360810034002";88;42;223;96;32;481
"4332";"360810036001";114;55;382;137;27;715
"4333";"360810036002";145;19;201;94;60;519
"4334";"360810037001";259;77;187;6;19;548
"4335";"360810038001";57;21;155;21;53;307
"4336";"360810038002";61;31;222;39;48;401
"4337";"360810039001";43;18;404;118;69;652
"4338";"360810040011";109;40;278;50;36;513
"4339";"360810040012";77;26;180;86;62;431
"4340";"360810040021";51;25;211;85;64;436
"4341";"360810042001";85;25;330;151;77;668
"4342";"360810042002";13;12;110;25;23;183
"4343";"360810042003";52;10;58;35;24;179
"4344";"360810043001";519;62;244;33;11;869
"4345";"360810043002";3;7;209;94;13;326
"4346";"360810044011";68;33;171;52;43;367
"4347";"360810044012";53;15;190;61;40;359
"4348";"360810045001";21;23;109;119;34;306
"4349";"360810045002";0;7;11;12;3;33
"4350";"360810045003";3;11;18;2;3;37
"4351";"360810047001";111;15;131;19;31;307
"4352";"360810047002";257;64;31;5;10;367
"4353";"360810050001";11;5;104;17;1;138
"4354";"360810051001";40;50;134;11;25;260
"4355";"360810051002";43;19;126;34;27;249
"4356";"360810052001";113;15;227;120;93;568
"4357";"360810052002";64;28;243;128;41;504
"4358";"360810053001";16;37;115;4;31;203
"4359";"360810053002";150;14;133;1;23;321
"4360";"360810053003";39;3;54;8;17;121
"4361";"360810053004";25;22;158;22;28;255
"4362";"360810054001";49;54;142;49;31;325
"4363";"360810054002";154;8;197;37;40;436
"4364";"360810054003";115;269;369;87;121;961
"4365";"360810054004";55;21;397;171;83;727
"4366";"360810055001";20;102;710;272;54;1158
"4367";"360810057001";136;79;131;12;33;391
"4368";"360810057002";15;19;111;35;28;208
"4369";"360810057003";97;141;130;7;37;412
"4370";"360810058001";79;35;305;106;69;594
"4371";"360810058002";30;3;96;52;31;212
"4372";"360810058003";44;15;103;67;50;279
"4373";"360810058004";56;106;274;65;63;564
"4374";"360810059001";30;74;123;11;33;271
"4375";"360810059002";49;30;101;9;16;205
"4376";"360810059003";30;123;77;5;39;274
"4377";"360810061001";52;54;94;3;22;225
"4378";"360810061002";81;191;48;5;29;354
"4379";"360810061003";72;46;39;9;20;186
"4380";"360810061004";30;16;44;5;12;107
"4381";"360810062011";68;1;35;13;1;118
"4382";"360810062012";122;18;209;80;26;455
"4383";"360810062021";0;5;28;41;15;89
"4384";"360810062022";44;10;133;33;55;275
"4385";"360810062023";62;10;101;68;30;271
"4386";"360810062024";16;2;108;21;15;162
"4387";"360810062025";95;24;59;19;29;226
"4388";"360810062026";85;13;97;25;7;227
"4389";"360810062027";62;6;124;52;24;268
"4390";"360810063001";67;34;162;8;28;299
"4391";"360810063002";56;58;50;1;33;198
"4392";"360810063003";118;37;31;12;21;219
"4393";"360810063004";33;127;104;7;33;304
"4394";"360810065011";82;110;29;8;8;237
"4395";"360810065012";41;9;157;20;8;235
"4396";"360810065013";39;9;177;3;9;237
"4397";"360810065021";42;213;143;9;48;455
"4398";"360810065022";44;5;124;2;8;183
"4399";"360810065023";113;129;203;7;28;480
"4400";"360810069001";51;16;207;2;19;295
"4401";"360810069002";113;50;174;11;57;405
"4402";"360810069003";48;26;94;3;30;201
"4403";"360810071001";15;186;267;8;28;504
"4404";"360810071002";22;9;17;5;20;73
"4405";"360810071003";59;30;199;6;11;305
"4406";"360810071004";97;589;196;7;88;977
"4407";"360810073001";124;43;127;10;31;335
"4408";"360810073002";13;30;32;2;7;84
"4409";"360810073003";82;14;99;1;22;218
"4410";"360810075001";29;14;115;1;27;186
"4411";"360810075002";43;78;33;2;11;167
"4412";"360810075003";43;14;46;1;10;114
"4413";"360810077001";35;21;168;7;53;284
"4414";"360810079001";108;24;280;35;42;489
"4415";"360810079002";50;17;137;18;25;247
"4416";"360810081001";117;47;544;72;42;822
"4417";"360810083001";33;18;399;49;43;542
"4418";"360810083002";85;206;416;73;62;842
"4419";"360810085001";30;26;293;115;16;480
"4420";"360810085002";8;23;244;69;16;360
"4421";"360810086001";37;19;299;56;45;456
"4422";"360810086002";73;13;210;51;51;398
"4423";"360810087001";226;36;32;4;10;308
"4424";"360810087002";61;45;98;17;27;248
"4425";"360810087003";109;93;13;9;8;232
"4426";"360810088001";96;85;308;86;90;665
"4427";"360810088002";98;55;275;65;43;536
"4428";"360810091001";32;29;124;29;16;230
"4429";"360810091002";42;31;279;46;21;419
"4430";"360810094001";70;58;142;29;134;433
"4431";"360810094002";327;50;177;36;115;705
"4432";"360810095001";44;6;90;1;12;153
"4433";"360810095002";15;37;159;25;22;258
"4434";"360810096001";215;72;340;60;84;771
"4435";"360810096002";146;35;279;80;104;644
"4436";"360810097001";38;12;36;7;11;104
"4437";"360810097002";25;39;71;16;23;174
"4438";"360810097003";9;0;37;12;20;78
"4439";"360810097004";37;14;62;10;16;139
"4440";"360810098001";122;46;169;46;107;490
"4441";"360810098002";93;81;251;45;108;578
"4442";"360810099001";5;99;26;5;15;150
"4443";"360810100001";96;18;179;29;77;399
"4444";"360810100002";232;35;273;70;139;749
"4445";"360810101001";38;26;95;6;14;179
"4446";"360810101002";27;39;81;8;30;185
"4447";"360810102001";75;23;145;35;84;362
"4448";"360810102002";166;28;205;40;59;498
"4449";"360810103001";36;194;98;5;26;359
"4450";"360810103002";21;21;78;9;25;154
"4451";"360810103003";59;13;76;9;30;187
"4452";"360810103004";42;37;17;8;18;122
"4453";"360810104001";272;311;228;60;82;953
"4454";"360810104002";394;19;229;70;87;799
"4455";"360810105001";56;9;22;2;12;101
"4456";"360810105002";29;11;37;2;5;84
"4457";"360810105003";38;8;41;6;12;105
"4458";"360810105004";13;50;28;1;22;114
"4459";"360810106001";295;49;189;40;53;626
"4460";"360810106002";243;102;350;70;142;907
"4461";"360810107011";5;17;66;23;4;115
"4462";"360810108001";112;21;271;28;71;503
"4463";"360810108002";133;18;388;74;94;707
"4464";"360810110001";48;40;226;85;44;443
"4465";"360810110002";151;25;494;53;201;924
"4466";"360810111001";78;77;97;8;5;265
"4467";"360810111002";18;32;130;9;9;198
"4468";"360810112001";55;7;192;63;48;365
"4469";"360810112002";70;76;211;19;58;434
"4470";"360810113001";74;31;30;1;20;156
"4471";"360810113002";77;315;120;2;25;539
"4472";"360810113003";66;71;470;6;32;645
"4473";"360810114001";104;28;220;94;85;531
"4474";"360810115001";82;90;302;13;31;518
"4475";"360810115002";21;27;95;6;122;271
"4476";"360810116001";125;20;151;38;13;347
"4477";"360810116002";88;24;286;40;41;479
"4478";"360810117001";24;30;125;7;20;206
"4479";"360810117002";7;163;102;7;23;302
"4480";"360810117003";41;44;268;7;47;407
"4481";"360810117004";32;12;178;15;8;245
"4482";"360810118001";132;12;311;47;75;577
"4483";"360810118002";32;14;382;41;70;539
"4484";"360810119001";18;54;150;4;36;262
"4485";"360810119002";24;15;59;7;24;129
"4486";"360810120001";16;13;173;30;31;263
"4487";"360810120002";39;58;355;57;66;575
"4488";"360810121001";19;16;90;4;28;157
"4489";"360810121002";16;36;58;0;36;146
"4490";"360810122001";80;17;247;12;71;427
"4491";"360810122002";119;34;207;32;72;464
"4492";"360810123011";57;140;211;83;46;537
"4493";"360810123012";14;47;157;56;28;302
"4494";"360810123013";22;33;130;37;32;254
"4495";"360810124001";30;4;92;18;43;187
"4496";"360810124002";110;30;226;76;51;493
"4497";"360810125001";21;37;177;10;23;268
"4498";"360810125002";31;36;53;2;14;136
"4499";"360810126011";98;16;189;125;111;539
"4500";"360810126012";49;47;225;103;68;492
"4501";"360810126021";22;12;136;41;63;274
"4502";"360810126022";88;40;200;93;37;458
"4503";"360810128001";59;10;78;36;12;195
"4504";"360810128002";74;47;163;44;41;369
"4505";"360810130001";12;2;128;36;13;191
"4506";"360810130002";42;15;109;23;36;225
"4507";"360810132001";17;4;50;4;10;85
"4508";"360810132002";45;43;175;52;68;383
"4509";"360810134001";165;16;42;2;17;242
"4510";"360810134002";25;6;434;1;13;479
"4511";"360810134003";218;15;153;3;9;398
"4512";"360810134004";19;1;20;0;5;45
"4513";"360810135001";16;19;131;15;28;209
"4514";"360810136001";14;3;35;9;16;77
"4515";"360810136002";37;131;17;1;24;210
"4516";"360810137001";44;54;299;33;26;456
"4517";"360810138001";200;11;65;10;9;295
"4518";"360810138002";167;32;290;23;54;566
"4519";"360810140001";26;7;193;18;30;274
"4520";"360810140002";144;10;127;3;55;339
"4521";"360810141001";45;157;59;1;15;277
"4522";"360810141002";89;13;209;117;50;478
"4523";"360810142011";13;12;162;10;75;272
"4524";"360810142012";91;18;244;50;69;472
"4525";"360810142021";144;28;322;35;71;600
"4526";"360810142022";92;92;257;136;39;616
"4527";"360810143001";18;12;106;14;28;178
"4528";"360810143002";131;365;247;10;100;853
"4529";"360810144001";124;38;490;24;76;752
"4530";"360810145001";33;13;178;124;33;381
"4531";"360810145002";87;46;268;34;13;448
"4532";"360810147001";28;13;113;32;10;196
"4533";"360810147002";40;15;177;13;23;268
"4534";"360810147003";60;190;144;1;45;440
"4535";"360810148001";108;59;269;62;116;614
"4536";"360810149001";36;42;62;6;17;163
"4537";"360810149002";70;68;138;6;36;318
"4538";"360810150001";230;21;222;50;55;578
"4539";"360810150002";112;12;235;40;54;453
"4540";"360810151001";18;12;146;10;12;198
"4541";"360810151002";41;55;220;52;24;392
"4542";"360810152001";51;14;150;39;41;295
"4543";"360810152002";105;33;265;64;53;520
"4544";"360810153001";36;19;184;41;59;339
"4545";"360810153002";30;50;171;16;29;296
"4546";"360810154001";84;25;154;16;37;316
"4547";"360810154002";50;24;349;82;65;570
"4548";"360810155001";42;220;201;0;54;517
"4549";"360810155002";37;160;128;3;126;454
"4550";"360810156001";68;53;374;43;61;599
"4551";"360810156002";93;39;237;40;146;555
"4552";"360810157001";29;182;91;18;58;378
"4553";"360810158011";47;23;126;57;51;304
"4554";"360810158012";112;24;116;79;44;375
"4555";"360810158013";203;141;268;55;68;735
"4556";"360810158021";214;88;221;38;87;648
"4557";"360810158022";378;85;305;41;97;906
"4558";"360810158023";49;62;162;38;98;409
"4559";"360810159001";27;325;124;3;22;501
"4560";"360810159002";49;19;26;24;29;147
"4561";"360810159003";58;27;28;3;19;135
"4562";"360810159004";45;9;136;0;9;199
"4563";"360810161001";17;7;88;4;20;136
"4564";"360810161002";66;92;104;1;42;305
"4565";"360810163001";13;14;179;19;26;251
"4566";"360810163002";81;117;14;3;7;222
"4567";"360810163003";298;32;108;12;14;464
"4568";"360810164001";179;12;187;40;49;467
"4569";"360810164002";111;35;215;64;164;589
"4570";"360810166001";159;60;440;60;106;825
"4571";"360810166002";60;67;167;42;61;397
"4572";"360810168001";103;12;171;46;89;421
"4573";"360810168002";68;7;312;100;58;545
"4574";"360810169001";38;7;33;3;2;83
"4575";"360810169002";56;13;110;8;21;208
"4576";"360810169003";41;7;94;4;18;164
"4577";"360810169004";32;25;112;0;5;174
"4578";"360810170001";258;5;163;35;53;514
"4579";"360810170002";135;72;172;57;83;519
"4580";"360810171001";14;59;440;52;64;629
"4581";"360810172001";87;24;138;65;81;395
"4582";"360810172002";48;30;86;103;52;319
"4583";"360810174001";61;9;113;143;41;367
"4584";"360810174002";47;12;153;48;58;318
"4585";"360810176001";138;14;155;78;60;445
"4586";"360810176002";43;8;93;19;27;190
"4587";"360810178001";143;16;143;67;39;408
"4588";"360810178002";94;11;143;83;24;355
"4589";"360810179001";25;9;238;27;20;319
"4590";"360810179002";44;23;155;8;33;263
"4591";"360810180001";63;9;171;52;48;343
"4592";"360810181011";49;27;62;1;14;153
"4593";"360810181012";59;18;34;3;11;125
"4594";"360810181013";103;34;24;3;30;194
"4595";"360810181021";69;14;92;3;19;197
"4596";"360810181022";33;23;28;8;31;123
"4597";"360810181023";33;63;32;3;11;142
"4598";"360810182001";78;13;87;48;44;270
"4599";"360810182002";41;9;133;85;73;341
"4600";"360810183001";31;26;117;12;17;203
"4601";"360810183002";41;9;66;0;15;131
"4602";"360810183003";81;106;49;9;25;270
"4603";"360810183004";58;58;92;2;44;254
"4604";"360810183005";36;112;59;4;25;236
"4605";"360810184011";251;14;189;111;70;635
"4606";"360810184021";46;15;122;81;33;297
"4607";"360810184022";29;3;116;27;30;205
"4608";"360810185011";55;6;191;1;22;275
"4609";"360810185012";3;12;22;3;5;45
"4610";"360810185013";113;25;84;1;23;246
"4611";"360810185021";14;1;10;0;5;30
"4612";"360810185022";94;26;49;5;18;192
"4613";"360810185023";39;61;25;1;26;152
"4614";"360810186001";149;32;335;145;68;729
"4615";"360810187001";80;22;136;10;117;365
"4616";"360810187002";26;5;59;5;23;118
"4617";"360810187003";54;20;117;13;10;214
"4618";"360810188001";136;7;138;48;31;360
"4619";"360810189001";77;6;106;3;46;238
"4620";"360810189002";18;10;228;31;34;321
"4621";"360810189003";19;6;193;4;15;237
"4622";"360810190001";27;18;114;31;55;245
"4623";"360810190002";59;7;194;73;90;423
"4624";"360810192001";60;23;110;37;42;272
"4625";"360810192002";150;32;185;44;39;450
"4626";"360810194001";61;9;81;75;37;263
"4627";"360810194002";80;24;214;103;76;497
"4628";"360810196001";90;8;150;94;45;387
"4629";"360810196002";118;23;343;192;52;728
"4630";"360810198001";73;18;114;75;62;342
"4631";"360810198002";130;16;146;57;38;387
"4632";"360810198003";31;5;86;69;32;223
"4633";"360810199001";0;15;351;80;25;471
"4634";"360810199002";19;33;398;156;56;662
"4635";"360810202001";50;31;431;135;79;726
"4636";"360810204001";15;34;212;171;66;498
"4637";"360810204002";149;131;227;67;40;614
"4638";"360810205001";8;7;77;89;17;198
"4639";"360810205002";26;3;183;78;4;294
"4640";"360810206001";136;34;365;77;73;685
"4641";"360810208001";50;33;168;34;39;324
"4642";"360810208002";25;47;335;189;93;689
"4643";"360810212001";23;47;125;14;75;284
"4644";"360810212002";167;67;104;14;55;407
"4645";"360810214001";224;12;174;2;26;438
"4646";"360810214002";94;10;128;7;41;280
"4647";"360810214003";35;19;225;52;94;425
"4648";"360810216001";46;32;203;7;37;325
"4649";"360810216002";23;8;70;9;11;121
"4650";"360810216003";58;11;58;16;29;172
"4651";"360810219001";3;8;240;94;19;364
"4652";"360810220011";16;2;67;2;10;97
"4653";"360810220012";67;5;174;11;14;271
"4654";"360810220013";197;14;161;2;7;381
"4655";"360810220014";25;1;5;0;1;32
"4656";"360810220021";14;6;116;11;11;158
"4657";"360810220022";45;16;123;9;27;220
"4658";"360810220023";121;23;139;1;19;303
"4659";"360810220024";87;28;74;2;18;209
"4660";"360810229001";2;1;23;34;5;65
"4661";"360810230001";24;11;80;46;24;185
"4662";"360810230002";41;4;73;25;13;156
"4663";"360810232001";9;1;30;0;4;44
"4664";"360810232002";5;7;196;8;27;243
"4665";"360810232003";39;8;199;13;54;313
"4666";"360810235001";45;29;115;16;23;228
"4667";"360810235002";81;38;32;5;24;180
"4668";"360810235003";49;17;153;17;7;243
"4669";"360810235004";36;35;87;4;26;188
"4670";"360810236001";19;6;96;19;27;167
"4671";"360810236002";56;51;44;10;28;189
"4672";"360810238001";692;12;47;2;45;798
"4673";"360810238002";26;12;19;7;42;106
"4674";"360810238003";91;36;21;13;4;165
"4675";"360810238004";23;6;61;9;16;115
"4676";"360810240001";76;14;75;3;33;201
"4677";"360810240002";166;85;131;9;64;455
"4678";"360810240003";59;10;35;1;7;112
"4679";"360810243001";7;3;97;94;27;228
"4680";"360810243002";40;11;126;88;43;308
"4681";"360810243003";37;6;154;59;29;285
"4682";"360810243004";109;13;201;110;45;478
"4683";"360810245001";12;9;54;3;15;93
"4684";"360810245002";37;5;158;6;18;224
"4685";"360810245003";4;13;63;4;16;100
"4686";"360810245004";54;5;121;10;7;197
"4687";"360810246001";1;8;148;8;17;182
"4688";"360810247001";35;7;126;3;29;200
"4689";"360810249001";44;49;133;6;51;283
"4690";"360810249002";40;12;55;2;6;115
"4691";"360810249003";49;14;132;1;31;227
"4692";"360810251001";29;100;89;3;19;240
"4693";"360810251002";27;6;49;3;9;94
"4694";"360810251003";70;50;316;4;32;472
"4695";"360810251004";67;13;33;5;27;145
"4696";"360810253011";51;19;59;2;9;140
"4697";"360810253012";117;23;27;1;28;196
"4698";"360810253013";34;13;4;3;24;78
"4699";"360810253014";106;59;71;4;12;252
"4700";"360810253021";46;7;6;1;7;67
"4701";"360810253022";94;52;128;10;57;341
"4702";"360810254001";170;77;187;62;39;535
"4703";"360810254002";27;11;124;53;47;262
"4704";"360810254003";156;42;47;18;20;283
"4705";"360810254004";159;36;31;14;9;249
"4706";"360810254005";35;8;407;142;54;646
"4707";"360810254006";76;23;164;84;45;392
"4708";"360810255001";107;26;334;98;55;620
"4709";"360810257001";22;37;349;70;39;517
"4710";"360810258001";98;31;71;40;12;252
"4711";"360810258002";38;6;80;81;45;250
"4712";"360810259001";72;47;332;41;44;536
"4713";"360810259002";41;37;104;3;38;223
"4714";"360810260001";99;29;55;23;37;243
"4715";"360810260002";25;10;173;123;37;368
"4716";"360810261001";20;7;28;22;22;99
"4717";"360810261002";82;6;185;12;23;308
"4718";"360810261003";38;45;45;3;25;156
"4719";"360810261004";63;89;193;7;50;402
"4720";"360810262001";55;21;136;117;58;387
"4721";"360810263001";30;89;177;2;37;335
"4722";"360810263002";61;101;266;4;37;469
"4723";"360810263003";57;10;118;5;18;208
"4724";"360810264001";116;17;53;49;35;270
"4725";"360810264002";70;10;56;67;30;233
"4726";"360810265001";43;61;223;4;58;389
"4727";"360810265002";75;27;179;4;30;315
"4728";"360810266001";102;16;88;60;28;294
"4729";"360810267001";34;20;105;4;44;207
"4730";"360810267002";22;57;121;3;50;253
"4731";"360810267003";62;74;341;7;78;562
"4732";"360810269011";33;135;32;1;31;232
"4733";"360810269012";29;3;19;1;7;59
"4734";"360810269013";21;9;33;2;13;78
"4735";"360810269014";10;23;90;1;22;146
"4736";"360810269021";103;32;94;4;45;278
"4737";"360810269022";96;15;112;2;37;262
"4738";"360810270001";81;19;180;106;53;439
"4739";"360810271001";110;441;112;0;18;681
"4740";"360810271002";76;13;47;1;8;145
"4741";"360810271003";52;7;203;7;27;296
"4742";"360810271004";75;4;36;3;30;148
"4743";"360810271005";30;11;29;0;23;93
"4744";"360810272001";65;6;125;40;30;266
"4745";"360810272002";33;6;115;38;35;227
"4746";"360810273001";8;49;33;6;7;103
"4747";"360810273002";99;36;21;3;17;176
"4748";"360810273003";98;169;32;0;31;330
"4749";"360810273004";166;66;72;5;50;359
"4750";"360810273005";126;34;191;2;63;416
"4751";"360810274001";61;8;197;58;39;363
"4752";"360810275001";7;30;24;1;3;65
"4753";"360810275002";77;31;154;5;50;317
"4754";"360810275003";247;33;200;9;66;555
"4755";"360810276001";180;63;166;69;52;530
"4756";"360810277001";19;2;16;1;3;41
"4757";"360810277002";231;18;114;10;27;400
"4758";"360810277003";110;6;14;2;13;145
"4759";"360810277004";61;20;18;1;16;116
"4760";"360810277005";209;22;74;13;40;358
"4761";"360810278001";34;0;21;38;13;106
"4762";"360810278002";190;9;4;9;5;217
"4763";"360810279001";115;18;191;4;21;349
"4764";"360810279002";79;5;146;3;61;294
"4765";"360810279003";73;34;15;0;10;132
"4766";"360810279004";4;2;16;0;1;23
"4767";"360810280001";161;16;70;128;56;431
"4768";"360810281001";82;55;190;16;31;374
"4769";"360810281002";196;22;67;5;17;307
"4770";"360810281003";15;35;46;1;13;110
"4771";"360810281004";51;15;13;0;7;86
"4772";"360810282001";54;21;153;89;81;398
"4773";"360810283001";7;14;24;1;8;54
"4774";"360810283002";55;12;37;2;14;120
"4775";"360810283003";38;112;27;4;31;212
"4776";"360810283004";25;162;34;7;14;242
"4777";"360810283005";46;41;14;0;13;114
"4778";"360810284001";55;18;157;108;49;387
"4779";"360810284002";46;14;67;64;37;228
"4780";"360810285001";2;3;32;1;3;41
"4781";"360810285002";36;13;19;3;7;78
"4782";"360810285003";31;31;70;0;6;138
"4783";"360810285004";82;32;67;5;32;218
"4784";"360810287001";76;17;67;2;18;180
"4785";"360810287002";27;18;41;8;4;98
"4786";"360810287003";112;78;125;9;42;366
"4787";"360810287004";62;73;41;2;31;209
"4788";"360810288001";28;8;33;49;26;144
"4789";"360810288002";42;22;75;62;23;224
"4790";"360810288003";46;8;58;44;18;174
"4791";"360810288004";90;6;158;66;54;374
"4792";"360810289001";19;11;115;8;9;162
"4793";"360810289002";26;14;51;5;13;109
"4794";"360810289003";67;103;152;7;49;378
"4795";"360810291001";23;5;89;5;26;148
"4796";"360810291002";60;23;368;6;35;492
"4797";"360810291003";34;19;40;1;20;114
"4798";"360810291004";42;46;141;1;30;260
"4799";"360810293001";28;19;350;23;70;490
"4800";"360810294001";34;1;122;35;22;214
"4801";"360810294002";41;4;119;37;26;227
"4802";"360810294003";69;9;150;44;35;307
"4803";"360810294004";65;1;78;41;18;203
"4804";"360810294005";47;22;54;44;33;200
"4805";"360810294006";22;2;253;42;32;351
"4806";"360810295001";28;11;175;88;14;316
"4807";"360810295002";56;26;424;100;30;636
"4808";"360810297001";19;79;319;168;52;637
"4809";"360810297002";45;42;464;98;33;682
"4810";"360810299001";0;0;17;11;14;42
"4811";"360810306001";20;42;199;74;35;370
"4812";"360810306002";63;8;81;69;29;250
"4813";"360810306003";54;15;157;73;31;330
"4814";"360810306004";6;3;99;52;25;185
"4815";"360810309021";19;5;86;31;7;148
"4816";"360810309022";70;3;153;12;29;267
"4817";"360810309023";36;5;230;18;20;309
"4818";"360810309024";35;4;378;9;16;442
"4819";"360810309025";47;3;657;28;14;749
"4820";"360810309031";81;47;441;19;34;622
"4821";"360810309032";62;11;231;11;47;362
"4822";"360810309033";65;23;198;5;18;309
"4823";"360810309041";82;11;288;29;36;446
"4824";"360810309042";53;7;168;10;113;351
"4825";"360810317001";92;12;371;28;25;528
"4826";"360810317002";13;6;158;14;20;211
"4827";"360810317003";41;23;214;46;25;349
"4828";"360810317004";26;7;115;8;42;198
"4829";"360810320001";51;7;83;94;41;276
"4830";"360810320002";6;16;214;29;16;281
"4831";"360810320003";48;32;156;106;57;399
"4832";"360810320004";14;3;67;76;7;167
"4833";"360810327001";49;30;287;19;30;415
"4834";"360810327002";56;201;147;3;30;437
"4835";"360810328001";17;5;44;47;39;152
"4836";"360810328002";32;6;61;54;25;178
"4837";"360810329001";25;6;58;35;41;165
"4838";"360810329002";23;10;131;13;17;194
"4839";"360810329003";43;31;119;12;30;235
"4840";"360810330001";62;16;87;73;45;283
"4841";"360810330002";10;0;27;42;12;91
"4842";"360810330003";30;3;67;61;177;338
"4843";"360810330004";30;4;68;59;10;171
"4844";"360810330005";21;2;77;66;24;190
"4845";"360810331001";1;4;8;1;5;19
"4846";"360810334011";81;9;138;52;51;331
"4847";"360810334012";59;14;240;188;38;539
"4848";"360810334021";16;3;8;1;6;34
"4849";"360810334022";55;7;2;0;1;65
"4850";"360810334023";13;14;1;1;2;31
"4851";"360810334024";37;4;3;1;7;52
"4852";"360810334025";25;17;27;7;3;79
"4853";"360810334026";38;14;175;125;19;371
"4854";"360810337001";49;10;142;23;33;257
"4855";"360810337002";102;225;154;15;74;570
"4856";"360810339001";44;16;71;9;15;155
"4857";"360810339002";26;13;11;3;11;64
"4858";"360810339003";41;7;101;8;11;168
"4859";"360810347001";43;8;264;56;37;408
"4860";"360810347002";87;12;280;44;20;443
"4861";"360810351001";75;15;110;19;18;237
"4862";"360810351002";133;36;804;20;15;1008
"4863";"360810351003";45;41;241;19;19;365
"4864";"360810352001";39;9;56;83;35;222
"4865";"360810352002";85;15;63;83;43;289
"4866";"360810353001";41;26;179;12;30;288
"4867";"360810353002";229;150;92;3;22;496
"4868";"360810357001";106;26;921;38;46;1137
"4869";"360810357002";68;14;253;27;25;387
"4870";"360810357003";37;6;158;15;20;236
"4871";"360810358001";25;23;35;42;10;135
"4872";"360810358002";103;17;94;65;26;305
"4873";"360810358003";35;7;37;71;21;171
"4874";"360810358004";15;2;13;26;19;75
"4875";"360810361001";133;47;103;26;42;351
"4876";"360810361002";42;9;105;23;14;193
"4877";"360810363001";58;6;107;48;34;253
"4878";"360810363002";37;41;205;6;11;300
"4879";"360810365001";82;27;182;21;32;344
"4880";"360810365002";62;40;206;30;38;376
"4881";"360810366001";32;21;140;65;34;292
"4882";"360810366002";90;43;99;35;37;304
"4883";"360810367001";15;1;47;27;12;102
"4884";"360810367002";49;12;269;45;56;431
"4885";"360810368001";25;7;39;26;53;150
"4886";"360810368002";16;6;57;34;36;149
"4887";"360810371001";20;7;245;35;29;336
"4888";"360810373001";38;8;207;47;30;330
"4889";"360810373002";284;113;377;21;31;826
"4890";"360810375001";59;37;209;18;28;351
"4891";"360810375002";55;35;141;8;35;274
"4892";"360810376001";20;20;81;36;30;187
"4893";"360810376002";50;5;42;36;41;174
"4894";"360810376003";13;5;41;7;11;77
"4895";"360810376004";21;4;89;68;31;213
"4896";"360810376005";51;6;47;54;29;187
"4897";"360810377001";105;47;610;22;36;820
"4898";"360810377002";116;28;188;5;12;349
"4899";"360810379001";116;14;396;24;15;565
"4900";"360810379002";73;97;247;27;20;464
"4901";"360810379003";61;58;146;9;28;302
"4902";"360810381001";70;20;162;18;27;297
"4903";"360810381002";192;29;267;30;22;540
"4904";"360810381003";98;39;247;25;27;436
"4905";"360810383011";337;92;116;64;37;646
"4906";"360810383021";112;153;283;45;109;702
"4907";"360810384001";44;6;194;47;20;311
"4908";"360810384002";34;5;80;51;41;211
"4909";"360810394001";19;3;68;42;25;157
"4910";"360810394002";27;10;48;34;13;132
"4911";"360810394003";18;6;54;31;16;125
"4912";"360810398001";9;2;39;21;22;93
"4913";"360810398002";5;2;27;7;14;55
"4914";"360810399001";22;2;159;10;29;222
"4915";"360810399002";53;17;145;6;26;247
"4916";"360810399003";72;27;177;11;16;303
"4917";"360810400001";25;5;116;28;11;185
"4918";"360810400002";17;8;42;27;25;119
"4919";"360810401001";183;24;274;44;23;548
"4920";"360810401002";52;184;178;23;42;479
"4921";"360810401003";52;7;172;26;13;270
"4922";"360810402001";33;13;31;29;27;133
"4923";"360810402002";39;4;63;49;14;169
"4924";"360810403001";262;254;467;34;44;1061
"4925";"360810403002";16;16;135;44;33;244
"4926";"360810403003";62;4;174;11;35;286
"4927";"360810404001";21;10;58;32;16;137
"4928";"360810404002";44;2;63;39;12;160
"4929";"360810404003";20;35;38;50;22;165
"4930";"360810404004";23;8;122;41;12;206
"4931";"360810405001";64;137;95;14;35;345
"4932";"360810405002";32;61;141;18;101;353
"4933";"360810407001";45;40;153;16;24;278
"4934";"360810407002";40;39;91;22;32;224
"4935";"360810407003";14;11;158;20;22;225
"4936";"360810407004";27;15;135;13;10;200
"4937";"360810407005";8;82;16;2;6;114
"4938";"360810409001";64;19;447;3;14;547
"4939";"360810409002";72;68;180;7;17;344
"4940";"360810409003";21;14;116;2;12;165
"4941";"360810409004";29;9;90;7;9;144
"4942";"360810411001";96;15;85;11;93;300
"4943";"360810411002";43;5;104;17;23;192
"4944";"360810413001";91;35;224;18;63;431
"4945";"360810413002";77;83;225;5;40;430
"4946";"360810414001";87;15;162;204;81;549
"4947";"360810414002";60;16;2;17;16;111
"4948";"360810414003";61;67;82;94;45;349
"4949";"360810415001";104;32;250;27;38;451
"4950";"360810415002";46;16;313;10;14;399
"4951";"360810424001";40;16;94;77;29;256
"4952";"360810424002";15;3;31;30;16;95
"4953";"360810424003";29;12;17;20;6;84
"4954";"360810426001";20;13;18;34;4;89
"4955";"360810427001";74;27;283;8;30;422
"4956";"360810427002";100;55;524;22;41;742
"4957";"360810432001";68;38;61;109;36;312
"4958";"360810434001";62;9;68;93;30;262
"4959";"360810437011";43;11;229;26;16;325
"4960";"360810437012";36;4;121;18;23;202
"4961";"360810437021";109;48;114;26;16;313
"4962";"360810437022";147;16;243;16;10;432
"4963";"360810437023";101;10;355;19;19;504
"4964";"360810439001";109;30;339;21;47;546
"4965";"360810439002";143;95;298;14;30;580
"4966";"360810440001";53;12;223;193;69;550
"4967";"360810440002";95;9;162;147;39;452
"4968";"360810440003";47;7;141;111;42;348
"4969";"360810443011";40;22;175;12;23;272
"4970";"360810443012";52;27;123;27;26;255
"4971";"360810443021";35;4;252;16;27;334
"4972";"360810443022";31;20;127;13;9;200
"4973";"360810443023";102;135;210;45;45;537
"4974";"360810444001";38;11;107;13;33;202
"4975";"360810444002";26;35;213;49;52;375
"4976";"360810444003";74;38;332;172;328;944
"4977";"360810446011";78;75;29;7;62;251
"4978";"360810446012";100;17;66;3;32;218
"4979";"360810446021";64;76;91;20;53;304
"4980";"360810446022";77;27;32;2;29;167
"4981";"360810448001";99;20;107;2;51;279
"4982";"360810448002";24;5;80;11;15;135
"4983";"360810450001";20;4;83;20;31;158
"4984";"360810450002";25;9;42;5;39;120
"4985";"360810452001";55;41;58;2;30;186
"4986";"360810454001";51;24;205;4;57;341
"4987";"360810454002";63;17;157;5;60;302
"4988";"360810455001";244;19;8;0;8;279
"4989";"360810455002";12;7;2;0;2;23
"4990";"360810455003";32;3;3;1;4;43
"4991";"360810455004";48;0;6;0;9;63
"4992";"360810455005";72;0;3;0;10;85
"4993";"360810455006";0;0;10;0;7;17
"4994";"360810456001";48;10;109;12;15;194
"4995";"360810457001";60;6;256;11;16;349
"4996";"360810457002";29;9;277;5;14;334
"4997";"360810458001";119;30;195;10;32;386
"4998";"360810459001";68;8;225;15;48;364
"4999";"360810459002";51;11;141;9;15;227
"5000";"360810460001";56;3;51;0;33;143
"5001";"360810460002";262;50;87;7;35;441
"5002";"360810460003";52;13;31;1;14;111
"5003";"360810461001";69;48;418;9;48;592
"5004";"360810462001";38;6;108;0;30;182
"5005";"360810462002";95;255;212;8;89;659
"5006";"360810462003";82;103;207;3;66;461
"5007";"360810463001";71;26;268;3;23;391
"5008";"360810463002";62;20;162;20;22;286
"5009";"360810464001";94;8;103;16;10;231
"5010";"360810465001";112;84;99;21;45;361
"5011";"360810465002";82;7;156;6;40;291
"5012";"360810466001";40;2;42;1;16;101
"5013";"360810466002";23;12;49;4;32;120
"5014";"360810467001";60;7;100;0;10;177
"5015";"360810467002";74;9;242;1;26;352
"5016";"360810467003";88;11;146;3;24;272
"5017";"360810467004";55;8;51;0;18;132
"5018";"360810468001";54;2;140;11;40;247
"5019";"360810468002";115;45;227;43;71;501
"5020";"360810469001";105;30;148;7;26;316
"5021";"360810469002";93;7;38;2;12;152
"5022";"360810469003";20;4;117;4;14;159
"5023";"360810469004";25;19;14;12;9;79
"5024";"360810469005";62;0;53;0;11;126
"5025";"360810470001";91;20;137;3;53;304
"5026";"360810470002";91;32;171;28;61;383
"5027";"360810471001";207;41;62;5;74;389
"5028";"360810471002";43;5;114;13;36;211
"5029";"360810472001";35;12;38;2;6;93
"5030";"360810472002";52;6;69;27;23;177
"5031";"360810472003";31;6;20;1;6;64
"5032";"360810473001";34;6;226;1;21;288
"5033";"360810473002";31;32;136;7;71;277
"5034";"360810473003";3;0;16;0;1;20
"5035";"360810475001";60;56;325;18;31;490
"5036";"360810475002";41;14;248;6;25;334
"5037";"360810476001";15;9;9;16;54;103
"5038";"360810476002";11;1;16;16;20;64
"5039";"360810478001";17;5;55;26;30;133
"5040";"360810478002";49;5;105;38;18;215
"5041";"360810478003";103;12;153;19;38;325
"5042";"360810479001";74;13;182;22;60;351
"5043";"360810479002";35;20;107;17;60;239
"5044";"360810479003";31;4;275;28;27;365
"5045";"360810480001";223;19;158;51;58;509
"5046";"360810480002";48;16;93;57;28;242
"5047";"360810481001";33;4;126;2;33;198
"5048";"360810481002";76;6;132;4;17;235
"5049";"360810481003";70;14;56;4;95;239
"5050";"360810481004";22;9;13;0;23;67
"5051";"360810482001";49;46;135;63;57;350
"5052";"360810483001";32;6;251;2;23;314
"5053";"360810483002";53;20;414;62;54;603
"5054";"360810484001";46;9;114;28;51;248
"5055";"360810484002";92;13;116;80;50;351
"5056";"360810484003";28;4;128;33;26;219
"5057";"360810484004";58;5;135;71;55;324
"5058";"360810485001";11;12;70;5;13;111
"5059";"360810485002";31;4;47;2;19;103
"5060";"360810485003";46;47;245;10;57;405
"5061";"360810489001";40;16;227;84;56;423
"5062";"360810489002";8;4;106;23;12;153
"5063";"360810492001";147;11;94;29;7;288
"5064";"360810492002";19;2;7;4;21;53
"5065";"360810492003";26;7;114;25;32;204
"5066";"360810493011";40;10;291;82;51;474
"5067";"360810493012";21;6;152;38;25;242
"5068";"360810493021";25;35;155;38;70;323
"5069";"360810493022";34;20;165;46;26;291
"5070";"360810495001";50;9;502;54;27;642
"5071";"360810496001";59;13;85;23;46;226
"5072";"360810496002";64;16;64;44;47;235
"5073";"360810496003";36;7;85;30;29;187
"5074";"360810497001";45;1;203;48;36;333
"5075";"360810497002";19;4;112;48;47;230
"5076";"360810499001";32;20;166;46;41;305
"5077";"360810499002";51;48;282;54;87;522
"5078";"360810499003";24;4;150;57;44;279
"5079";"360810500001";52;53;181;91;41;418
"5080";"360810500002";138;48;148;68;60;462
"5081";"360810502011";60;6;69;101;35;271
"5082";"360810502021";53;8;74;61;48;244
"5083";"360810504001";41;10;30;28;21;130
"5084";"360810504002";20;4;43;21;12;100
"5085";"360810505001";28;3;266;42;18;357
"5086";"360810506001";26;12;28;20;27;113
"5087";"360810506002";14;23;20;60;9;126
"5088";"360810507001";20;5;299;105;70;499
"5089";"360810507002";31;4;99;44;23;201
"5090";"360810508001";62;18;65;38;26;209
"5091";"360810508002";47;35;75;13;33;203
"5092";"360810510001";53;6;23;50;21;153
"5093";"360810510002";21;8;18;21;12;80
"5094";"360810511001";31;9;692;92;22;846
"5095";"360810511002";22;0;265;31;37;355
"5096";"360810512001";10;5;70;52;14;151
"5097";"360810512002";51;4;31;47;20;153
"5098";"360810512003";39;24;33;43;15;154
"5099";"360810513001";60;1;299;99;55;514
"5100";"360810513002";33;0;222;46;19;320
"5101";"360810515001";20;5;118;14;25;182
"5102";"360810515002";42;5;173;21;4;245
"5103";"360810515003";3;4;409;78;30;524
"5104";"360810516001";12;8;25;33;14;92
"5105";"360810516002";26;5;77;39;28;175
"5106";"360810517001";10;6;144;51;23;234
"5107";"360810517002";29;8;156;69;26;288
"5108";"360810518001";43;26;41;32;18;160
"5109";"360810518002";22;6;23;46;27;124
"5110";"360810520001";22;16;76;50;20;184
"5111";"360810521001";10;7;59;39;7;122
"5112";"360810521002";34;20;266;86;35;441
"5113";"360810522001";52;10;72;40;38;212
"5114";"360810524001";42;6;79;27;13;167
"5115";"360810524002";33;5;61;19;21;139
"5116";"360810525001";16;2;377;98;25;518
"5117";"360810525002";42;24;251;213;23;553
"5118";"360810526001";26;6;73;31;45;181
"5119";"360810526002";12;12;59;32;39;154
"5120";"360810528001";21;31;64;38;18;172
"5121";"360810530001";34;6;26;21;14;101
"5122";"360810530002";22;9;71;31;35;168
"5123";"360810531001";35;12;334;217;39;637
"5124";"360810531002";14;8;117;26;15;180
"5125";"360810531003";18;26;202;138;28;412
"5126";"360810532001";29;5;44;40;17;135
"5127";"360810532002";25;6;89;33;16;169
"5128";"360810534011";25;18;99;22;17;181
"5129";"360810534012";30;3;41;22;28;124
"5130";"360810535001";24;103;223;86;69;505
"5131";"360810536011";14;5;22;45;14;100
"5132";"360810536012";14;2;19;42;12;89
"5133";"360810538001";18;3;27;31;11;90
"5134";"360810538002";19;4;23;43;26;115
"5135";"360810539001";79;39;215;100;47;480
"5136";"360810539002";29;29;168;32;18;276
"5137";"360810539003";176;43;142;20;28;409
"5138";"360810540001";117;22;173;123;78;513
"5139";"360810540002";39;138;129;230;52;588
"5140";"360810540003";32;6;70;48;21;177
"5141";"360810542001";55;7;70;29;33;194
"5142";"360810542002";143;13;172;60;100;488
"5143";"360810542003";72;22;173;47;91;405
"5144";"360810542004";61;11;44;50;70;236
"5145";"360810545001";99;29;272;4;15;419
"5146";"360810545002";23;14;86;3;19;145
"5147";"360810545003";108;60;71;3;19;261
"5148";"360810547001";92;254;117;4;16;483
"5149";"360810547002";185;66;69;7;10;337
"5150";"360810547003";90;25;44;1;14;174
"5151";"360810548001";39;8;84;24;43;198
"5152";"360810548002";39;6;90;28;8;171
"5153";"360810549001";64;82;143;5;14;308
"5154";"360810549002";89;62;70;2;17;240
"5155";"360810549003";99;51;51;15;38;254
"5156";"360810549004";1990;92;41;9;24;2156
"5157";"360810551001";39;18;89;3;14;163
"5158";"360810551002";87;128;32;6;21;274
"5159";"360810551003";64;39;35;7;40;185
"5160";"360810551004";78;64;69;3;9;223
"5161";"360810552001";34;8;30;35;24;131
"5162";"360810552002";30;6;119;36;54;245
"5163";"360810553001";67;242;202;4;33;548
"5164";"360810553002";94;314;67;7;30;512
"5165";"360810554001";24;6;81;22;26;159
"5166";"360810554002";51;5;152;40;26;274
"5167";"360810555001";27;20;140;4;13;204
"5168";"360810555002";50;30;231;20;43;374
"5169";"360810556001";53;63;67;16;41;240
"5170";"360810556002";15;3;46;14;9;87
"5171";"360810557001";54;40;157;17;23;291
"5172";"360810557002";77;25;136;16;24;278
"5173";"360810557003";37;16;33;4;18;108
"5174";"360810558001";19;4;37;10;25;95
"5175";"360810558002";90;15;45;40;30;220
"5176";"360810559001";140;100;215;84;53;592
"5177";"360810560001";32;4;33;11;16;96
"5178";"360810560002";45;10;36;12;9;112
"5179";"360810561001";4;30;108;26;11;179
"5180";"360810562001";54;2;74;10;54;194
"5181";"360810564001";69;6;51;16;15;157
"5182";"360810565001";171;49;330;158;21;729
"5183";"360810566001";25;3;36;12;9;85
"5184";"360810566002";55;10;40;17;35;157
"5185";"360810567001";32;7;338;71;15;463
"5186";"360810567002";48;10;645;129;78;910
"5187";"360810567003";98;10;409;108;16;641
"5188";"360810567004";52;6;209;22;25;314
"5189";"360810568001";25;22;101;30;44;222
"5190";"360810568002";76;11;45;45;30;207
"5191";"360810568003";12;13;39;30;34;128
"5192";"360810568004";59;22;127;94;59;361
"5193";"360810577001";21;7;38;7;17;90
"5194";"360810577002";98;35;247;19;37;436
"5195";"360810577003";24;23;226;10;16;299
"5196";"360810579001";35;106;61;13;7;222
"5197";"360810579002";61;4;86;3;7;161
"5198";"360810580001";4;1;22;24;12;63
"5199";"360810580002";15;2;21;12;14;64
"5200";"360810580003";36;5;66;48;11;166
"5201";"360810580004";18;0;35;11;3;67
"5202";"360810581001";16;4;271;26;15;332
"5203";"360810581002";60;46;302;7;17;432
"5204";"360810582001";23;5;165;95;50;338
"5205";"360810582002";42;9;132;73;53;309
"5206";"360810582003";9;4;48;29;19;109
"5207";"360810583001";179;20;66;9;23;297
"5208";"360810583002";23;15;143;0;16;197
"5209";"360810583003";26;14;135;3;42;220
"5210";"360810585001";15;16;69;3;32;135
"5211";"360810585002";39;16;239;38;13;345
"5212";"360810585003";97;78;224;25;29;453
"5213";"360810587001";29;11;286;13;13;352
"5214";"360810587002";11;15;169;10;9;214
"5215";"360810587003";52;16;185;22;23;298
"5216";"360810589001";89;36;282;18;13;438
"5217";"360810589002";40;35;90;6;33;204
"5218";"360810589003";91;527;83;3;20;724
"5219";"360810590001";12;7;28;60;31;138
"5220";"360810591001";72;41;197;10;21;341
"5221";"360810591002";75;53;232;0;16;376
"5222";"360810591003";82;31;324;16;26;479
"5223";"360810591004";72;14;168;4;15;273
"5224";"360810592001";28;3;37;49;22;139
"5225";"360810593001";443;46;186;27;21;723
"5226";"360810593002";34;40;231;23;45;373
"5227";"360810594001";5;1;35;15;11;67
"5228";"360810594002";17;0;11;19;5;52
"5229";"360810595001";18;9;318;141;23;509
"5230";"360810595002";23;52;171;10;14;270
"5231";"360810595003";23;21;76;19;29;168
"5232";"360810595004";54;82;218;10;41;405
"5233";"360810596001";2;2;15;44;8;71
"5234";"360810596002";16;6;9;14;7;52
"5235";"360810598001";11;1;40;8;9;69
"5236";"360810598002";8;7;43;31;23;112
"5237";"360810599001";7;4;201;45;22;279
"5238";"360810599002";19;28;171;83;19;320
"5239";"360810600001";30;60;48;39;16;193
"5240";"360810601001";37;12;397;133;53;632
"5241";"360810601002";87;63;247;79;23;499
"5242";"360810603001";28;14;443;203;22;710
"5243";"360810606001";21;21;45;28;9;124
"5244";"360810606002";22;2;23;28;9;84
"5245";"360810607011";2;2;113;37;6;160
"5246";"360810608001";48;219;84;59;17;427
"5247";"360810610001";69;26;88;45;25;253
"5248";"360810612001";23;3;46;47;16;135
"5249";"360810612002";22;7;57;17;10;113
"5250";"360810613011";64;21;444;44;24;597
"5251";"360810613012";58;69;750;81;51;1009
"5252";"360810613013";72;25;260;18;25;400
"5253";"360810613014";129;66;153;17;8;373
"5254";"360810613021";1;0;4;3;3;11
"5255";"360810614001";16;6;46;17;14;99
"5256";"360810616011";13;1;12;16;3;45
"5257";"360810616012";8;3;7;13;7;38
"5258";"360810616013";36;3;16;8;6;69
"5259";"360810616021";12;1;26;19;17;75
"5260";"360810616022";6;10;31;33;20;100
"5261";"360810618001";3;0;7;4;10;24
"5262";"360810618002";4;37;49;18;16;124
"5263";"360810619001";31;29;342;105;45;552
"5264";"360810619002";54;9;160;14;24;261
"5265";"360810620001";15;4;38;43;9;109
"5266";"360810621001";61;7;156;14;80;318
"5267";"360810621002";37;15;177;43;17;289
"5268";"360810621003";44;4;112;14;14;188
"5269";"360810622001";5;16;27;38;11;97
"5270";"360810622002";14;7;41;37;3;102
"5271";"360810623001";32;9;174;59;14;288
"5272";"360810623002";18;6;356;84;20;484
"5273";"360810624001";0;0;4;0;0;4
"5274";"360810625001";23;17;197;7;15;259
"5275";"360810625002";60;37;429;16;31;573
"5276";"360810626001";8;27;61;37;14;147
"5277";"360810626002";17;7;68;33;19;144
"5278";"360810626003";6;1;15;31;9;62
"5279";"360810627001";97;18;214;6;24;359
"5280";"360810627002";54;11;163;2;43;273
"5281";"360810629001";13;17;290;35;20;375
"5282";"360810629002";23;7;102;13;16;161
"5283";"360810629003";48;26;234;21;12;341
"5284";"360810630001";12;6;37;34;24;113
"5285";"360810630002";25;2;35;53;20;135
"5286";"360810632001";5;3;20;23;24;75
"5287";"360810632002";32;24;80;64;21;221
"5288";"360810633011";26;27;415;156;31;655
"5289";"360810633021";10;7;170;51;19;257
"5290";"360810633022";19;4;355;39;19;436
"5291";"360810635001";14;10;100;24;23;171
"5292";"360810635002";24;4;664;104;41;837
"5293";"360810637001";7;7;372;69;27;482
"5294";"360810637002";14;19;261;103;49;446
"5295";"360810637003";31;70;92;38;19;250
"5296";"360810638001";20;8;70;37;16;151
"5297";"360810638002";20;10;104;31;4;169
"5298";"360810638003";10;1;28;36;6;81
"5299";"360810638004";8;3;33;20;18;82
"5300";"360810638005";16;24;28;17;7;92
"5301";"360810639001";22;11;245;71;24;373
"5302";"360810639002";27;50;404;107;54;642
"5303";"360810641011";36;24;164;46;15;285
"5304";"360810641021";53;210;363;61;33;720
"5305";"360810645001";2;1;30;71;6;110
"5306";"360810645002";18;37;153;35;45;288
"5307";"360810646001";20;4;45;78;12;159
"5308";"360810646002";52;6;32;40;14;144
"5309";"360810650001";12;3;44;37;17;113
"5310";"360810650002";21;11;56;36;26;150
"5311";"360810654001";23;17;40;56;60;196
"5312";"360810654002";32;6;42;32;37;149
"5313";"360810654003";48;2;71;47;11;179
"5314";"360810655011";1;2;51;8;15;77
"5315";"360810656001";90;58;155;67;33;403
"5316";"360810656002";23;2;25;51;14;115
"5317";"360810656003";196;16;155;71;32;470
"5318";"360810657021";36;23;289;44;40;432
"5319";"360810657031";22;24;320;37;54;457
"5320";"360810657032";44;33;142;23;17;259
"5321";"360810657033";7;3;114;49;4;177
"5322";"360810659001";13;2;72;42;12;141
"5323";"360810659002";25;4;227;54;27;337
"5324";"360810660001";37;17;45;41;36;176
"5325";"360810660002";38;5;67;95;27;232
"5326";"360810661001";15;3;71;17;21;127
"5327";"360810663001";6;0;151;13;12;182
"5328";"360810663002";8;7;62;36;21;134
"5329";"360810663003";7;15;90;44;22;178
"5330";"360810664001";7;1;33;14;17;72
"5331";"360810664002";30;5;117;52;44;248
"5332";"360810664003";14;2;42;35;10;103
"5333";"360810664004";92;4;69;35;13;213
"5334";"360810664005";16;6;49;21;16;108
"5335";"360810664006";21;6;45;25;7;104
"5336";"360810664007";21;10;92;36;16;175
"5337";"360810664008";44;3;87;42;16;192
"5338";"360810665011";5;7;109;25;18;164
"5339";"360810665012";18;3;197;45;17;280
"5340";"360810665013";37;17;164;23;21;262
"5341";"360810665014";60;8;91;10;24;193
"5342";"360810667011";63;44;339;77;42;565
"5343";"360810667012";6;6;168;24;20;224
"5344";"360810669001";51;1;230;21;72;375
"5345";"360810669002";9;5;525;56;25;620
"5346";"360810671001";19;7;86;38;41;191
"5347";"360810671002";16;3;126;83;63;291
"5348";"360810677001";6;3;51;25;4;89
"5349";"360810677002";8;5;115;35;19;182
"5350";"360810679001";0;2;112;26;2;142
"5351";"360810679002";146;11;93;16;15;281
"5352";"360810679003";26;115;382;100;21;644
"5353";"360810680001";12;6;75;65;25;183
"5354";"360810680002";31;6;79;59;27;202
"5355";"360810680003";15;7;50;59;23;154
"5356";"360810680004";31;2;178;40;27;278
"5357";"360810682001";6;3;45;26;15;95
"5358";"360810682002";16;2;28;26;20;92
"5359";"360810683001";158;11;39;3;26;237
"5360";"360810683002";60;5;29;0;32;126
"5361";"360810683003";11;5;61;15;18;110
"5362";"360810687001";18;4;24;0;12;58
"5363";"360810687002";28;7;179;2;22;238
"5364";"360810687003";44;10;540;18;72;684
"5365";"360810690001";43;17;109;88;43;300
"5366";"360810690002";77;9;88;105;24;303
"5367";"360810693001";72;22;224;7;40;365
"5368";"360810693002";30;7;112;4;11;164
"5369";"360810694001";62;9;142;55;29;297
"5370";"360810694002";80;27;126;89;11;333
"5371";"360810695001";23;7;204;9;21;264
"5372";"360810695002";18;8;123;15;17;181
"5373";"360810697011";42;11;52;2;10;117
"5374";"360810697012";33;3;197;1;20;254
"5375";"360810697013";69;3;67;1;7;147
"5376";"360810697021";2;2;54;20;17;95
"5377";"360810697022";5;0;22;14;12;53
"5378";"360810697023";29;4;102;28;18;181
"5379";"360810697024";30;8;53;23;14;128
"5380";"360810703001";16;6;83;57;18;180
"5381";"360810703002";19;9;707;18;49;802
"5382";"360810707001";2;3;47;1;2;55
"5383";"360810707002";3;0;16;4;10;33
"5384";"360810707003";31;9;61;1;9;111
"5385";"360810709001";28;2;89;8;6;133
"5386";"360810709002";13;9;98;1;53;174
"5387";"360810711001";17;13;53;2;0;85
"5388";"360810711002";85;108;201;14;60;468
"5389";"360810711003";22;16;37;17;4;96
"5390";"360810711004";12;41;44;3;70;170
"5391";"360810713031";50;16;119;1;4;190
"5392";"360810713032";99;45;85;0;26;255
"5393";"360810713033";74;14;22;0;5;115
"5394";"360810713041";27;10;34;10;3;84
"5395";"360810713042";26;6;40;4;2;78
"5396";"360810713043";13;1;4;0;3;21
"5397";"360810713044";59;16;117;4;8;204
"5398";"360810713051";34;1;28;0;5;68
"5399";"360810713052";5;9;48;2;5;69
"5400";"360810713053";47;22;169;0;9;247
"5401";"360810713061";140;13;191;1;1;346
"5402";"360810713062";79;21;195;2;17;314
"5403";"360810713063";33;11;57;5;40;146
"5404";"360810713064";75;29;62;0;20;186
"5405";"360810716001";0;2;200;2;13;217
"5406";"360810717011";51;13;46;1;3;114
"5407";"360810717012";56;12;107;2;20;197
"5408";"360810717013";10;5;8;1;4;28
"5409";"360810717014";27;10;152;7;22;218
"5410";"360810717021";13;32;210;7;36;298
"5411";"360810717022";7;13;60;5;2;87
"5412";"360810719001";113;11;155;9;19;307
"5413";"360810719002";161;14;240;1;31;447
"5414";"360810721001";35;6;39;3;9;92
"5415";"360810721002";15;0;13;1;5;34
"5416";"360810721003";329;3;167;5;15;519
"5417";"360810721004";9;5;91;0;8;113
"5418";"360810721005";12;7;561;1;5;586
"5419";"360810723001";1;10;19;3;7;40
"5420";"360810723002";0;3;32;9;5;49
"5421";"360810723003";7;5;43;2;6;63
"5422";"360810729001";23;7;36;3;9;78
"5423";"360810729002";32;13;102;1;29;177
"5424";"360810731001";9;23;18;7;9;66
"5425";"360810731002";28;21;39;4;14;106
"5426";"360810737001";31;69;35;4;67;206
"5427";"360810737002";7;6;16;1;15;45
"5428";"360810739001";2;1;11;0;1;15
"5429";"360810739002";9;8;41;0;2;60
"5430";"360810739003";17;8;18;0;14;57
"5431";"360810739004";11;10;44;1;13;79
"5432";"360810739005";6;12;24;0;6;48
"5433";"360810741001";12;5;32;0;2;51
"5434";"360810741002";31;9;82;6;1;129
"5435";"360810741003";18;2;11;2;0;33
"5436";"360810741004";5;12;42;4;4;67
"5437";"360810743001";4;0;29;6;9;48
"5438";"360810743002";27;3;86;0;14;130
"5439";"360810743003";85;34;120;2;14;255
"5440";"360810743004";27;18;36;2;7;90
"5441";"360810745001";76;7;80;4;9;176
"5442";"360810745002";108;13;47;0;16;184
"5443";"360810747001";32;17;116;17;19;201
"5444";"360810747002";18;5;140;12;6;181
"5445";"360810749001";0;1;10;4;6;21
"5446";"360810749002";7;10;10;1;3;31
"5447";"360810757011";41;112;124;4;16;297
"5448";"360810757012";37;21;17;2;5;82
"5449";"360810757013";52;12;47;2;19;132
"5450";"360810757021";19;4;42;3;6;74
"5451";"360810757022";13;7;145;7;16;188
"5452";"360810757023";14;3;12;2;1;32
"5453";"360810769011";12;9;14;12;7;54
"5454";"360810769012";181;21;39;1;16;258
"5455";"360810769021";29;26;107;8;44;214
"5456";"360810773001";46;212;160;6;25;449
"5457";"360810773002";11;6;62;2;35;116
"5458";"360810775001";22;6;65;1;12;106
"5459";"360810775002";36;12;74;0;15;137
"5460";"360810775003";14;166;146;1;17;344
"5461";"360810779021";2;1;33;1;8;45
"5462";"360810779022";13;5;38;3;8;67
"5463";"360810779023";1;3;40;8;8;60
"5464";"360810779024";8;2;10;5;0;25
"5465";"360810779025";13;5;123;10;9;160
"5466";"360810779031";3;1;27;0;7;38
"5467";"360810779032";6;3;48;3;1;61
"5468";"360810779033";15;4;29;2;2;52
"5469";"360810779041";13;2;19;5;22;61
"5470";"360810779042";95;5;116;16;25;257
"5471";"360810779043";43;14;63;1;8;129
"5472";"360810779044";8;4;41;7;5;65
"5473";"360810779051";52;32;86;31;23;224
"5474";"360810779052";2;5;38;1;1;47
"5475";"360810779061";21;6;74;3;13;117
"5476";"360810779062";33;13;206;77;52;381
"5477";"360810779071";42;9;71;14;20;156
"5478";"360810779072";19;3;72;5;26;125
"5479";"360810779081";30;11;17;0;7;65
"5480";"360810779082";90;8;32;9;4;143
"5481";"360810788001";45;14;56;44;47;206
"5482";"360810788002";65;6;53;45;8;177
"5483";"360810790001";54;24;82;55;40;255
"5484";"360810790002";158;17;141;125;49;490
"5485";"360810792001";126;23;113;76;26;364
"5486";"360810792002";76;16;128;56;33;309
"5487";"360810793001";3;0;9;1;1;14
"5488";"360810797011";19;4;43;0;2;68
"5489";"360810797012";108;1;4;0;10;123
"5490";"360810797013";7;2;3;0;7;19
"5491";"360810797014";8;2;21;0;24;55
"5492";"360810797021";5;10;159;5;22;201
"5493";"360810797022";53;7;108;2;32;202
"5494";"360810797023";52;4;58;4;10;128
"5495";"360810799001";17;29;343;94;64;547
"5496";"360810799002";36;15;372;3;70;496
"5497";"360810803011";29;16;93;6;32;176
"5498";"360810803012";22;0;279;2;32;335
"5499";"360810803013";44;7;188;27;35;301
"5500";"360810803021";2;3;201;26;19;251
"5501";"360810803022";34;3;150;51;32;270
"5502";"360810803023";6;2;104;27;31;170
"5503";"360810809001";7;3;34;4;1;49
"5504";"360810809002";28;3;63;1;1;96
"5505";"360810809003";19;2;88;3;9;121
"5506";"360810809004";4;4;131;20;51;210
"5507";"360810809005";1;1;32;14;13;61
"5508";"360810809006";6;1;18;18;2;45
"5509";"360810809007";19;5;132;73;5;234
"5510";"360810814001";42;4;196;56;61;359
"5511";"360810814002";55;13;95;31;51;245
"5512";"360810814003";49;9;61;42;28;189
"5513";"360810818001";85;42;128;41;60;356
"5514";"360810818002";67;49;88;87;26;317
"5515";"360810818003";58;10;124;44;47;283
"5516";"360810837001";75;28;105;29;67;304
"5517";"360810837002";14;1;196;50;32;293
"5518";"360810837003";24;4;152;34;26;240
"5519";"360810837004";9;8;83;8;40;148
"5520";"360810838001";50;8;164;135;37;394
"5521";"360810838002";83;12;97;70;35;297
"5522";"360810838003";50;8;204;85;44;391
"5523";"360810838004";62;9;167;45;42;325
"5524";"360810840001";123;35;187;46;71;462
"5525";"360810840002";206;83;118;31;68;506
"5526";"360810840003";37;42;134;34;44;291
"5527";"360810840004";62;6;164;36;52;320
"5528";"360810840005";121;7;125;43;75;371
"5529";"360810845001";3;0;4;0;6;13
"5530";"360810845002";120;17;27;0;12;176
"5531";"360810845003";8;6;440;21;139;614
"5532";"360810846011";94;10;250;119;66;539
"5533";"360810846012";120;11;174;67;35;407
"5534";"360810846021";41;8;261;174;34;518
"5535";"360810849001";59;13;147;1;44;264
"5536";"360810849002";84;39;55;3;38;219
"5537";"360810849003";40;3;161;3;27;234
"5538";"360810849004";10;21;149;46;61;287
"5539";"360810853001";10;19;97;5;59;190
"5540";"360810853002";13;3;19;4;23;62
"5541";"360810853003";16;17;383;1;20;437
"5542";"360810853004";7;9;26;0;7;49
"5543";"360810855001";24;12;11;0;19;66
"5544";"360810855002";54;4;27;0;18;103
"5545";"360810855003";24;1;101;2;16;144
"5546";"360810855004";30;20;62;3;15;130
"5547";"360810857001";19;21;46;2;12;100
"5548";"360810857002";33;3;91;0;28;155
"5549";"360810857003";94;5;75;2;27;203
"5550";"360810859001";26;8;41;1;21;97
"5551";"360810859002";27;11;109;1;97;245
"5552";"360810859003";42;36;79;3;26;186
"5553";"360810861001";59;5;35;0;9;108
"5554";"360810861002";11;11;101;2;38;163
"5555";"360810863001";34;5;13;0;2;54
"5556";"360810863002";6;6;70;1;5;88
"5557";"360810863003";71;3;8;0;6;88
"5558";"360810863004";60;6;107;0;17;190
"5559";"360810864001";70;19;182;35;76;382
"5560";"360810864002";51;35;72;30;20;208
"5561";"360810865001";42;24;121;4;22;213
"5562";"360810865002";30;53;96;9;50;238
"5563";"360810869001";19;19;235;14;104;391
"5564";"360810869002";7;1;239;25;63;335
"5565";"360810871001";143;32;63;2;59;299
"5566";"360810871002";35;40;139;6;109;329
"5567";"360810884001";35;18;76;57;29;215
"5568";"360810884002";1;7;56;14;27;105
"5569";"360810884003";9;2;30;17;13;71
"5570";"360810884004";10;7;92;21;23;153
"5571";"360810884005";64;10;36;21;17;148
"5572";"360810884006";34;9;187;54;33;317
"5573";"360810884007";7;5;28;16;11;67
"5574";"360810884008";3;7;109;44;25;188
"5575";"360810889011";106;7;166;50;23;352
"5576";"360810889012";27;7;27;6;3;70
"5577";"360810889013";31;6;23;2;7;69
"5578";"360810889014";34;10;62;1;21;128
"5579";"360810889015";50;10;26;0;1;87
"5580";"360810889016";207;23;40;0;27;297
"5581";"360810889017";38;9;91;0;23;161
"5582";"360810892001";2;0;33;11;27;73
"5583";"360810892002";56;43;38;26;13;176
"5584";"360810892003";21;6;72;45;13;157
"5585";"360810892004";17;3;38;10;24;92
"5586";"360810892005";23;14;70;20;38;165
"5587";"360810892006";5;3;15;9;20;52
"5588";"360810892007";13;3;19;16;12;63
"5589";"360810892008";6;65;39;22;20;152
"5590";"360810907001";43;36;284;108;53;524
"5591";"360810916011";0;0;3;1;2;6
"5592";"360810916012";1;1;1;0;1;4
"5593";"360810916013";88;32;2;0;6;128
"5594";"360810916014";6;0;16;3;7;32
"5595";"360810916021";0;1;5;0;0;6
"5596";"360810918001";0;0;8;0;0;8
"5597";"360810919001";17;3;111;22;28;181
"5598";"360810919002";91;71;324;60;41;587
"5599";"360810919003";75;9;240;49;42;415
"5600";"360810922001";8;3;7;2;20;40
"5601";"360810922002";0;1;56;0;11;68
"5602";"360810922003";1;3;93;0;13;110
"5603";"360810925001";87;24;215;92;37;455
"5604";"360810925002";58;17;191;33;37;336
"5605";"360810925003";81;29;258;28;28;424
"5606";"360810928001";20;18;44;3;33;118
"5607";"360810928002";13;5;12;3;5;38
"5608";"360810928003";5;2;14;2;6;29
"5609";"360810929001";243;37;365;216;83;944
"5610";"360810929002";123;15;341;96;73;648
"5611";"360810929003";32;3;176;43;13;267
"5612";"360810929004";8;3;67;7;30;115
"5613";"360810934010";14;5;5;0;2;26
"5614";"360810934011";10;15;44;6;19;94
"5615";"360810934012";18;4;235;7;13;277
"5616";"360810934013";7;16;80;0;7;110
"5617";"360810934021";136;10;183;6;19;354
"5618";"360810934022";10;8;121;1;3;143
"5619";"360810934023";51;8;245;6;30;340
"5620";"360810938001";17;5;20;2;32;76
"5621";"360810938002";121;28;297;6;43;495
"5622";"360810938003";145;129;173;10;153;610
"5623";"360810939001";89;10;229;78;50;456
"5624";"360810939002";49;22;243;40;44;398
"5625";"360810939003";67;9;168;91;38;373
"5626";"360810942011";176;113;284;28;88;689
"5627";"360810942021";327;52;151;19;9;558
"5628";"360810942022";166;109;214;14;53;556
"5629";"360810942031";76;36;72;21;25;230
"5630";"360810942032";16;34;39;0;10;99
"5631";"360810942033";37;8;28;0;5;78
"5632";"360810942034";7;30;11;0;6;54
"5633";"360810942035";32;14;15;5;4;70
"5634";"360810945000";2;2;4;1;0;9
"5635";"360810945001";69;62;156;63;47;397
"5636";"360810945002";59;33;183;99;72;446
"5637";"360810947001";34;36;231;59;33;393
"5638";"360810947002";130;8;193;88;37;456
"5639";"360810954001";112;6;55;30;31;234
"5640";"360810954002";76;15;42;26;24;183
"5641";"360810954003";56;18;64;17;35;190
"5642";"360810964001";50;17;76;76;28;247
"5643";"360810964002";84;63;167;56;55;425
"5644";"360810972021";145;7;13;10;16;191
"5645";"360810972031";54;22;67;37;18;198
"5646";"360810972032";92;22;8;9;4;135
"5647";"360810972033";46;11;27;3;2;89
"5648";"360810972034";173;22;6;3;9;213
"5649";"360810972041";49;6;3;3;4;65
"5650";"360810972042";44;16;248;33;16;357
"5651";"360810972043";21;0;23;9;1;54
"5652";"360810973001";6;52;27;28;10;123
"5653";"360810973002";5;14;36;11;13;79
"5654";"360810973003";7;1;6;21;6;41
"5655";"360810981001";18;7;40;17;18;100
"5656";"360810981002";19;102;81;20;36;258
"5657";"360810987001";20;9;80;39;21;169
"5658";"360810987002";96;40;115;19;42;312
"5659";"360810991001";8;3;115;25;10;161
"5660";"360810991002";11;1;66;3;0;81
"5661";"360810991003";0;4;29;14;5;52
"5662";"360810991004";13;2;42;17;18;92
"5663";"360810991005";15;5;62;32;30;144
"5664";"360810992001";161;18;45;24;38;286
"5665";"360810992002";883;39;73;30;12;1037
"5666";"360810997011";8;11;17;20;10;66
"5667";"360810997012";35;2;17;16;21;91
"5668";"360810997013";8;3;45;21;4;81
"5669";"360810997031";84;14;139;67;12;316
"5670";"360810997032";1;2;20;1;1;25
"5671";"360810997033";23;13;38;23;13;110
"5672";"360810997041";92;4;83;13;3;195
"5673";"360810997042";35;1;96;8;6;146
"5674";"360810997043";14;4;157;13;1;189
"5675";"360810997044";18;11;71;5;6;111
"5676";"360810997051";9;6;74;25;17;131
"5677";"360810998011";34;7;106;31;20;198
"5678";"360810998012";105;4;31;5;9;154
"5679";"360810998013";48;3;118;11;28;208
"5680";"360810998014";2;2;7;1;0;12
"5681";"360810998015";84;7;93;26;19;229
"5682";"360810998021";55;30;68;93;29;275
"5683";"360810998022";90;1;4;3;5;103
"5684";"360810998023";4;5;5;0;4;18
"5685";"360810999001";1;1;1;0;0;3
"5686";"360811008011";31;11;34;26;15;117
"5687";"360811008012";28;7;42;37;30;144
"5688";"360811008021";77;14;226;16;53;386
"5689";"360811008022";47;1;75;12;21;156
"5690";"360811008023";52;5;52;23;17;149
"5691";"360811008024";62;21;59;20;20;182
"5692";"360811010011";117;18;204;10;31;380
"5693";"360811010012";46;4;103;17;6;176
"5694";"360811010013";46;103;122;27;19;317
"5695";"360811010014";96;14;38;9;31;188
"5696";"360811010021";8;1;42;26;7;84
"5697";"360811010022";216;102;149;23;35;525
"5698";"360811017001";7;1;65;24;28;125
"5699";"360811017002";12;3;39;43;18;115
"5700";"360811017003";2;12;84;7;11;116
"5701";"360811017004";2;8;111;19;9;149
"5702";"360811017005";1;9;40;12;19;81
"5703";"360811017006";1;24;89;27;15;156
"5704";"360811017007";13;23;59;24;11;130
"5705";"360811029001";16;17;171;60;66;330
"5706";"360811029002";14;55;176;11;19;275
"5707";"360811032011";72;6;111;36;34;259
"5708";"360811032012";155;13;105;11;28;312
"5709";"360811032013";69;15;31;5;25;145
"5710";"360811032021";36;22;98;20;34;210
"5711";"360811032022";7;3;47;12;3;72
"5712";"360811032023";119;17;110;16;7;269
"5713";"360811032024";101;49;154;3;18;325
"5714";"360811033001";13;6;74;33;32;158
"5715";"360811033002";22;3;105;15;21;166
"5716";"360811033003";7;1;34;14;13;69
"5717";"360811033004";8;3;25;4;15;55
"5718";"360811039001";33;6;141;35;20;235
"5719";"360811039002";66;8;248;63;39;424
"5720";"360811039003";22;24;96;31;20;193
"5721";"360811039004";17;43;57;47;15;179
"5722";"360811047001";12;14;183;61;33;303
"5723";"360811047002";16;19;64;50;29;178
"5724";"360811047003";39;6;133;81;37;296
"5725";"360811047004";12;3;231;18;15;279
"5726";"360811047005";29;8;259;43;32;371
"5727";"360811059001";7;7;33;3;19;69
"5728";"360811059002";17;2;23;12;33;87
"5729";"360811059003";8;9;8;5;8;38
"5730";"360811059004";19;2;47;17;11;96
"5731";"360811072011";18;15;314;77;43;467
"5732";"360811072020";3;6;0;2;1;12
"5733";"360811085001";4;1;47;18;25;95
"5734";"360811085002";9;8;76;18;32;143
"5735";"360811085003";5;2;105;26;26;164
"5736";"360811093001";8;1;26;11;6;52
"5737";"360811093002";7;5;10;7;11;40
"5738";"360811093003";7;2;12;7;4;32
"5739";"360811097001";1;3;12;8;13;37
"5740";"360811097002";19;13;64;12;11;119
"5741";"360811097003";4;6;22;3;10;45
"5742";"360811099001";13;5;77;44;57;196
"5743";"360811099002";6;4;31;17;28;86
"5744";"360811099003";18;75;90;22;47;252
"5745";"360811113001";13;5;42;7;10;77
"5746";"360811113002";3;3;55;16;20;97
"5747";"360811113003";6;0;44;16;11;77
"5748";"360811123001";24;4;152;23;28;231
"5749";"360811123002";29;254;257;13;41;594
"5750";"360811129001";18;2;50;4;13;87
"5751";"360811129002";3;0;16;9;5;33
"5752";"360811129003";34;3;86;15;14;152
"5753";"360811133001";2;0;43;7;6;58
"5754";"360811133002";15;0;44;10;25;94
"5755";"360811139001";7;0;107;15;7;136
"5756";"360811139002";108;2;117;12;22;261
"5757";"360811139003";26;4;82;24;15;151
"5758";"360811141001";7;16;56;30;44;153
"5759";"360811141002";16;10;34;6;12;78
"5760";"360811147001";14;0;52;24;28;118
"5761";"360811147002";26;1;36;6;48;117
"5762";"360811151001";4;124;40;25;82;275
"5763";"360811155001";65;1;64;2;14;146
"5764";"360811155002";16;75;41;1;62;195
"5765";"360811157001";6;9;92;3;18;128
"5766";"360811157002";45;23;74;2;44;188
"5767";"360811157003";50;5;51;2;18;126
"5768";"360811159001";11;1;56;5;10;83
"5769";"360811159002";18;1;164;4;32;219
"5770";"360811159003";83;2;123;0;17;225
"5771";"360811161001";49;7;158;1;20;235
"5772";"360811161002";40;13;43;0;20;116
"5773";"360811163001";95;5;15;0;9;124
"5774";"360811163002";52;4;83;6;18;163
"5775";"360811163003";23;39;122;1;15;200
"5776";"360811163004";77;11;62;0;12;162
"5777";"360811163005";11;9;143;11;25;199
"5778";"360811167001";49;40;1325;20;59;1493
"5779";"360811171001";24;23;156;21;42;266
"5780";"360811171002";26;7;81;0;26;140
"5781";"360811171003";41;5;77;19;35;177
"5782";"360811175001";12;7;104;5;29;157
"5783";"360811175002";29;21;121;5;17;193
"5784";"360811175003";10;5;91;9;9;124
"5785";"360811175004";15;50;188;37;33;323
"5786";"360811181001";11;7;116;16;25;175
"5787";"360811181002";37;3;199;53;48;340
"5788";"360811185001";22;10;198;39;22;291
"5789";"360811185002";41;9;97;21;42;210
"5790";"360811187001";5;1;37;8;12;63
"5791";"360811187002";19;8;431;6;27;491
"5792";"360811189001";26;3;194;49;41;313
"5793";"360811189002";1;3;96;10;25;135
"5794";"360811191001";69;9;236;27;35;376
"5795";"360811191002";36;4;150;28;32;250
"5796";"360811193001";9;2;79;17;23;130
"5797";"360811193002";71;9;138;8;15;241
"5798";"360811195001";38;18;139;48;87;330
"5799";"360811199001";56;7;161;37;40;301
"5800";"360811201001";35;7;181;16;42;281
"5801";"360811203001";14;1;69;9;33;126
"5802";"360811203002";13;1;53;0;35;102
"5803";"360811205001";20;35;385;5;45;490
"5804";"360811207001";22;13;65;23;27;150
"5805";"360811207002";9;5;152;56;58;280
"5806";"360811211001";3;23;25;2;12;65
"5807";"360811215001";40;4;208;60;33;345
"5808";"360811215002";28;6;227;21;57;339
"5809";"360811215003";30;9;320;51;44;454
"5810";"360811223001";14;5;141;22;24;206
"5811";"360811223002";6;3;94;32;26;161
"5812";"360811223003";91;10;113;43;48;305
"5813";"360811227011";46;9;226;41;27;349
"5814";"360811227012";5;7;149;27;16;204
"5815";"360811227013";30;911;247;9;203;1400
"5816";"360811227014";10;2;67;3;0;82
"5817";"360811227015";92;2;67;19;7;187
"5818";"360811227016";3;2;17;2;0;24
"5819";"360811227017";60;15;45;13;7;140
"5820";"360811227021";380;2;3;23;2;410
"5821";"360811227022";54;9;63;5;13;144
"5822";"360811227023";773;16;14;12;17;832
"5823";"360811227024";16;3;94;33;31;177
"5824";"360811227025";102;37;49;8;9;205
"5825";"360811241001";84;1;100;40;22;247
"5826";"360811241002";25;4;42;4;23;98
"5827";"360811241003";89;6;91;16;36;238
"5828";"360811247001";17;7;35;38;15;112
"5829";"360811247002";38;1;38;30;24;131
"5830";"360811247003";41;5;89;36;37;208
"5831";"360811257001";31;21;207;11;26;296
"5832";"360811257002";312;2745;448;6;216;3727
"5833";"360811257003";1227;2163;2846;1;621;6858
"5834";"360811265001";19;17;42;18;17;113
"5835";"360811265002";21;2011;93;8;57;2190
"5836";"360811267001";65;24;86;11;20;206
"5837";"360811267002";23;4933;216;19;77;5268
"5838";"360811267003";78;7;56;34;38;213
"5839";"360811277001";41;6;24;23;21;115
"5840";"360811277002";30;6;46;9;22;113
"5841";"360811277003";20;2;31;10;11;74
"5842";"360811277004";4;3;30;13;12;62
"5843";"360811283001";5;37;153;6;13;214
"5844";"360811291021";17;4;24;17;20;82
"5845";"360811291022";26;8;15;13;11;73
"5846";"360811291023";8;2;7;4;17;38
"5847";"360811291024";19;20;20;3;10;72
"5848";"360811291031";15;7;36;3;9;70
"5849";"360811291032";28;8;30;7;3;76
"5850";"360811291033";35;1;20;5;32;93
"5851";"360811291041";4;1;1;2;6;14
"5852";"360811291042";4;41;45;8;6;104
"5853";"360811291043";15;18;49;7;7;96
"5854";"360811291044";1;3;12;10;1;27
"5855";"360811291045";7;0;113;17;1;138
"5856";"360811301001";1;0;42;19;17;79
"5857";"360811301002";4;3;31;5;3;46
"5858";"360811301003";79;13;57;28;17;194
"5859";"360811301004";9;2;34;17;19;81
"5860";"360811333001";21;3;176;50;6;256
"5861";"360811333002";7;2;56;9;13;87
"5862";"360811333003";44;3;87;16;19;169
"5863";"360811333004";39;8;142;17;6;212
"5864";"360811339001";47;2;131;26;23;229
"5865";"360811341001";5;4;109;19;23;160
"5866";"360811341002";24;4;61;28;49;166
"5867";"360811341003";10;4;64;17;33;128
"5868";"360811347001";36;2;108;14;16;176
"5869";"360811347002";24;3;59;15;6;107
"5870";"360811347003";35;3;30;37;3;108
"5871";"360811347004";56;7;57;4;14;138
"5872";"360811347005";53;11;177;24;8;273
"5873";"360811367001";31;22;143;8;20;224
"5874";"360811367002";8;0;42;6;10;66
"5875";"360811367003";10;1;17;0;0;28
"5876";"360811367004";13;2;26;2;8;51
"5877";"360811367005";6;2;116;49;5;178
"5878";"360811377001";10;0;77;9;6;102
"5879";"360811377002";14;13;83;21;5;136
"5880";"360811377003";37;3;117;6;24;187
"5881";"360811377004";4;3;57;11;25;100
"5882";"360811385011";6;9;55;6;10;86
"5883";"360811385012";20;2;72;6;22;122
"5884";"360811385013";1;2;39;10;33;85
"5885";"360811385014";3;4;77;15;34;133
"5886";"360811385021";6;17;50;16;9;98
"5887";"360811399001";1;2;67;20;29;119
"5888";"360811399002";6;0;33;8;18;65
"5889";"360811403001";5;5;28;13;15;66
"5890";"360811403002";3;37;32;21;7;100
"5891";"360811409011";4;1;34;13;12;64
"5892";"360811409021";8;1;133;22;47;211
"5893";"360811409022";6;15;74;28;27;150
"5894";"360811417001";4;0;27;14;20;65
"5895";"360811417002";8;10;36;7;21;82
"5896";"360811417003";6;1;17;8;13;45
"5897";"360811417004";10;4;41;9;26;90
"5898";"360811417005";6;11;85;6;5;113
"5899";"360811429001";1;3;25;14;43;86
"5900";"360811429002";29;4;64;13;21;131
"5901";"360811429003";12;1;16;15;24;68
"5902";"360811429004";11;11;26;18;28;94
"5903";"360811435001";12;2;70;13;38;135
"5904";"360811435002";5;5;21;16;19;66
"5905";"360811441001";10;1;35;4;10;60
"5906";"360811441002";8;1;34;8;1;52
"5907";"360811441003";21;3;25;8;4;61
"5908";"360811441004";1;0;37;6;25;69
"5909";"360811447001";22;5;117;28;27;199
"5910";"360811447002";23;17;195;50;35;320
"5911";"360811451011";17;16;99;10;30;172
"5912";"360811451021";7;2;45;11;29;94
"5913";"360811451022";7;5;44;36;14;106
"5914";"360811459001";8;10;36;13;23;90
"5915";"360811459002";9;16;79;19;43;166
"5916";"360811459003";17;5;62;21;25;130
"5917";"360811463001";20;7;166;40;60;293
"5918";"360811463002";10;9;111;36;24;190
"5919";"360811467001";48;59;273;34;29;443
"5920";"360811467002";31;5;18;8;4;66
"5921";"360811467003";12;1;120;34;32;199
"5922";"360811471001";62;15;229;49;56;411
"5923";"360811471002";20;9;63;12;14;118
"5924";"360811479001";4;9;119;11;26;169
"5925";"360811479002";15;8;136;12;22;193
"5926";"360811479003";16;15;176;22;13;242
"5927";"360811483001";47;8;86;11;13;165
"5928";"360811483002";3;1;85;16;11;116
"5929";"360811483003";15;7;14;16;15;67
"5930";"360811483004";4;7;12;2;14;39
"5931";"360811507011";9;3;20;9;24;65
"5932";"360811507012";16;5;38;18;14;91
"5933";"360811507013";3;3;30;18;4;58
"5934";"360811507021";30;0;29;4;22;85
"5935";"360811507022";1;0;17;8;8;34
"5936";"360811507023";3;1;34;15;2;55
"5937";"360811507024";5;109;152;10;22;298
"5938";"360811529011";10;1;57;19;16;103
"5939";"360811529012";32;3;234;36;31;336
"5940";"360811529013";4;32;75;17;19;147
"5941";"360811529021";6;0;5;8;6;25
"5942";"360811529022";6;4;16;5;5;36
"5943";"360811529023";16;2;94;19;15;146
"5944";"360811529024";3;7;30;7;7;54
"5945";"360811551011";6;1;1;0;1;9
"5946";"360811551021";4;1;110;12;3;130
"5947";"360811551022";1;0;8;7;5;21
"5948";"360811551023";25;51;224;7;22;329
"5949";"360811551024";3;19;21;22;10;75
"5950";"360811551025";6;1;16;1;3;27
"5951";"360811551026";3;1;52;8;1;65
"5952";"360811567001";22;11;29;11;19;92
"5953";"360811571011";3;0;19;4;7;33
"5954";"360811571012";1;18;55;15;22;111
"5955";"360811571013";4;1;11;8;0;24
"5956";"360811571014";17;2;12;8;3;42
"5957";"360811571015";30;0;35;9;18;92
"5958";"360811571016";27;3;39;31;24;124
"5959";"360811571017";10;9;42;22;42;125
"5960";"360811571018";10;1;13;1;22;47
"5961";"360811571021";9;1;65;29;15;119
"5962";"360811571022";13;5;48;10;32;108
"5963";"360811579011";12;1;15;4;21;53
"5964";"360811579012";11;1;33;5;43;93
"5965";"360811579013";2;2;15;11;9;39
"5966";"360811579014";3;0;16;6;4;29
"5967";"360811579015";3;4;37;12;31;87
"5968";"360811579016";7;5;23;4;15;54
"5969";"360811579021";8;5;18;13;18;62
"5970";"360811579022";38;4;25;9;13;89
"5971";"360811579023";38;84;26;9;9;166
"5972";"360811579024";15;1;14;9;15;54
"5973";"360811579025";16;35;47;10;33;141
"5974";"360811579031";18;3;47;10;37;115
"5975";"360811579032";45;31;46;9;19;150
"5976";"360811579033";18;3;105;44;43;213
"5977";"360811579034";19;10;64;63;38;194
"5978";"360811617001";30;7;64;36;28;165
"5979";"360811617002";8;1;9;8;25;51
"5980";"360811617003";15;0;28;13;94;150
"5981";"360811617004";34;7;192;59;36;328
"5982";"360811621001";17;4;34;17;21;93
"5983";"360811621002";104;7;114;23;27;275
"5984";"360811621003";47;11;30;19;22;129
"5985";"360811621004";17;1;36;16;19;89
"5986";"360811621005";56;9;104;26;39;234
"5987";"360850003001";64;7;55;6;25;157
"5988";"360850003002";21;37;69;21;34;182
"5989";"360850006001";24;181;39;15;23;282
"5990";"360850006002";31;16;105;26;36;214
"5991";"360850007001";104;209;395;17;17;742
"5992";"360850007002";23;8;181;22;3;237
"5993";"360850007003";32;35;85;27;5;184
"5994";"360850007004";456;23;128;5;10;622
"5995";"360850008001";32;12;114;37;53;248
"5996";"360850008002";59;5;182;46;19;311
"5997";"360850008003";44;14;75;21;25;179
"5998";"360850009001";160;30;608;48;30;876
"5999";"360850009002";118;7;20;33;9;187
"6000";"360850011001";41;18;80;38;47;224
"6001";"360850011002";43;7;84;21;45;200
"6002";"360850011003";31;6;74;29;20;160
"6003";"360850017001";0;0;23;2;8;33
"6004";"360850017002";32;5;45;84;9;175
"6005";"360850018001";2;0;0;0;0;2
"6006";"360850020011";38;10;60;31;9;148
"6007";"360850020012";2;0;71;14;8;95
"6008";"360850020021";40;5;95;46;26;212
"6009";"360850020022";14;1;47;9;2;73
"6010";"360850021001";87;28;151;76;50;392
"6011";"360850021002";101;111;243;116;89;660
"6012";"360850021003";388;245;159;97;71;960
"6013";"360850027001";112;126;126;81;64;509
"6014";"360850029001";132;16;257;115;40;560
"6015";"360850029002";264;449;16;3;13;745
"6016";"360850029003";119;56;97;54;42;368
"6017";"360850029004";13;8;69;48;14;152
"6018";"360850033001";38;3;43;21;32;137
"6019";"360850033002";54;16;168;171;28;437
"6020";"360850036001";16;9;107;38;39;209
"6021";"360850036002";56;10;41;14;10;131
"6022";"360850039001";5;1;29;15;3;53
"6023";"360850039002";79;9;68;17;5;178
"6024";"360850040001";27;2;58;32;24;143
"6025";"360850040002";254;82;85;50;29;500
"6026";"360850040003";469;30;22;17;15;553
"6027";"360850040004";14;8;33;23;8;86
"6028";"360850040005";15;5;15;0;7;42
"6029";"360850040006";120;11;31;30;16;208
"6030";"360850040007";71;12;61;27;24;195
"6031";"360850047001";30;14;103;51;52;250
"6032";"360850047002";42;8;96;21;15;182
"6033";"360850050001";18;7;64;13;11;113
"6034";"360850050002";31;8;120;26;12;197
"6035";"360850050003";37;5;55;20;11;128
"6036";"360850059001";43;26;118;41;21;249
"6037";"360850059002";80;171;93;18;21;383
"6038";"360850064001";17;0;80;4;17;118
"6039";"360850064002";4;2;18;23;10;57
"6040";"360850064003";90;30;198;18;40;376
"6041";"360850067001";8;4;18;20;9;59
"6042";"360850067002";21;56;89;31;19;216
"6043";"360850067003";11;4;24;19;6;64
"6044";"360850070001";51;28;143;42;51;315
"6045";"360850070002";12;3;114;27;23;179
"6046";"360850070003";56;55;49;47;36;243
"6047";"360850070004";37;9;93;41;37;217
"6048";"360850074001";18;9;183;39;29;278
"6049";"360850074002";74;21;152;39;37;323
"6050";"360850075001";74;24;59;31;32;220
"6051";"360850075002";16;2;127;27;17;189
"6052";"360850075003";89;9;105;63;18;284
"6053";"360850077001";46;22;32;50;49;199
"6054";"360850081001";43;5;70;67;36;221
"6055";"360850081002";104;29;47;13;13;206
"6056";"360850081003";242;55;71;57;48;473
"6057";"360850096011";33;19;107;32;24;215
"6058";"360850096012";22;10;120;29;12;193
"6059";"360850096021";29;4;134;19;33;219
"6060";"360850096022";51;7;32;20;32;142
"6061";"360850096023";17;8;74;13;6;118
"6062";"360850097001";80;16;113;75;34;318
"6063";"360850097002";34;3;76;28;18;159
"6064";"360850097003";13;6;39;41;14;113
"6065";"360850105001";12;23;25;14;13;87
"6066";"360850105002";15;17;37;11;40;120
"6067";"360850105003";25;6;54;20;25;130
"6068";"360850105004";32;12;139;60;25;268
"6069";"360850105005";123;27;50;29;23;252
"6070";"360850112011";42;7;143;36;35;263
"6071";"360850112012";12;22;132;91;44;301
"6072";"360850112021";34;9;99;38;38;218
"6073";"360850112022";41;35;132;52;37;297
"6074";"360850112023";32;6;69;23;19;149
"6075";"360850112024";0;0;2;1;0;3
"6076";"360850114011";22;3;62;5;15;107
"6077";"360850114012";315;22;40;3;11;391
"6078";"360850114021";10;1;38;16;14;79
"6079";"360850114022";37;1;87;11;9;145
"6080";"360850114023";5;3;39;5;25;77
"6081";"360850121001";7;6;35;23;14;85
"6082";"360850121002";9;3;36;12;7;67
"6083";"360850121003";48;14;30;8;20;120
"6084";"360850122001";13;4;44;12;46;119
"6085";"360850122002";16;18;37;19;29;119
"6086";"360850122003";8;6;29;7;11;61
"6087";"360850122004";8;77;37;19;15;156
"6088";"360850125001";290;40;174;152;154;810
"6089";"360850125002";36;11;31;24;24;126
"6090";"360850125003";10;1;63;21;4;99
"6091";"360850128041";63;9;141;73;61;347
"6092";"360850128042";60;21;272;39;79;471
"6093";"360850128051";28;1;97;31;32;189
"6094";"360850128061";3;1;21;8;21;54
"6095";"360850128062";16;12;16;16;13;73
"6096";"360850128063";71;11;50;10;14;156
"6097";"360850128064";30;5;145;27;36;243
"6098";"360850132011";8;6;19;6;11;50
"6099";"360850132012";4;1;31;3;4;43
"6100";"360850132031";19;0;37;14;11;81
"6101";"360850132032";9;3;88;21;25;146
"6102";"360850132033";22;4;62;33;18;139
"6103";"360850132041";10;5;145;14;16;190
"6104";"360850132042";29;8;74;20;28;159
"6105";"360850132043";26;2;33;14;16;91
"6106";"360850133011";462;11;35;23;35;566
"6107";"360850133021";34;9;63;81;34;221
"6108";"360850133022";73;9;114;90;29;315
"6109";"360850133023";290;58;108;55;50;561
"6110";"360850134001";36;11;61;21;14;143
"6111";"360850134002";11;2;62;10;29;114
"6112";"360850134003";15;1;72;25;16;129
"6113";"360850138001";15;1;12;4;7;39
"6114";"360850138002";26;1;57;18;22;124
"6115";"360850138003";9;4;36;16;15;80
"6116";"360850138004";0;4;21;8;7;40
"6117";"360850138005";17;12;44;17;22;112
"6118";"360850141001";36;7;45;27;20;135
"6119";"360850141002";37;10;45;18;29;139
"6120";"360850146041";8;1;78;13;38;138
"6121";"360850146042";17;13;50;19;24;123
"6122";"360850146043";21;1;80;16;27;145
"6123";"360850146044";41;5;93;8;34;181
"6124";"360850146051";9;4;73;33;25;144
"6125";"360850146052";21;20;51;19;16;127
"6126";"360850146061";18;7;224;28;28;305
"6127";"360850146062";17;10;85;13;31;156
"6128";"360850146063";40;3;135;18;23;219
"6129";"360850146064";0;2;83;7;5;97
"6130";"360850146071";41;19;141;49;29;279
"6131";"360850146072";13;17;45;20;27;122
"6132";"360850146081";29;4;222;51;28;334
"6133";"360850146082";9;10;61;13;19;112
"6134";"360850147001";4;2;14;12;10;42
"6135";"360850147002";14;13;34;5;14;80
"6136";"360850147003";180;25;79;8;26;318
"6137";"360850151001";63;37;54;56;41;251
"6138";"360850151002";6;0;19;19;4;48
"6139";"360850151003";7;1;16;30;11;65
"6140";"360850151004";2;3;44;16;9;74
"6141";"360850151005";12;12;71;13;28;136
"6142";"360850154000";0;0;1;0;0;1
"6143";"360850154001";0;1;1;0;3;5
"6144";"360850156011";11;5;38;11;16;81
"6145";"360850156012";15;2;11;3;9;40
"6146";"360850156013";4;9;62;22;12;109
"6147";"360850156014";30;4;44;12;11;101
"6148";"360850156015";2;3;18;3;16;42
"6149";"360850156016";11;31;29;9;10;90
"6150";"360850156021";3;2;29;3;11;48
"6151";"360850156022";8;3;10;8;15;44
"6152";"360850156023";16;2;15;4;9;46
"6153";"360850156024";4;1;27;2;4;38
"6154";"360850156031";16;2;47;9;26;100
"6155";"360850156032";68;7;153;30;30;288
"6156";"360850156033";22;78;218;26;43;387
"6157";"360850169011";9;7;60;27;17;120
"6158";"360850169012";41;5;100;30;14;190
"6159";"360850170051";40;11;148;19;35;253
"6160";"360850170052";88;288;70;41;34;521
"6161";"360850170071";16;5;79;16;21;137
"6162";"360850170072";68;17;159;18;21;283
"6163";"360850170081";11;8;134;40;28;221
"6164";"360850170082";15;2;143;26;29;215
"6165";"360850170083";38;7;224;26;44;339
"6166";"360850170091";0;8;28;5;9;50
"6167";"360850170092";30;6;30;16;27;109
"6168";"360850170093";7;2;58;19;14;100
"6169";"360850170101";16;14;192;24;22;268
"6170";"360850170102";24;8;165;31;8;236
"6171";"360850170103";102;4;236;29;45;416
"6172";"360850170104";7;5;74;16;15;117
"6173";"360850170111";12;5;60;13;19;109
"6174";"360850170112";11;6;93;21;17;148
"6175";"360850170121";59;8;140;19;62;288
"6176";"360850170122";14;3;68;20;24;129
"6177";"360850170123";10;2;60;18;9;99
"6178";"360850173001";5;1;47;43;15;111
"6179";"360850173002";133;3;8;0;8;152
"6180";"360850176001";18;3;51;5;13;90
"6181";"360850176002";7;2;20;10;12;51
"6182";"360850176003";21;6;22;6;17;72
"6183";"360850176004";22;2;8;13;21;66
"6184";"360850177001";15;7;13;13;12;60
"6185";"360850177002";12;22;41;16;14;105
"6186";"360850177003";16;3;30;9;17;75
"6187";"360850177004";14;4;9;5;15;47
"6188";"360850177005";10;0;27;10;22;69
"6189";"360850177006";10;0;3;0;3;16
"6190";"360850181001";4;3;181;1;14;203
"6191";"360850181002";32;4;37;13;32;118
"6192";"360850181003";10;0;14;3;11;38
"6193";"360850187011";63;4;50;17;88;222
"6194";"360850187012";21;1;42;27;10;101
"6195";"360850187021";17;2;59;27;19;124
"6196";"360850187022";8;3;74;25;49;159
"6197";"360850187023";78;4;68;24;27;201
"6198";"360850187024";36;11;268;52;25;392
"6199";"360850189011";71;45;200;66;128;510
"6200";"360850189012";251;4;61;44;40;400
"6201";"360850189021";11;5;39;27;11;93
"6202";"360850189022";13;3;108;35;24;183
"6203";"360850189023";69;13;41;12;21;156
"6204";"360850197001";15;2;26;13;17;73
"6205";"360850197002";9;1;63;15;17;105
"6206";"360850198000";1;0;0;0;0;1
"6207";"360850198001";3;6;11;0;5;25
"6208";"360850198002";32;22;97;37;31;219
"6209";"360850198003";3;3;85;15;14;120
"6210";"360850198004";23;11;67;10;29;140
"6211";"360850201001";55;13;37;34;37;176
"6212";"360850201002";5;6;48;11;19;89
"6213";"360850201003";20;7;22;21;12;82
"6214";"360850207001";224;27;258;99;89;697
"6215";"360850207002";73;14;131;28;61;307
"6216";"360850207003";115;11;81;53;38;298
"6217";"360850207004";59;15;99;108;48;329
"6218";"360850208011";15;22;157;51;18;263
"6219";"360850208012";22;0;113;14;10;159
"6220";"360850208013";29;7;241;33;30;340
"6221";"360850208014";57;34;151;44;34;320
"6222";"360850208031";16;9;219;43;28;315
"6223";"360850208032";40;17;174;36;34;301
"6224";"360850208033";23;4;79;19;47;172
"6225";"360850208041";35;3;68;20;30;156
"6226";"360850208042";11;5;109;54;42;221
"6227";"360850208043";25;6;92;17;25;165
"6228";"360850213001";44;13;67;26;41;191
"6229";"360850213002";22;11;16;10;12;71
"6230";"360850213003";35;10;99;56;20;220
"6231";"360850213004";44;2;74;46;20;186
"6232";"360850213005";14;17;89;35;36;191
"6233";"360850223001";152;27;66;100;70;415
"6234";"360850223002";57;22;137;103;30;349
"6235";"360850226001";15;10;97;66;74;262
"6236";"360850226002";27;11;104;31;24;197
"6237";"360850226003";49;16;115;36;52;268
"6238";"360850226004";12;17;98;15;33;175
"6239";"360850228001";2;6;76;9;33;126
"6240";"360850231001";114;33;199;68;47;461
"6241";"360850231002";38;14;74;21;27;174
"6242";"360850239001";73;25;137;104;32;371
"6243";"360850239002";35;15;134;46;67;297
"6244";"360850244011";9;23;49;7;41;129
"6245";"360850244012";52;10;95;10;29;196
"6246";"360850244013";53;15;130;13;24;235
"6247";"360850244021";33;12;40;10;26;121
"6248";"360850244022";28;17;66;19;15;145
"6249";"360850247001";191;20;57;19;19;306
"6250";"360850247002";44;19;64;54;21;202
"6251";"360850248001";44;11;180;55;50;340
"6252";"360850248002";20;19;117;38;25;219
"6253";"360850248003";23;67;118;13;26;247
"6254";"360850251001";74;14;95;54;37;274
"6255";"360850251002";25;12;44;20;19;120
"6256";"360850251003";18;1;63;38;24;144
"6257";"360850273011";0;2;13;5;7;27
"6258";"360850273012";45;9;157;38;19;268
"6259";"360850273021";57;16;165;29;42;309
"6260";"360850273022";12;2;55;18;23;110
"6261";"360850277021";91;10;67;10;26;204
"6262";"360850277022";9;8;50;11;12;90
"6263";"360850277023";41;7;93;20;7;168
"6264";"360850277041";19;9;191;31;12;262
"6265";"360850277042";22;0;148;18;26;214
"6266";"360850277051";31;3;181;66;79;360
"6267";"360850277052";72;6;116;30;27;251
"6268";"360850277053";27;10;101;24;42;204
"6269";"360850277061";108;3;404;29;185;729
"6270";"360850277062";8;3;54;8;18;91
"6271";"360850277063";26;4;51;6;15;102
"6272";"360850279001";5;15;44;5;17;86
"6273";"360850279002";19;3;23;5;16;66
"6274";"360850291021";17;4;118;40;14;193
"6275";"360850291022";52;38;255;56;65;466
"6276";"360850291031";55;15;182;26;60;338
"6277";"360850291032";3;0;41;0;7;51
"6278";"360850291033";5;2;62;15;37;121
"6279";"360850291034";75;3;82;23;17;200
"6280";"360850291035";51;7;135;46;28;267
"6281";"360850291041";48;0;186;56;42;332
"6282";"360850291042";27;6;123;29;11;196
"6283";"360850291043";10;2;63;21;25;121
"6284";"360850291044";53;22;109;63;46;293
"6285";"360850303011";80;38;220;95;24;457
"6286";"360850303012";27;6;103;33;21;190
"6287";"360850303021";20;7;60;28;18;133
"6288";"360850303022";61;8;188;47;33;337
"6289";"360850303023";40;6;69;11;12;138
"6290";"360850303024";53;8;28;14;9;112
"6291";"360850319011";140;22;25;15;22;224
"6292";"360850319012";71;11;45;37;18;182
"6293";"360850319021";110;5;83;10;6;214
"6294";"360850319022";166;8;109;62;53;398
"6295";"360850319023";49;7;215;181;46;498
"6296";"360850323001";99;71;87;71;38;366
"6297";"361190002031";0;1;0;6;0;7
"6298";"361190015031";4;0;11;1;2;18
"6299";"361190026001";3;0;12;4;0;19
"6300";"361190026003";11;1;2;11;0;25
"6301";"361190029002";3;0;1;4;0;8
