"";"Data";"0";"1";"3";"4";"5";"sum"
"1";"360050001001";0;0;0;0;1;1
"2";"360050002001";41;11;69;14;32;167
"3";"360050002002";94;19;77;34;36;260
"4";"360050002003";38;16;22;15;35;126
"5";"360050004001";28;4;34;9;34;109
"6";"360050004002";44;11;48;24;42;169
"7";"360050004003";10;51;23;8;14;106
"8";"360050004004";8;4;11;17;5;45
"9";"360050016001";34;2;1;0;0;37
"10";"360050016002";38;2;31;12;17;100
"11";"360050016003";8;0;2;0;0;10
"12";"360050016004";39;21;53;9;9;131
"13";"360050019001";100;27;74;13;52;266
"14";"360050019002";4;1;6;10;5;26
"15";"360050019003";18;7;67;4;37;133
"16";"360050019004";18;3;6;6;8;41
"17";"360050020001";47;5;66;5;22;145
"18";"360050020002";76;31;57;9;20;193
"19";"360050020003";75;10;3;7;4;99
"20";"360050020004";40;10;1;6;0;57
"21";"360050020005";135;2;1;1;0;139
"22";"360050020006";39;9;21;6;10;85
"23";"360050023001";183;4;5;0;1;193
"24";"360050023002";4;3;1;0;0;8
"25";"360050023003";71;7;1;0;3;82
"26";"360050024000";1;0;0;0;0;1
"27";"360050024001";13;17;1;1;3;35
"28";"360050025001";56;37;1;3;13;110
"29";"360050025002";403;7;0;1;2;413
"30";"360050025003";12;8;2;0;13;35
"31";"360050025004";45;2;3;1;5;56
"32";"360050025005";25;6;7;2;7;47
"33";"360050027011";47;2;14;6;2;71
"34";"360050027012";53;14;18;2;6;93
"35";"360050027021";37;5;8;1;8;59
"36";"360050027022";9;4;3;2;4;22
"37";"360050027023";46;10;10;1;10;77
"38";"360050027024";75;3;4;0;7;89
"39";"360050028001";31;15;27;4;19;96
"40";"360050028002";16;15;3;1;1;36
"41";"360050028003";5;3;0;0;0;8
"42";"360050028004";16;16;2;2;3;39
"43";"360050031001";28;15;32;4;52;131
"44";"360050033001";6;6;20;2;12;46
"45";"360050033002";54;6;2;0;9;71
"46";"360050033003";43;13;9;0;8;73
"47";"360050035001";60;14;23;2;21;120
"48";"360050035002";49;15;1;2;10;77
"49";"360050035003";35;16;13;4;28;96
"50";"360050037001";8;10;2;0;0;20
"51";"360050038001";162;7;34;27;11;241
"52";"360050039001";54;12;17;1;16;100
"53";"360050039002";22;7;15;6;26;76
"54";"360050039003";68;8;4;5;28;113
"55";"360050039004";30;2;17;0;17;66
"56";"360050039005";56;6;11;1;12;86
"57";"360050040011";20;15;42;4;20;101
"58";"360050041001";221;3;3;0;9;236
"59";"360050041002";63;8;33;1;26;131
"60";"360050041003";1;0;0;0;3;4
"61";"360050041004";49;16;8;0;7;80
"62";"360050042001";13;9;0;0;1;23
"63";"360050042002";96;0;0;1;7;104
"64";"360050042003";23;3;9;0;2;37
"65";"360050042004";4;2;5;0;1;12
"66";"360050042005";5;1;3;1;9;19
"67";"360050042006";1;2;0;1;2;6
"68";"360050042007";13;6;0;0;0;19
"69";"360050043001";67;22;16;5;35;145
"70";"360050043002";41;16;20;1;28;106
"71";"360050043003";58;27;9;1;15;110
"72";"360050043004";48;13;27;1;5;94
"73";"360050044001";21;3;4;1;0;29
"74";"360050044002";10;1;1;0;1;13
"75";"360050044003";50;4;21;2;22;99
"76";"360050044004";40;2;13;4;7;66
"77";"360050046001";91;8;32;8;30;169
"78";"360050048001";540;50;7;0;42;639
"79";"360050048002";81;19;27;2;23;152
"80";"360050050011";30;16;15;1;12;74
"81";"360050050012";158;31;14;0;17;220
"82";"360050050013";70;5;15;0;14;104
"83";"360050050014";15;7;8;2;11;43
"84";"360050050021";92;6;4;5;34;141
"85";"360050050022";15;3;12;0;8;38
"86";"360050050023";36;10;4;0;10;60
"87";"360050050024";34;9;6;0;23;72
"88";"360050051001";13;3;30;18;30;94
"89";"360050051002";173;2;50;3;33;261
"90";"360050051003";61;4;7;0;3;75
"91";"360050052001";28;14;38;17;26;123
"92";"360050052002";129;17;2;3;11;162
"93";"360050053001";73;2;1;0;8;84
"94";"360050054001";35;7;23;3;37;105
"95";"360050054002";125;28;36;1;58;248
"96";"360050054003";26;20;17;7;42;112
"97";"360050054004";51;13;2;1;17;84
"98";"360050056001";111;6;8;1;6;132
"99";"360050056002";3;2;4;0;8;17
"100";"360050056003";27;15;43;1;31;117
"101";"360050059021";49;28;8;1;5;91
"102";"360050059022";1;9;17;1;7;35
"103";"360050060001";50;12;20;3;24;109
"104";"360050061001";0;2;3;0;1;6
"105";"360050061002";68;7;13;1;4;93
"106";"360050061003";3;6;7;1;1;18
"107";"360050062001";52;1;20;2;34;109
"108";"360050062002";94;3;2;2;2;103
"109";"360050062003";135;20;7;3;6;171
"110";"360050062004";34;18;4;1;39;96
"111";"360050062005";4;3;3;1;8;19
"112";"360050063001";42;65;2;1;14;124
"113";"360050063002";28;28;53;19;46;174
"114";"360050063003";37;36;11;2;12;98
"115";"360050063004";11;59;1;0;6;77
"116";"360050063005";63;26;2;2;6;99
"117";"360050063006";203;117;17;3;34;374
"118";"360050064001";61;10;36;4;28;139
"119";"360050064002";25;4;3;1;7;40
"120";"360050064003";8;0;17;1;11;37
"121";"360050064004";35;31;14;3;22;105
"122";"360050065001";70;14;9;0;36;129
"123";"360050065002";72;10;11;0;8;101
"124";"360050065003";36;1;10;0;7;54
"125";"360050065004";23;22;6;1;33;85
"126";"360050067001";50;14;20;0;26;110
"127";"360050067002";139;24;9;0;13;185
"128";"360050067003";77;5;1;0;2;85
"129";"360050067004";45;0;3;0;3;51
"130";"360050067005";7;3;1;0;5;16
"131";"360050067006";40;6;14;2;16;78
"132";"360050068001";43;4;27;0;29;103
"133";"360050068002";5;17;14;1;27;64
"134";"360050068003";12;27;33;1;20;93
"135";"360050069001";63;34;21;4;26;148
"136";"360050069002";149;7;32;12;21;221
"137";"360050069003";11;3;0;0;1;15
"138";"360050069004";13;2;0;0;1;16
"139";"360050070001";79;9;60;2;26;176
"140";"360050070002";41;416;17;1;50;525
"141";"360050070003";130;89;37;1;32;289
"142";"360050071001";18;5;27;3;8;61
"143";"360050071002";1559;44;23;0;31;1657
"144";"360050072001";50;19;39;1;24;133
"145";"360050072002";57;14;42;4;33;150
"146";"360050072003";13;28;8;0;26;75
"147";"360050072004";14;4;47;0;11;76
"148";"360050073001";58;16;8;0;14;96
"149";"360050073002";101;3;2;2;6;114
"150";"360050073003";68;10;7;3;8;96
"151";"360050074001";14;5;20;11;10;60
"152";"360050074002";37;22;17;12;13;101
"153";"360050074003";40;11;3;9;5;68
"154";"360050075001";37;5;29;10;9;90
"155";"360050075002";166;12;31;1;28;238
"156";"360050075003";168;0;1;0;3;172
"157";"360050075004";15;0;2;0;4;21
"158";"360050076001";14;2;4;3;11;34
"159";"360050076002";36;13;34;0;51;134
"160";"360050076003";11;4;21;1;21;58
"161";"360050076004";60;10;25;8;41;144
"162";"360050076005";9;4;52;3;40;108
"163";"360050077001";68;25;47;5;28;173
"164";"360050078001";171;5;53;5;30;264
"165";"360050078002";112;15;105;6;61;299
"166";"360050078003";33;7;16;0;9;65
"167";"360050078004";25;6;22;1;19;73
"168";"360050079001";41;16;5;2;20;84
"169";"360050079002";17;19;3;0;20;59
"170";"360050079003";39;2;5;0;17;63
"171";"360050079004";39;6;4;0;2;51
"172";"360050079005";13;2;0;0;1;16
"173";"360050079006";14;7;3;0;1;25
"174";"360050083001";39;11;6;0;27;83
"175";"360050083002";14;1;2;9;6;32
"176";"360050083003";47;4;14;3;3;71
"177";"360050083004";56;9;22;0;19;106
"178";"360050083005";24;11;5;0;17;57
"179";"360050083006";84;8;85;6;9;192
"180";"360050084001";13;2;15;10;4;44
"181";"360050084002";22;4;54;9;18;107
"182";"360050085001";46;14;14;1;13;88
"183";"360050085002";92;20;31;0;16;159
"184";"360050085003";10;0;7;0;14;31
"185";"360050085004";14;4;1;0;2;21
"186";"360050085005";42;9;5;0;2;58
"187";"360050086001";10;2;11;5;9;37
"188";"360050086002";54;2;3;0;3;62
"189";"360050086003";475;12;2;0;5;494
"190";"360050087001";101;19;6;0;11;137
"191";"360050087002";47;12;5;0;9;73
"192";"360050087003";34;3;22;0;13;72
"193";"360050087004";11;5;2;2;3;23
"194";"360050087005";44;3;4;0;12;63
"195";"360050089001";38;8;6;1;14;67
"196";"360050089002";43;5;13;1;12;74
"197";"360050090001";3;2;5;1;2;13
"198";"360050090002";1;0;9;5;6;21
"199";"360050090003";172;5;2;0;0;179
"200";"360050090004";16;4;33;27;25;105
"201";"360050090005";47;0;0;0;5;52
"202";"360050092001";31;3;20;0;7;61
"203";"360050092002";81;4;25;0;18;128
"204";"360050092003";79;28;58;7;56;228
"205";"360050092004";13;13;10;4;23;63
"206";"360050092005";64;5;66;1;11;147
"207";"360050093001";5;0;31;5;32;73
"208";"360050093002";40;7;27;1;41;116
"209";"360050093003";69;26;13;0;17;125
"210";"360050093004";246;35;13;8;23;325
"211";"360050093005";31;12;37;14;26;120
"212";"360050093006";2;5;49;22;86;164
"213";"360050096001";140;19;97;1;49;306
"214";"360050096002";16;27;67;32;61;203
"215";"360050098001";44;27;39;2;33;145
"216";"360050098002";17;7;10;6;9;49
"217";"360050098003";32;4;24;7;18;85
"218";"360050098004";11;5;36;4;7;63
"219";"360050098005";45;6;6;0;7;64
"220";"360050110001";6;6;10;6;14;42
"221";"360050115021";30;4;30;11;62;137
"222";"360050115022";69;5;15;2;37;128
"223";"360050115023";60;11;12;2;35;120
"224";"360050117001";180;9;11;2;39;241
"225";"360050117002";1;0;5;3;29;38
"226";"360050118001";2;1;48;9;16;76
"227";"360050118002";10;17;46;5;19;97
"228";"360050118003";28;6;39;13;18;104
"229";"360050119001";43;19;1;1;48;112
"230";"360050119002";16;10;13;1;9;49
"231";"360050119003";11;8;11;0;6;36
"232";"360050119004";52;4;4;0;4;64
"233";"360050119005";263;9;2;1;11;286
"234";"360050121011";32;21;12;2;15;82
"235";"360050121012";77;62;58;1;38;236
"236";"360050121021";45;19;11;1;54;130
"237";"360050123001";58;12;16;1;46;133
"238";"360050123002";29;3;40;0;28;100
"239";"360050123003";21;26;11;7;20;85
"240";"360050125001";96;33;32;0;73;234
"241";"360050125002";68;61;33;5;19;186
"242";"360050127011";29;5;4;4;27;69
"243";"360050127012";25;5;21;4;12;67
"244";"360050129011";44;30;17;5;74;170
"245";"360050129012";132;45;22;1;44;244
"246";"360050130001";25;0;34;4;9;72
"247";"360050131001";20;8;8;6;8;50
"248";"360050131002";52;38;46;7;29;172
"249";"360050131003";92;31;37;2;28;190
"250";"360050132001";73;5;36;17;11;142
"251";"360050132002";103;5;11;14;9;142
"252";"360050132003";18;3;35;8;19;83
"253";"360050132004";30;68;62;30;21;211
"254";"360050132005";73;8;36;11;19;147
"255";"360050133001";82;7;4;0;1;94
"256";"360050133002";48;20;22;0;23;113
"257";"360050133003";9;2;0;0;2;13
"258";"360050133004";49;0;1;0;0;50
"259";"360050135001";119;19;19;1;29;187
"260";"360050135002";59;9;1;0;0;69
"261";"360050135003";104;10;37;2;23;176
"262";"360050138001";5;13;35;28;7;88
"263";"360050138002";34;8;42;19;19;122
"264";"360050141001";69;25;7;2;9;112
"265";"360050141002";118;22;6;0;13;159
"266";"360050141003";68;24;23;6;28;149
"267";"360050143001";66;4;24;3;22;119
"268";"360050144001";1;1;0;0;1;3
"269";"360050144002";26;0;1;1;0;28
"270";"360050144003";35;3;0;0;0;38
"271";"360050144004";32;4;1;0;0;37
"272";"360050144005";77;3;63;13;10;166
"273";"360050144006";65;5;36;15;11;132
"274";"360050145001";162;15;6;4;17;204
"275";"360050145002";97;5;5;0;9;116
"276";"360050145003";19;6;29;2;11;67
"277";"360050145004";91;3;15;14;32;155
"278";"360050147011";118;2;5;1;2;128
"279";"360050147012";27;8;6;2;8;51
"280";"360050147013";79;6;2;0;1;88
"281";"360050147021";23;8;0;0;1;32
"282";"360050147022";50;11;3;0;4;68
"283";"360050147023";40;1;0;0;2;43
"284";"360050147024";18;15;1;1;1;36
"285";"360050149001";53;24;40;1;4;122
"286";"360050149002";36;17;40;2;12;107
"287";"360050149003";46;7;12;0;15;80
"288";"360050151001";62;11;8;1;10;92
"289";"360050151002";64;95;21;1;13;194
"290";"360050151003";52;7;37;0;25;121
"291";"360050151004";89;8;27;8;33;165
"292";"360050152001";56;2;36;12;26;132
"293";"360050152002";25;27;27;17;46;142
"294";"360050153001";108;124;30;24;23;309
"295";"360050153002";42;115;4;2;7;170
"296";"360050153003";29;12;32;2;25;100
"297";"360050155001";72;86;10;0;24;192
"298";"360050155002";24;11;9;3;23;70
"299";"360050157001";89;13;49;2;28;181
"300";"360050157002";45;4;13;0;29;91
"301";"360050157003";66;9;23;3;41;142
"302";"360050158001";37;16;81;47;25;206
"303";"360050159001";68;1;6;2;21;98
"304";"360050159002";178;10;5;0;9;202
"305";"360050160001";22;2;74;3;30;131
"306";"360050160002";4;0;59;1;14;78
"307";"360050160003";2;0;27;7;13;49
"308";"360050160004";3;1;18;6;9;37
"309";"360050161001";28;14;10;2;22;76
"310";"360050161002";40;9;22;2;13;86
"311";"360050161003";42;10;3;0;2;57
"312";"360050161004";54;8;2;0;7;71
"313";"360050162001";12;1;20;3;6;42
"314";"360050162002";15;3;30;7;22;77
"315";"360050163001";8;18;11;0;3;40
"316";"360050164001";48;4;19;12;23;106
"317";"360050165001";42;14;22;20;29;127
"318";"360050166001";29;23;88;23;42;205
"319";"360050166002";9;1;42;12;10;74
"320";"360050167001";10;19;30;2;6;67
"321";"360050167002";40;31;34;18;30;153
"322";"360050169001";21;10;23;1;16;71
"323";"360050171001";199;21;8;8;19;255
"324";"360050173001";83;10;17;3;7;120
"325";"360050173002";87;4;5;0;13;109
"326";"360050173003";77;12;19;4;20;132
"327";"360050173004";44;19;9;1;0;73
"328";"360050175001";33;5;2;3;14;57
"329";"360050175002";50;8;1;0;13;72
"330";"360050175003";57;11;1;2;2;73
"331";"360050175004";135;8;19;1;9;172
"332";"360050175005";46;2;0;0;3;51
"333";"360050175006";10;0;2;0;2;14
"334";"360050177011";70;24;27;3;22;146
"335";"360050177012";46;5;1;1;13;66
"336";"360050177013";55;12;19;2;14;102
"337";"360050177021";27;4;8;0;9;48
"338";"360050177022";27;35;37;3;25;127
"339";"360050177023";84;62;60;2;35;243
"340";"360050177024";69;8;13;1;4;95
"341";"360050179011";164;147;11;1;28;351
"342";"360050179012";85;2;1;0;3;91
"343";"360050179013";63;8;1;1;17;90
"344";"360050179021";119;21;7;1;12;160
"345";"360050179022";46;18;0;0;3;67
"346";"360050179023";28;11;0;1;10;50
"347";"360050181011";113;47;47;4;27;238
"348";"360050181012";45;1;4;1;3;54
"349";"360050181013";99;7;10;0;8;124
"350";"360050181021";55;16;9;3;0;83
"351";"360050181022";49;19;10;0;7;85
"352";"360050181023";35;37;4;1;10;87
"353";"360050181024";163;22;5;1;7;198
"354";"360050183011";89;38;16;0;1;144
"355";"360050183012";115;23;10;0;5;153
"356";"360050183013";58;10;4;0;4;76
"357";"360050183021";150;23;11;0;11;195
"358";"360050183022";33;9;6;4;5;57
"359";"360050183023";59;12;14;0;9;94
"360";"360050184001";12;0;19;9;14;54
"361";"360050184002";9;1;59;6;45;120
"362";"360050184003";8;14;29;13;30;94
"363";"360050184004";28;18;83;15;27;171
"364";"360050185001";222;40;73;21;46;402
"365";"360050185002";60;8;16;5;16;105
"366";"360050185003";99;14;22;16;18;169
"367";"360050185004";65;4;3;2;6;80
"368";"360050185005";42;0;3;0;15;60
"369";"360050189001";60;10;14;2;5;91
"370";"360050189002";27;6;1;0;11;45
"371";"360050189003";404;81;40;4;79;608
"372";"360050189004";255;36;60;1;25;377
"373";"360050193001";119;42;27;1;15;204
"374";"360050193002";33;5;1;0;1;40
"375";"360050193003";70;0;0;1;0;71
"376";"360050193004";88;19;106;1;9;223
"377";"360050194001";37;10;86;25;60;218
"378";"360050195001";196;18;7;0;9;230
"379";"360050195002";286;56;28;0;54;424
"380";"360050195003";104;12;7;0;8;131
"381";"360050195004";42;32;3;1;6;84
"382";"360050197001";100;18;2;0;4;124
"383";"360050197002";465;9;12;0;9;495
"384";"360050197003";62;5;16;13;22;118
"385";"360050197004";14;5;1;0;4;24
"386";"360050197005";38;26;1;0;20;85
"387";"360050199001";28;13;2;2;18;63
"388";"360050199002";167;159;1;0;6;333
"389";"360050199003";8;13;28;1;5;55
"390";"360050199004";259;62;14;0;9;344
"391";"360050199005";43;8;13;0;7;71
"392";"360050199006";33;14;53;1;17;118
"393";"360050200001";39;8;11;3;24;85
"394";"360050200002";5;6;24;18;11;64
"395";"360050200003";38;3;19;5;18;83
"396";"360050200004";58;6;14;0;13;91
"397";"360050201001";101;31;9;2;15;158
"398";"360050201002";43;16;12;0;17;88
"399";"360050201003";100;28;7;0;8;143
"400";"360050202001";31;1;18;2;7;59
"401";"360050202002";79;28;29;1;63;200
"402";"360050204001";49;2;18;2;27;98
"403";"360050204002";5;3;18;2;7;35
"404";"360050204003";25;2;35;2;23;87
"405";"360050205011";163;7;6;4;17;197
"406";"360050205012";88;21;15;1;13;138
"407";"360050205013";370;18;26;1;12;427
"408";"360050205014";41;8;48;2;8;107
"409";"360050205021";20;6;21;3;7;57
"410";"360050205022";30;3;54;1;12;100
"411";"360050205023";19;3;62;3;14;101
"412";"360050206011";53;8;24;3;51;139
"413";"360050206012";14;2;56;4;20;96
"414";"360050209001";43;30;14;8;3;98
"415";"360050209002";93;228;5;3;8;337
"416";"360050209003";25;44;3;0;3;75
"417";"360050209004";102;27;24;0;6;159
"418";"360050210011";5;1;3;1;1;11
"419";"360050210012";16;0;3;0;2;21
"420";"360050210013";13;1;1;0;0;15
"421";"360050210014";4;2;7;0;5;18
"422";"360050210015";7;3;8;1;0;19
"423";"360050210016";7;2;5;0;6;20
"424";"360050210021";12;1;1;0;0;14
"425";"360050210022";97;5;4;1;1;108
"426";"360050210025";5;1;0;0;0;6
"427";"360050210026";3;11;0;0;0;14
"428";"360050210027";0;0;5;0;0;5
"429";"360050210028";0;0;4;0;0;4
"430";"360050211001";141;21;46;2;9;219
"431";"360050211002";37;20;23;2;21;103
"432";"360050211003";43;20;10;0;14;87
"433";"360050211004";27;7;1;0;7;42
"434";"360050212001";3;1;1;1;0;6
"435";"360050212002";12;0;0;0;1;13
"436";"360050212004";10;2;8;0;2;22
"437";"360050212005";14;0;0;0;1;15
"438";"360050213011";2;0;4;0;0;6
"439";"360050213012";15;24;11;4;14;68
"440";"360050213021";127;23;49;1;20;220
"441";"360050213022";86;7;7;1;5;106
"442";"360050213023";21;1;8;1;3;34
"443";"360050213024";50;19;25;0;7;101
"444";"360050215011";9;5;2;0;8;24
"445";"360050215012";210;16;22;2;4;254
"446";"360050215013";73;6;40;0;12;131
"447";"360050215021";69;28;11;3;6;117
"448";"360050215022";141;16;22;1;8;188
"449";"360050215023";29;12;43;3;17;104
"450";"360050215024";15;11;14;0;2;42
"451";"360050215025";18;2;9;0;3;32
"452";"360050216011";85;3;50;9;20;167
"453";"360050216012";40;9;36;1;26;112
"454";"360050216013";47;0;3;0;13;63
"455";"360050216014";63;3;15;5;11;97
"456";"360050216021";28;4;25;0;27;84
"457";"360050216022";3;2;6;0;3;14
"458";"360050216023";220;1;4;0;1;226
"459";"360050216024";27;0;13;0;7;47
"460";"360050216025";133;7;55;0;9;204
"461";"360050217001";116;47;48;5;26;242
"462";"360050217002";270;12;6;0;10;298
"463";"360050217003";0;7;7;0;6;20
"464";"360050217004";156;50;15;0;4;225
"465";"360050218001";97;7;6;3;7;120
"466";"360050218002";107;11;26;0;17;161
"467";"360050218003";78;34;43;2;38;195
"468";"360050218004";54;3;26;12;31;126
"469";"360050218005";15;16;6;2;20;59
"470";"360050219001";63;127;62;30;26;308
"471";"360050220001";69;6;64;8;36;183
"472";"360050221011";162;10;1;0;5;178
"473";"360050221012";38;4;1;1;13;57
"474";"360050221013";59;13;9;7;6;94
"475";"360050221021";87;36;2;1;24;150
"476";"360050221022";48;20;1;0;5;74
"477";"360050221023";88;9;2;1;7;107
"478";"360050222001";178;8;28;0;14;228
"479";"360050222002";10;22;29;1;15;77
"480";"360050222003";16;12;40;4;34;106
"481";"360050222004";16;2;22;0;21;61
"482";"360050223001";33;68;5;1;8;115
"483";"360050223002";52;18;6;0;7;83
"484";"360050223003";92;41;3;0;4;140
"485";"360050223004";66;11;0;0;7;84
"486";"360050224011";30;0;2;3;11;46
"487";"360050224012";106;10;10;0;24;150
"488";"360050224031";203;27;4;0;26;260
"489";"360050224032";179;27;8;0;54;268
"490";"360050224041";90;9;8;0;20;127
"491";"360050224042";150;9;9;0;32;200
"492";"360050224043";75;18;22;0;13;128
"493";"360050225001";136;36;8;2;17;199
"494";"360050225002";86;2;15;1;9;113
"495";"360050225003";28;10;0;0;9;47
"496";"360050225004";17;7;3;0;3;30
"497";"360050225005";68;7;0;0;4;79
"498";"360050225006";33;13;3;0;3;52
"499";"360050227011";55;55;5;0;10;125
"500";"360050227012";34;27;21;0;13;95
"501";"360050227013";72;28;35;8;13;156
"502";"360050227021";81;22;12;8;14;137
"503";"360050227031";71;13;12;0;7;103
"504";"360050228001";31;12;70;9;23;145
"505";"360050228002";118;4;40;2;16;180
"506";"360050228003";175;15;3;1;17;211
"507";"360050228004";100;8;2;0;9;119
"508";"360050229011";216;23;6;0;19;264
"509";"360050229012";123;20;5;2;9;159
"510";"360050229013";33;57;3;0;4;97
"511";"360050229014";36;3;28;1;8;76
"512";"360050229015";129;35;23;0;12;199
"513";"360050229021";77;12;11;0;3;103
"514";"360050229022";14;17;2;2;20;55
"515";"360050229023";48;56;15;2;9;130
"516";"360050230001";116;17;48;9;56;246
"517";"360050230002";84;9;62;6;29;190
"518";"360050231001";46;10;35;14;33;138
"519";"360050232001";54;3;45;2;39;143
"520";"360050232002";67;7;67;3;47;191
"521";"360050233011";33;6;20;3;7;69
"522";"360050233012";156;131;6;1;19;313
"523";"360050233013";33;10;24;1;11;79
"524";"360050233014";22;4;3;1;4;34
"525";"360050233021";224;13;5;1;15;258
"526";"360050233022";90;29;15;0;15;149
"527";"360050235011";115;14;6;5;19;159
"528";"360050235012";24;7;0;0;7;38
"529";"360050235013";29;36;1;1;5;72
"530";"360050235021";52;36;38;6;7;139
"531";"360050235022";74;14;5;0;5;98
"532";"360050235023";63;12;20;0;14;109
"533";"360050235024";126;12;2;1;18;159
"534";"360050236001";26;7;30;2;27;92
"535";"360050236002";31;13;18;1;32;95
"536";"360050237021";46;70;2;0;15;133
"537";"360050237031";90;41;9;0;40;180
"538";"360050237032";68;17;3;0;17;105
"539";"360050237033";56;5;9;0;9;79
"540";"360050237041";27;10;0;0;7;44
"541";"360050237042";138;23;2;1;10;174
"542";"360050237043";159;30;0;0;7;196
"543";"360050238001";1;0;35;1;25;62
"544";"360050238002";28;8;45;4;31;116
"545";"360050238003";76;34;74;3;63;250
"546";"360050239001";156;23;16;0;17;212
"547";"360050239002";83;11;7;0;18;119
"548";"360050239003";67;6;4;2;15;94
"549";"360050239004";216;41;5;1;32;295
"550";"360050239005";39;18;4;1;16;78
"551";"360050239006";96;12;0;0;8;116
"552";"360050240001";35;11;133;24;86;289
"553";"360050240002";19;3;9;14;20;65
"554";"360050240003";342;2;35;3;68;450
"555";"360050241001";35;21;9;0;32;97
"556";"360050241002";22;5;7;1;22;57
"557";"360050241003";76;9;10;1;17;113
"558";"360050241004";62;5;9;1;8;85
"559";"360050241005";88;17;0;0;5;110
"560";"360050243001";24;12;13;0;23;72
"561";"360050243002";65;21;38;0;11;135
"562";"360050243003";60;3;3;1;5;72
"563";"360050243004";67;19;55;1;13;155
"564";"360050244001";13;3;37;3;7;63
"565";"360050244002";28;3;64;27;20;142
"566";"360050245011";63;7;28;1;9;108
"567";"360050245012";113;16;31;1;16;177
"568";"360050245013";18;5;7;2;5;37
"569";"360050245014";57;8;42;2;4;113
"570";"360050245021";36;15;51;1;17;120
"571";"360050245022";3;0;1;0;3;7
"572";"360050245023";111;15;32;1;13;172
"573";"360050246001";51;2;46;5;14;118
"574";"360050246002";5;1;39;16;10;71
"575";"360050247001";0;0;2;1;0;3
"576";"360050247002";33;9;12;3;7;64
"577";"360050248001";0;2;21;4;7;34
"578";"360050248002";40;5;60;14;18;137
"579";"360050248003";8;3;26;9;9;55
"580";"360050249001";75;6;15;3;5;104
"581";"360050250001";47;4;25;8;39;123
"582";"360050250002";16;0;24;18;13;71
"583";"360050251001";87;10;4;0;19;120
"584";"360050251002";38;67;8;0;12;125
"585";"360050251003";24;15;37;0;15;91
"586";"360050251004";45;2;10;6;2;65
"587";"360050251005";128;8;22;1;23;182
"588";"360050251006";107;17;27;1;8;160
"589";"360050251007";6;4;9;1;2;22
"590";"360050252001";40;8;61;15;28;152
"591";"360050252002";14;1;50;34;10;109
"592";"360050253001";613;13;6;1;28;661
"593";"360050253002";80;9;13;0;12;114
"594";"360050253003";99;6;9;0;16;130
"595";"360050253004";60;9;2;1;12;84
"596";"360050254001";16;6;26;1;18;67
"597";"360050254002";15;4;22;8;13;62
"598";"360050255001";99;20;33;0;8;160
"599";"360050255002";130;54;60;3;16;263
"600";"360050255003";55;1;24;2;12;94
"601";"360050256001";11;1;29;14;25;80
"602";"360050256002";11;3;71;12;36;133
"603";"360050257001";54;4;26;6;10;100
"604";"360050261001";61;18;18;3;6;106
"605";"360050263001";109;50;6;2;24;191
"606";"360050263002";144;44;9;3;2;202
"607";"360050263003";53;27;63;2;8;153
"608";"360050263004";8;0;7;0;0;15
"609";"360050263005";47;8;14;0;9;78
"610";"360050264001";48;7;60;19;23;157
"611";"360050264002";44;3;59;19;35;160
"612";"360050264003";44;4;43;5;44;140
"613";"360050264004";56;9;45;6;11;127
"614";"360050265001";137;19;20;1;19;196
"615";"360050265002";92;8;16;0;8;124
"616";"360050265003";318;12;4;1;11;346
"617";"360050265004";63;12;14;1;16;106
"618";"360050266011";34;3;10;4;3;54
"619";"360050266012";21;10;12;5;14;62
"620";"360050266013";4;2;36;7;4;53
"621";"360050266021";28;4;28;4;25;89
"622";"360050266022";33;19;57;2;36;147
"623";"360050266023";27;5;49;11;39;131
"624";"360050266024";48;0;12;5;19;84
"625";"360050266025";32;1;28;3;10;74
"626";"360050267011";23;4;25;0;11;63
"627";"360050267012";103;23;1;1;5;133
"628";"360050267013";84;10;21;1;27;143
"629";"360050267021";234;9;27;0;12;282
"630";"360050267022";78;0;3;0;4;85
"631";"360050267023";122;5;4;0;8;139
"632";"360050267024";25;0;12;1;11;49
"633";"360050267025";55;0;24;0;4;83
"634";"360050267026";106;21;24;0;14;165
"635";"360050269001";140;44;88;3;18;293
"636";"360050269002";57;23;20;5;9;114
"637";"360050269003";49;2;17;0;9;77
"638";"360050273001";43;12;11;4;10;80
"639";"360050273002";167;33;37;0;15;252
"640";"360050273003";107;11;22;1;9;150
"641";"360050273004";145;26;42;6;22;241
"642";"360050274011";3;2;7;11;4;27
"643";"360050274012";2;1;36;7;5;51
"644";"360050274013";1;1;44;12;20;78
"645";"360050274014";19;4;52;10;20;105
"646";"360050274021";5;6;20;6;5;42
"647";"360050274022";2;0;7;3;4;16
"648";"360050274023";17;8;28;15;12;80
"649";"360050276001";8;5;38;2;11;64
"650";"360050277001";58;22;38;10;20;148
"651";"360050277002";45;36;10;1;12;104
"652";"360050277003";16;4;31;1;4;56
"653";"360050277004";78;4;10;0;4;96
"654";"360050279001";19;6;23;1;7;56
"655";"360050279002";51;2;23;1;9;86
"656";"360050279003";128;6;25;1;6;166
"657";"360050279004";33;3;21;0;12;69
"658";"360050279005";15;2;33;0;1;51
"659";"360050279006";278;8;17;2;5;310
"660";"360050281001";52;12;6;0;1;71
"661";"360050281002";10;1;0;1;4;16
"662";"360050281003";5;1;11;0;5;22
"663";"360050283001";33;41;22;6;16;118
"664";"360050283002";41;9;13;1;9;73
"665";"360050284001";7;22;24;15;16;84
"666";"360050285001";98;17;46;4;9;174
"667";"360050285002";14;5;23;2;3;47
"668";"360050285003";54;115;0;0;2;171
"669";"360050285004";161;13;29;5;21;229
"670";"360050286001";3;4;48;10;11;76
"671";"360050286002";24;13;45;5;14;101
"672";"360050287001";39;5;76;7;29;156
"673";"360050287002";35;3;3;0;3;44
"674";"360050287003";59;57;3;0;2;121
"675";"360050288001";229;6;23;10;6;274
"676";"360050288002";8;1;32;21;11;73
"677";"360050288003";122;1;8;2;5;138
"678";"360050288004";8;9;20;4;24;65
"679";"360050289001";151;18;6;3;8;186
"680";"360050289002";31;4;0;0;5;40
"681";"360050289003";18;17;12;4;17;68
"682";"360050289004";36;6;2;0;4;48
"683";"360050293011";2;1;2;5;2;12
"684";"360050293012";2;1;4;0;5;12
"685";"360050293021";1;2;0;0;4;7
"686";"360050293022";1;2;4;3;9;19
"687";"360050293023";12;3;15;2;7;39
"688";"360050293024";22;2;32;9;21;86
"689";"360050295001";48;21;27;1;15;112
"690";"360050295002";47;28;20;0;16;111
"691";"360050295003";38;5;5;1;10;59
"692";"360050295004";5;5;17;3;16;46
"693";"360050296001";62;7;78;23;32;202
"694";"360050296002";3;0;11;3;11;28
"695";"360050297001";67;2;10;0;8;87
"696";"360050297002";28;8;37;1;12;86
"697";"360050297003";53;1;25;1;3;83
"698";"360050300001";19;3;50;4;20;96
"699";"360050300002";38;1;60;12;20;131
"700";"360050300003";20;18;25;4;12;79
"701";"360050300004";31;2;24;4;20;81
"702";"360050300005";24;1;9;9;3;46
"703";"360050300006";36;1;35;4;11;87
"704";"360050301001";3;3;0;0;1;7
"705";"360050301002";0;1;7;0;3;11
"706";"360050302001";2;0;1;2;0;5
"707";"360050302002";1;0;5;0;2;8
"708";"360050302003";5;1;45;4;1;56
"709";"360050302005";13;3;12;1;0;29
"710";"360050302006";5;1;0;0;0;6
"711";"360050307011";2;0;9;7;6;24
"712";"360050307012";5;1;9;5;2;22
"713";"360050307013";5;2;15;1;6;29
"714";"360050307014";1;3;4;0;3;11
"715";"360050309001";1;1;3;0;2;7
"716";"360050309002";1;1;23;5;2;32
"717";"360050309003";4;3;0;0;0;7
"718";"360050309004";9;44;5;1;6;65
"719";"360050310001";10;3;13;15;9;50
"720";"360050310002";10;6;14;16;9;55
"721";"360050310003";27;1;19;10;17;74
"722";"360050312001";2;2;20;4;8;36
"723";"360050312002";16;0;15;16;9;56
"724";"360050314001";32;0;28;4;15;79
"725";"360050314002";17;0;31;7;2;57
"726";"360050316001";35;5;53;12;8;113
"727";"360050316002";3;0;7;4;3;17
"728";"360050318001";18;3;51;9;8;89
"729";"360050318002";6;1;34;2;15;58
"730";"360050319001";0;0;1;0;1;2
"731";"360050323001";1;0;2;0;3;6
"732";"360050323002";18;0;2;0;1;21
"733";"360050323003";17;2;6;0;1;26
"734";"360050323004";30;1;23;6;3;63
"735";"360050324001";468;5;13;3;8;497
"736";"360050324002";53;62;33;4;17;169
"737";"360050326001";111;9;41;2;26;189
"738";"360050326002";15;1;18;15;11;60
"739";"360050326003";10;3;14;3;5;35
"740";"360050328001";27;6;18;1;22;74
"741";"360050328002";84;3;3;0;1;91
"742";"360050328003";21;6;23;3;2;55
"743";"360050328004";57;3;21;3;3;87
"744";"360050330001";38;19;45;2;32;136
"745";"360050330002";78;8;29;0;14;129
"746";"360050330003";145;5;7;1;21;179
"747";"360050330004";30;3;21;0;13;67
"748";"360050332011";54;3;11;0;12;80
"749";"360050332012";156;6;15;2;10;189
"750";"360050332013";109;7;7;3;24;150
"751";"360050332021";12;6;5;0;2;25
"752";"360050332022";66;9;12;0;16;103
"753";"360050332023";34;8;14;0;6;62
"754";"360050332024";42;6;1;1;0;50
"755";"360050334001";15;9;9;1;17;51
"756";"360050335001";0;0;2;1;3;6
"757";"360050335002";9;9;18;24;6;66
"758";"360050335003";33;11;4;0;2;50
"759";"360050336001";17;3;22;8;6;56
"760";"360050336002";42;3;1;0;24;70
"761";"360050336003";60;1;2;0;5;68
"762";"360050336004";60;2;1;0;0;63
"763";"360050336005";47;2;1;0;7;57
"764";"360050336006";72;5;10;0;27;114
"765";"360050337001";6;1;10;5;4;26
"766";"360050337002";1;1;29;14;21;66
"767";"360050337003";7;13;18;17;16;71
"768";"360050338001";66;5;18;1;26;116
"769";"360050338002";42;5;6;0;9;62
"770";"360050338003";33;10;14;1;12;70
"771";"360050338004";35;3;42;2;62;144
"772";"360050340001";14;2;53;0;15;84
"773";"360050340002";50;1;45;0;8;104
"774";"360050340003";63;7;17;2;9;98
"775";"360050340004";27;4;20;0;8;59
"776";"360050342001";62;1;14;3;7;87
"777";"360050342002";17;10;43;11;21;102
"778";"360050343001";16;0;9;4;4;33
"779";"360050343002";56;1;36;4;12;109
"780";"360050344001";9;2;15;1;12;39
"781";"360050344002";20;8;12;15;9;64
"782";"360050345001";23;12;26;18;14;93
"783";"360050345002";11;2;63;21;10;107
"784";"360050345003";13;0;9;1;1;24
"785";"360050348001";20;8;48;38;45;159
"786";"360050348002";234;17;3;0;3;257
"787";"360050348003";20;0;77;25;10;132
"788";"360050348004";19;4;39;9;8;79
"789";"360050350001";36;7;54;10;17;124
"790";"360050350002";10;6;13;13;18;60
"791";"360050351001";2;6;8;7;2;25
"792";"360050351002";34;2;18;8;7;69
"793";"360050351003";6;9;19;9;4;47
"794";"360050356001";11;0;20;7;16;54
"795";"360050356002";46;9;50;12;17;134
"796";"360050358001";85;8;30;23;20;166
"797";"360050358002";18;3;35;17;13;86
"798";"360050358003";57;9;39;18;18;141
"799";"360050358004";18;2;24;32;8;84
"800";"360050358005";15;3;18;11;11;58
"801";"360050358006";68;3;29;5;37;142
"802";"360050358007";109;6;34;9;18;176
"803";"360050359001";125;12;34;3;25;199
"804";"360050360001";17;6;21;2;9;55
"805";"360050360002";45;4;32;16;15;112
"806";"360050360003";17;3;15;11;6;52
"807";"360050361001";31;7;4;1;3;46
"808";"360050361002";103;8;34;0;10;155
"809";"360050361003";8;2;4;0;10;24
"810";"360050361004";26;3;0;0;0;29
"811";"360050361005";37;4;4;1;11;57
"812";"360050363001";83;15;5;0;6;109
"813";"360050363002";5;1;1;0;3;10
"814";"360050363003";129;25;14;0;9;177
"815";"360050363004";38;8;19;5;20;90
"816";"360050363005";36;10;2;2;1;51
"817";"360050363006";137;19;9;5;9;179
"818";"360050364001";34;3;28;8;20;93
"819";"360050364002";29;0;12;1;32;74
"820";"360050364003";28;23;18;4;16;89
"821";"360050365011";16;11;7;2;16;52
"822";"360050365012";47;5;17;12;9;90
"823";"360050365013";44;9;15;0;9;77
"824";"360050365021";28;7;8;2;15;60
"825";"360050365022";85;36;11;1;31;164
"826";"360050367001";28;8;4;2;12;54
"827";"360050367002";187;13;8;2;5;215
"828";"360050368001";38;6;31;8;32;115
"829";"360050368002";13;1;18;2;7;41
"830";"360050369011";46;14;6;4;27;97
"831";"360050369012";40;5;4;0;4;53
"832";"360050369021";28;0;2;0;4;34
"833";"360050369022";53;12;5;1;7;78
"834";"360050370001";51;27;25;3;30;136
"835";"360050370002";11;3;22;0;10;46
"836";"360050370003";13;1;23;0;11;48
"837";"360050371001";30;15;24;1;15;85
"838";"360050371002";105;18;15;2;37;177
"839";"360050371003";123;18;3;0;13;157
"840";"360050371004";24;13;10;5;9;61
"841";"360050372001";12;10;21;1;14;58
"842";"360050372002";47;15;38;8;15;123
"843";"360050373001";46;4;12;0;23;85
"844";"360050373002";99;18;17;8;40;182
"845";"360050373003";135;15;20;2;29;201
"846";"360050373004";79;33;7;3;26;148
"847";"360050374001";746;6;30;0;23;805
"848";"360050374002";167;13;30;1;54;265
"849";"360050374003";12;10;2;0;2;26
"850";"360050374004";6;1;0;0;0;7
"851";"360050375041";26;3;15;11;16;71
"852";"360050375042";15;4;9;1;10;39
"853";"360050375043";98;19;20;7;13;157
"854";"360050376001";268;4;5;1;8;286
"855";"360050376002";17;2;11;7;15;52
"856";"360050378001";48;6;41;2;45;142
"857";"360050378002";24;2;4;1;11;42
"858";"360050378003";25;6;30;3;18;82
"859";"360050379001";6;6;30;28;30;100
"860";"360050379002";5;1;1;3;3;13
"861";"360050379003";22;33;6;0;4;65
"862";"360050379004";34;2;14;0;46;96
"863";"360050379005";101;6;12;0;10;129
"864";"360050380001";26;7;4;2;8;47
"865";"360050380002";16;0;22;3;4;45
"866";"360050380003";105;29;12;2;28;176
"867";"360050380004";50;39;23;4;51;167
"868";"360050381001";52;2;0;0;1;55
"869";"360050381002";143;12;9;0;10;174
"870";"360050381003";65;78;3;0;12;158
"871";"360050381004";22;13;29;1;17;82
"872";"360050381005";20;3;37;1;12;73
"873";"360050381006";100;20;16;10;16;162
"874";"360050382001";70;9;27;14;20;140
"875";"360050382002";29;8;37;0;19;93
"876";"360050383011";71;25;2;1;6;105
"877";"360050383012";61;4;15;1;7;88
"878";"360050383013";238;12;14;0;8;272
"879";"360050383021";126;22;15;5;50;218
"880";"360050383022";132;13;6;3;9;163
"881";"360050383023";299;28;22;1;7;357
"882";"360050385001";35;24;15;2;16;92
"883";"360050385002";17;11;5;1;3;37
"884";"360050385003";32;26;18;11;13;100
"885";"360050385004";58;37;12;17;26;150
"886";"360050386001";16;3;78;15;24;136
"887";"360050386002";17;12;33;14;38;114
"888";"360050386003";17;49;2;2;9;79
"889";"360050386004";30;7;42;9;21;109
"890";"360050386005";12;40;21;5;15;93
"891";"360050386006";9;3;23;2;11;48
"892";"360050386007";32;1;5;0;17;55
"893";"360050386008";12;4;5;1;8;30
"894";"360050387001";245;18;8;0;23;294
"895";"360050387002";113;32;18;39;33;235
"896";"360050387003";38;24;15;4;15;96
"897";"360050388001";20;1;39;6;15;81
"898";"360050388002";60;3;81;11;12;167
"899";"360050389001";79;14;10;4;36;143
"900";"360050389002";57;16;11;0;22;106
"901";"360050389003";54;17;25;3;34;133
"902";"360050389004";66;24;6;0;8;104
"903";"360050389005";41;18;6;5;25;95
"904";"360050390001";98;4;47;5;25;179
"905";"360050390002";51;2;26;0;23;102
"906";"360050391001";155;25;14;0;21;215
"907";"360050391002";68;17;9;2;13;109
"908";"360050391003";59;11;9;6;21;106
"909";"360050391004";21;51;13;2;34;121
"910";"360050391005";14;4;2;0;8;28
"911";"360050391006";19;8;1;0;16;44
"912";"360050392001";6;3;22;8;9;48
"913";"360050392002";14;7;9;3;34;67
"914";"360050393001";151;25;8;1;10;195
"915";"360050393002";126;31;5;0;18;180
"916";"360050393003";23;3;1;1;6;34
"917";"360050393004";60;24;28;1;15;128
"918";"360050393005";56;10;2;1;5;74
"919";"360050393006";56;30;17;10;10;123
"920";"360050394001";71;2;8;0;12;93
"921";"360050394002";42;11;48;0;29;130
"922";"360050394003";2;2;9;0;2;15
"923";"360050394004";144;6;22;3;10;185
"924";"360050395001";59;5;26;12;51;153
"925";"360050395002";34;6;26;20;39;125
"926";"360050395003";28;18;27;10;43;126
"927";"360050395004";28;20;34;8;48;138
"928";"360050396001";33;4;65;2;29;133
"929";"360050396002";40;11;18;7;23;99
"930";"360050396003";90;7;65;10;56;228
"931";"360050396004";17;5;46;0;20;88
"932";"360050397001";35;24;20;2;31;112
"933";"360050397002";43;28;11;3;33;118
"934";"360050398001";43;1;32;9;18;103
"935";"360050398002";27;7;29;4;13;80
"936";"360050398003";20;2;12;3;7;44
"937";"360050399011";67;19;2;0;19;107
"938";"360050399012";74;10;9;0;7;100
"939";"360050399013";72;18;1;0;7;98
"940";"360050399014";54;7;1;0;14;76
"941";"360050399015";39;16;34;1;16;106
"942";"360050399021";78;33;19;0;18;148
"943";"360050399022";38;24;3;0;7;72
"944";"360050399023";148;23;6;1;12;190
"945";"360050399024";88;3;0;0;7;98
"946";"360050399025";25;4;5;1;8;43
"947";"360050401001";101;2;0;0;36;139
"948";"360050401002";110;20;4;1;43;178
"949";"360050401003";57;5;3;0;9;74
"950";"360050401004";28;4;0;0;8;40
"951";"360050401005";109;29;1;0;19;158
"952";"360050403021";303;18;2;1;21;345
"953";"360050403022";21;10;5;0;5;41
"954";"360050403023";51;4;3;1;15;74
"955";"360050403031";220;28;26;2;31;307
"956";"360050403032";204;7;68;3;22;304
"957";"360050403033";273;4;2;0;10;289
"958";"360050403041";25;30;2;1;18;76
"959";"360050403042";110;17;12;0;4;143
"960";"360050403043";59;30;9;0;18;116
"961";"360050404001";43;3;79;8;19;152
"962";"360050404002";16;1;48;10;8;83
"963";"360050404003";11;2;42;8;17;80
"964";"360050405011";202;13;9;0;52;276
"965";"360050405012";23;2;10;0;7;42
"966";"360050405013";80;16;19;4;27;146
"967";"360050405021";45;117;12;0;24;198
"968";"360050405022";49;15;9;0;15;88
"969";"360050405023";61;10;9;0;21;101
"970";"360050405024";46;43;10;5;10;114
"971";"360050405025";54;4;14;0;7;79
"972";"360050405026";50;4;21;3;25;103
"973";"360050406001";66;46;52;5;22;191
"974";"360050406002";35;6;16;1;21;79
"975";"360050406003";49;4;24;4;25;106
"976";"360050407011";82;26;6;0;6;120
"977";"360050407012";55;8;3;4;11;81
"978";"360050407013";60;16;2;1;8;87
"979";"360050407021";23;8;5;0;15;51
"980";"360050407022";87;44;22;3;32;188
"981";"360050407023";155;13;12;1;15;196
"982";"360050407024";98;7;24;0;27;156
"983";"360050407025";55;1;18;1;15;90
"984";"360050408001";82;11;22;0;14;129
"985";"360050408002";32;6;28;3;17;86
"986";"360050408003";50;14;19;2;13;98
"987";"360050408004";179;9;79;1;14;282
"988";"360050409001";34;8;36;1;6;85
"989";"360050409002";46;7;12;5;6;76
"990";"360050411001";160;5;7;0;14;186
"991";"360050411002";187;18;9;0;21;235
"992";"360050411003";69;7;13;0;34;123
"993";"360050413001";115;51;26;0;41;233
"994";"360050413002";29;11;1;1;8;50
"995";"360050413003";134;6;11;0;16;167
"996";"360050413004";27;7;3;0;13;50
"997";"360050413005";69;5;9;0;6;89
"998";"360050413006";35;9;22;0;6;72
"999";"360050413007";69;3;11;1;12;96
"1000";"360050414001";34;6;17;10;15;82
"1001";"360050414002";78;37;19;1;28;163
"1002";"360050414003";45;7;34;6;12;104
"1003";"360050414004";53;17;35;32;28;165
"1004";"360050415001";86;2;7;1;10;106
"1005";"360050415002";31;4;35;0;5;75
"1006";"360050415003";45;1;21;0;0;67
"1007";"360050415004";44;3;6;0;2;55
"1008";"360050415005";60;20;15;0;21;116
"1009";"360050415006";132;6;13;2;11;164
"1010";"360050418001";79;12;38;13;15;157
"1011";"360050418002";51;6;31;9;27;124
"1012";"360050418003";40;5;24;11;4;84
"1013";"360050418004";34;3;28;6;9;80
"1014";"360050419001";54;8;43;0;6;111
"1015";"360050419002";32;5;34;0;5;76
"1016";"360050419003";82;4;3;1;13;103
"1017";"360050419004";79;8;15;3;12;117
"1018";"360050419005";44;4;4;0;6;58
"1019";"360050419006";79;2;7;1;11;100
"1020";"360050419007";50;7;14;0;8;79
"1021";"360050420001";40;8;16;1;13;78
"1022";"360050420002";234;2;25;0;15;276
"1023";"360050420003";106;8;64;1;15;194
"1024";"360050421001";15;13;5;1;5;39
"1025";"360050421002";79;16;5;1;4;105
"1026";"360050421003";128;18;12;0;11;169
"1027";"360050421004";117;280;33;2;13;445
"1028";"360050421005";98;47;1;0;6;152
"1029";"360050422001";88;4;52;5;39;188
"1030";"360050422002";72;3;42;0;22;139
"1031";"360050423001";107;32;5;2;5;151
"1032";"360050423002";78;8;34;0;12;132
"1033";"360050423003";75;17;34;1;30;157
"1034";"360050424001";36;2;53;6;9;106
"1035";"360050424002";26;1;49;6;15;97
"1036";"360050425001";16;10;7;1;14;48
"1037";"360050425002";44;16;5;1;19;85
"1038";"360050425003";69;10;3;1;17;100
"1039";"360050425004";66;2;23;0;4;95
"1040";"360050425005";17;17;14;6;40;94
"1041";"360050425006";44;16;7;0;8;75
"1042";"360050425007";62;15;12;0;15;104
"1043";"360050426001";37;3;69;35;30;174
"1044";"360050426002";52;8;65;20;16;161
"1045";"360050426003";2;0;63;3;10;78
"1046";"360050426004";12;1;28;11;9;61
"1047";"360050426005";11;2;15;5;2;35
"1048";"360050426006";10;2;101;9;6;128
"1049";"360050428001";14;4;29;8;16;71
"1050";"360050428002";35;5;45;10;11;106
"1051";"360050429011";87;10;37;1;17;152
"1052";"360050429012";126;10;16;0;14;166
"1053";"360050429013";38;5;18;0;8;69
"1054";"360050429021";118;23;31;3;20;195
"1055";"360050429022";11;20;66;1;10;108
"1056";"360050429023";85;6;17;1;8;117
"1057";"360050430001";35;4;70;10;4;123
"1058";"360050430002";13;3;19;15;10;60
"1059";"360050430003";15;1;27;17;14;74
"1060";"360050431001";21;9;0;0;1;31
"1061";"360050431002";54;7;10;1;8;80
"1062";"360050431003";24;1;0;0;0;25
"1063";"360050431004";49;12;22;1;5;89
"1064";"360050431005";215;86;35;3;14;353
"1065";"360050431006";76;27;4;1;6;114
"1066";"360050431007";47;26;22;0;6;101
"1067";"360050431008";55;414;98;0;15;582
"1068";"360050434001";35;11;89;18;47;200
"1069";"360050434002";47;10;15;0;15;87
"1070";"360050434003";37;3;12;1;6;59
"1071";"360050434004";88;0;31;5;14;138
"1072";"360050435001";112;66;62;25;39;304
"1073";"360050436001";21;0;20;20;9;70
"1074";"360050436002";54;15;82;12;9;172
"1075";"360050442001";71;13;11;1;9;105
"1076";"360050442002";35;0;32;1;4;72
"1077";"360050442003";14;5;37;25;2;83
"1078";"360050442004";33;1;18;15;16;83
"1079";"360050442005";8;8;28;7;12;63
"1080";"360050444001";65;6;68;25;17;181
"1081";"360050444002";15;16;17;13;11;72
"1082";"360050444003";54;3;52;30;9;148
"1083";"360050444004";17;7;177;16;21;238
"1084";"360050448001";25;0;54;10;12;101
"1085";"360050448002";24;0;29;7;2;62
"1086";"360050449011";7;2;17;3;13;42
"1087";"360050449012";4;2;44;5;14;69
"1088";"360050449021";16;8;51;6;11;92
"1089";"360050449022";18;9;55;7;19;108
"1090";"360050451011";16;9;68;17;18;128
"1091";"360050451012";23;3;27;14;11;78
"1092";"360050451021";0;4;39;9;22;74
"1093";"360050451022";21;0;24;14;23;82
"1094";"360050456001";29;5;29;26;23;112
"1095";"360050456002";39;20;91;50;13;213
"1096";"360050456003";8;4;14;9;7;42
"1097";"360050458001";77;8;1;2;1;89
"1098";"360050458002";333;3;2;0;1;339
"1099";"360050458003";15;0;1;0;0;16
"1100";"360050458004";208;26;7;4;1;246
"1101";"360050460001";80;10;48;15;8;161
"1102";"360050460002";40;7;25;14;15;101
"1103";"360050462011";9;49;46;10;17;131
"1104";"360050462012";0;1;2;0;1;4
"1105";"360050462013";9;16;12;3;1;41
"1106";"360050462014";4;22;7;1;4;38
"1107";"360050462015";1;0;4;0;1;6
"1108";"360050462016";2;9;5;1;2;19
"1109";"360050462017";0;1;9;0;1;11
"1110";"360050462018";4;2;20;2;0;28
"1111";"360050462019";0;0;2;1;1;4
"1112";"360050462021";110;7;47;36;19;219
"1113";"360050462022";51;9;187;24;25;296
"1114";"360050462023";67;2;40;22;45;176
"1115";"360050462024";6;2;7;13;20;48
"1116";"360050462025";22;0;26;18;30;96
"1117";"360050462026";6;0;2;7;4;19
"1118";"360050484001";18;2;19;11;4;54
"1119";"360050484002";20;25;85;67;45;242
"1120";"360050484003";6;6;8;22;4;46
"1121";"360050484004";17;4;36;5;3;65
"1122";"360050504001";2;13;0;1;1;17
"1123";"360050516000";0;3;9;0;0;12
"1124";"360050516001";28;119;195;16;60;418
"1125";"360050516002";28;68;48;30;50;224
"1126";"360050516003";26;77;139;37;45;324
"1127";"360050516004";40;13;59;23;31;166
"1128";"360470001001";4;12;34;3;3;56
"1129";"360470001002";11;7;13;4;3;38
"1130";"360470001003";12;4;16;2;9;43
"1131";"360470001004";0;23;6;8;5;42
"1132";"360470002001";18;20;77;26;76;217
"1133";"360470003011";2;17;2;0;3;24
"1134";"360470003012";7;5;10;1;1;24
"1135";"360470003013";10;3;8;5;2;28
"1136";"360470003014";8;8;8;4;3;31
"1137";"360470003015";6;13;6;1;3;29
"1138";"360470005011";14;18;50;2;10;94
"1139";"360470005012";2;8;5;0;2;17
"1140";"360470005013";8;12;6;1;14;41
"1141";"360470005021";11;5;9;5;4;34
"1142";"360470005022";13;23;16;5;11;68
"1143";"360470007001";13;45;50;6;18;132
"1144";"360470007002";46;4;30;2;10;92
"1145";"360470007003";22;9;13;4;8;56
"1146";"360470009001";35;54;28;10;17;144
"1147";"360470009002";15;29;6;2;5;57
"1148";"360470011001";68;34;54;23;74;253
"1149";"360470013001";6;57;39;1;9;112
"1150";"360470013002";0;0;3;0;1;4
"1151";"360470015001";18;26;30;7;19;100
"1152";"360470015002";352;11;10;2;9;384
"1153";"360470015003";26;44;157;6;22;255
"1154";"360470018001";28;7;100;26;52;213
"1155";"360470020001";3;13;37;9;32;94
"1156";"360470020002";8;3;30;4;30;75
"1157";"360470021001";7;54;56;7;17;141
"1158";"360470021002";24;67;73;4;22;190
"1159";"360470021003";41;35;81;12;33;202
"1160";"360470022001";68;4;108;5;21;206
"1161";"360470022002";13;10;44;3;16;86
"1162";"360470022003";30;29;29;6;29;123
"1163";"360470023001";170;11;6;1;5;193
"1164";"360470023002";34;17;1;0;2;54
"1165";"360470023003";282;12;8;4;0;306
"1166";"360470029011";52;4;11;2;6;75
"1167";"360470029012";81;3;10;0;4;98
"1168";"360470030001";36;1;39;4;21;101
"1169";"360470030002";24;9;47;2;8;90
"1170";"360470031001";8;15;5;1;2;31
"1171";"360470031002";1;4;11;1;2;19
"1172";"360470031003";3;5;5;1;1;15
"1173";"360470033001";11;11;13;5;11;51
"1174";"360470033002";69;55;53;8;35;220
"1175";"360470034001";3;14;19;9;33;78
"1176";"360470034002";15;4;39;2;18;78
"1177";"360470034003";10;2;43;3;6;64
"1178";"360470035001";12;38;25;3;18;96
"1179";"360470035002";27;53;25;4;12;121
"1180";"360470036001";12;1;40;4;13;70
"1181";"360470036002";21;2;52;0;3;78
"1182";"360470036003";6;1;44;5;2;58
"1183";"360470037001";58;77;52;1;21;209
"1184";"360470038001";12;6;38;5;15;76
"1185";"360470039001";32;43;10;1;19;105
"1186";"360470039002";21;36;32;6;17;112
"1187";"360470039003";15;22;31;4;53;125
"1188";"360470041001";37;50;61;10;29;187
"1189";"360470041002";7;6;20;5;8;46
"1190";"360470041003";24;12;38;1;11;86
"1191";"360470043002";2;8;21;0;6;37
"1192";"360470043003";9;17;12;13;25;76
"1193";"360470043004";25;48;45;11;25;154
"1194";"360470044001";11;6;31;10;13;71
"1195";"360470044002";9;3;50;4;11;77
"1196";"360470045001";33;21;29;21;12;116
"1197";"360470045002";3;12;16;1;5;37
"1198";"360470045003";3;10;17;4;2;36
"1199";"360470045004";6;18;101;6;3;134
"1200";"360470046001";10;8;38;14;16;86
"1201";"360470047001";71;47;43;5;46;212
"1202";"360470049001";10;3;92;4;3;112
"1203";"360470049002";3;7;10;2;2;24
"1204";"360470049003";11;3;6;0;3;23
"1205";"360470050001";14;2;12;1;0;29
"1206";"360470050002";48;15;40;6;4;113
"1207";"360470050003";25;3;83;2;12;125
"1208";"360470051001";6;16;24;5;9;60
"1209";"360470051002";14;8;50;10;11;93
"1210";"360470051003";10;61;77;3;35;186
"1211";"360470052011";13;11;47;3;8;82
"1212";"360470052021";9;5;48;1;3;66
"1213";"360470052022";31;1;51;17;5;105
"1214";"360470053001";48;42;65;25;54;234
"1215";"360470053002";22;27;30;8;13;100
"1216";"360470053003";14;11;27;13;14;79
"1217";"360470053004";6;7;31;5;23;72
"1218";"360470054001";20;4;54;3;10;91
"1219";"360470054002";7;1;20;4;5;37
"1220";"360470054003";27;7;25;5;16;80
"1221";"360470056011";9;6;42;31;6;94
"1222";"360470056012";71;43;114;3;17;248
"1223";"360470056021";50;18;66;9;11;154
"1224";"360470058001";36;15;35;2;20;108
"1225";"360470058002";25;34;66;14;22;161
"1226";"360470058003";12;1;9;4;2;28
"1227";"360470059001";32;32;16;7;13;100
"1228";"360470059002";39;38;47;22;21;167
"1229";"360470060001";27;14;38;6;12;97
"1230";"360470060002";40;16;39;5;23;123
"1231";"360470060003";12;1;26;1;6;46
"1232";"360470062001";27;29;45;2;6;109
"1233";"360470062002";20;22;6;1;25;74
"1234";"360470062003";7;13;20;3;12;55
"1235";"360470063001";18;2;12;5;6;43
"1236";"360470063002";10;8;20;7;12;57
"1237";"360470064001";60;34;63;1;35;193
"1238";"360470064002";33;4;47;3;18;105
"1239";"360470064003";21;72;34;1;7;135
"1240";"360470065001";13;7;5;2;7;34
"1241";"360470065002";2;6;4;6;2;20
"1242";"360470065003";13;6;25;3;5;52
"1243";"360470065004";6;6;6;6;8;32
"1244";"360470065005";1;6;6;9;9;31
"1245";"360470065006";14;20;30;5;16;85
"1246";"360470065007";11;3;14;4;16;48
"1247";"360470066001";11;55;41;1;24;132
"1248";"360470066002";5;13;17;1;19;55
"1249";"360470066003";62;13;18;4;23;120
"1250";"360470067001";1;12;10;1;2;26
"1251";"360470067002";6;43;44;0;13;106
"1252";"360470067003";6;8;22;0;3;39
"1253";"360470067004";8;5;11;3;1;28
"1254";"360470067005";3;4;11;0;3;21
"1255";"360470068001";11;7;17;4;29;68
"1256";"360470068002";63;9;36;2;55;165
"1257";"360470068003";68;30;5;6;28;137
"1258";"360470068004";12;10;38;3;37;100
"1259";"360470069001";19;20;3;2;11;55
"1260";"360470069002";14;19;34;2;17;86
"1261";"360470069003";8;7;24;5;6;50
"1262";"360470069004";6;33;25;4;18;86
"1263";"360470070001";7;7;25;14;13;66
"1264";"360470070002";4;10;62;3;16;95
"1265";"360470071001";4;15;4;3;11;37
"1266";"360470071002";8;8;40;14;13;83
"1267";"360470071003";116;32;3;1;1;153
"1268";"360470071004";31;13;3;0;1;48
"1269";"360470072001";103;12;26;13;53;207
"1270";"360470074001";48;25;17;5;21;116
"1271";"360470074002";14;16;11;2;18;61
"1272";"360470074003";39;11;60;0;27;137
"1273";"360470074004";32;5;5;2;12;56
"1274";"360470075001";14;17;25;11;5;72
"1275";"360470075002";9;39;14;6;7;75
"1276";"360470075003";9;36;42;8;17;112
"1277";"360470075004";18;10;11;2;15;56
"1278";"360470075005";10;18;16;7;10;61
"1279";"360470076001";48;19;26;6;24;123
"1280";"360470076002";28;6;2;3;22;61
"1281";"360470076003";27;10;27;11;37;112
"1282";"360470077001";8;12;34;1;11;66
"1283";"360470077002";7;8;19;15;30;79
"1284";"360470077003";24;22;54;7;27;134
"1285";"360470077004";7;9;7;0;20;43
"1286";"360470078001";20;8;9;0;11;48
"1287";"360470078002";46;15;36;5;13;115
"1288";"360470078003";15;12;14;4;18;63
"1289";"360470078004";18;10;9;1;15;53
"1290";"360470080001";92;36;25;0;28;181
"1291";"360470080002";28;17;9;3;21;78
"1292";"360470080003";18;4;10;2;10;44
"1293";"360470082001";70;22;11;5;4;112
"1294";"360470082002";12;11;26;2;15;66
"1295";"360470082003";30;26;22;2;12;92
"1296";"360470084001";24;15;19;2;15;75
"1297";"360470084002";29;25;5;1;9;69
"1298";"360470084003";6;5;34;2;22;69
"1299";"360470085001";198;34;3;1;5;241
"1300";"360470085002";51;5;3;1;7;67
"1301";"360470085003";138;7;2;0;2;149
"1302";"360470086001";4;393;11;3;4;415
"1303";"360470088001";23;12;8;2;18;63
"1304";"360470088002";37;99;38;0;35;209
"1305";"360470090001";24;55;34;5;32;150
"1306";"360470090002";68;14;158;3;26;269
"1307";"360470092001";93;33;25;1;20;172
"1308";"360470092002";53;10;39;1;22;125
"1309";"360470092003";15;10;17;5;26;73
"1310";"360470094001";9;7;70;1;60;147
"1311";"360470094002";18;9;60;1;44;132
"1312";"360470094003";30;7;27;1;28;93
"1313";"360470096001";36;5;22;3;16;82
"1314";"360470096002";21;9;27;0;18;75
"1315";"360470096003";41;10;27;3;14;95
"1316";"360470096004";48;24;20;8;22;122
"1317";"360470098001";28;9;20;1;32;90
"1318";"360470098002";35;8;54;3;24;124
"1319";"360470098003";21;5;27;1;32;86
"1320";"360470098004";6;6;10;1;11;34
"1321";"360470100001";7;2;8;1;40;58
"1322";"360470100002";26;6;36;1;43;112
"1323";"360470100003";30;13;3;4;37;87
"1324";"360470100004";15;18;13;3;46;95
"1325";"360470101001";17;10;24;2;41;94
"1326";"360470101002";21;34;73;3;20;151
"1327";"360470101003";37;11;18;11;42;119
"1328";"360470102001";10;14;33;3;70;130
"1329";"360470102002";10;37;12;3;33;95
"1330";"360470102003";22;21;47;4;27;121
"1331";"360470104001";5;2;72;0;38;117
"1332";"360470104002";2;6;47;1;41;97
"1333";"360470104003";4;8;59;2;52;125
"1334";"360470106001";10;6;74;5;45;140
"1335";"360470106002";21;6;41;3;61;132
"1336";"360470106003";15;11;44;1;32;103
"1337";"360470108001";8;5;48;0;31;92
"1338";"360470108002";17;2;71;0;11;101
"1339";"360470108003";24;5;61;1;35;126
"1340";"360470110001";31;11;70;17;42;171
"1341";"360470110002";53;23;62;19;44;201
"1342";"360470112001";38;6;30;7;36;117
"1343";"360470112002";18;1;8;1;8;36
"1344";"360470112003";3;5;18;2;18;46
"1345";"360470112004";35;6;20;4;25;90
"1346";"360470114001";25;5;23;1;12;66
"1347";"360470114002";8;4;52;5;8;77
"1348";"360470114003";12;0;52;1;5;70
"1349";"360470116001";9;11;60;1;23;104
"1350";"360470116002";5;4;39;1;42;91
"1351";"360470116003";17;6;43;1;19;86
"1352";"360470117001";17;21;36;2;26;102
"1353";"360470117002";15;20;36;3;11;85
"1354";"360470117003";18;13;69;14;38;152
"1355";"360470118001";25;14;54;0;49;142
"1356";"360470118002";6;5;52;3;34;100
"1357";"360470119001";27;91;154;23;56;351
"1358";"360470119002";16;442;125;33;62;678
"1359";"360470119003";23;52;66;16;36;193
"1360";"360470120001";21;13;63;7;67;171
"1361";"360470121001";14;23;59;5;23;124
"1362";"360470121002";12;11;65;11;51;150
"1363";"360470122001";41;15;26;1;59;142
"1364";"360470122002";24;33;21;3;25;106
"1365";"360470122003";27;28;42;7;28;132
"1366";"360470126001";34;21;52;1;25;133
"1367";"360470126002";5;50;22;8;11;96
"1368";"360470126003";7;0;29;4;6;46
"1369";"360470127001";50;28;43;9;25;155
"1370";"360470127002";114;63;98;11;15;301
"1371";"360470127003";43;29;8;0;6;86
"1372";"360470128011";42;24;50;5;51;172
"1373";"360470129011";6;81;69;4;15;175
"1374";"360470129012";54;147;264;10;22;497
"1375";"360470129013";10;4;16;2;10;42
"1376";"360470129021";9;34;57;1;7;108
"1377";"360470129022";44;91;113;5;8;261
"1378";"360470129023";13;8;21;1;4;47
"1379";"360470130001";34;4;24;5;23;90
"1380";"360470130002";11;12;40;9;34;106
"1381";"360470130003";11;13;20;3;25;72
"1382";"360470130004";27;9;16;3;16;71
"1383";"360470131001";18;20;21;3;15;77
"1384";"360470131002";13;65;15;3;15;111
"1385";"360470131003";7;31;12;4;7;61
"1386";"360470131004";40;28;21;2;15;106
"1387";"360470132001";4;0;24;2;59;89
"1388";"360470132002";7;3;50;8;29;97
"1389";"360470133001";19;31;22;12;10;94
"1390";"360470133002";23;12;32;1;16;84
"1391";"360470133003";12;63;20;1;6;102
"1392";"360470133004";5;3;22;2;7;39
"1393";"360470134001";8;10;99;27;14;158
"1394";"360470134002";37;13;22;8;30;110
"1395";"360470134003";19;2;54;1;33;109
"1396";"360470135001";9;11;8;2;16;46
"1397";"360470135002";16;23;33;10;8;90
"1398";"360470135003";14;38;24;6;23;105
"1399";"360470136001";10;1;39;0;19;69
"1400";"360470136002";10;1;34;3;15;63
"1401";"360470136003";4;2;29;5;18;58
"1402";"360470136004";22;6;27;4;20;79
"1403";"360470137001";6;71;13;4;8;102
"1404";"360470137002";11;28;44;2;23;108
"1405";"360470137003";28;17;28;7;18;98
"1406";"360470138001";39;22;57;3;28;149
"1407";"360470138002";13;8;27;3;9;60
"1408";"360470138003";16;2;37;3;14;72
"1409";"360470139001";38;9;16;6;14;83
"1410";"360470139002";18;17;24;0;10;69
"1411";"360470139003";15;1;7;5;14;42
"1412";"360470139004";24;6;5;5;5;45
"1413";"360470140001";8;0;34;8;13;63
"1414";"360470140002";7;3;70;11;16;107
"1415";"360470141001";18;29;29;4;14;94
"1416";"360470141002";12;6;32;3;17;70
"1417";"360470141003";24;12;25;8;19;88
"1418";"360470142001";13;4;36;8;43;104
"1419";"360470142002";36;10;11;2;14;73
"1420";"360470142003";18;46;24;2;20;110
"1421";"360470143001";36;43;34;15;23;151
"1422";"360470143002";27;21;28;10;23;109
"1423";"360470143003";12;7;22;2;13;56
"1424";"360470145001";37;25;31;2;16;111
"1425";"360470145002";46;56;17;2;33;154
"1426";"360470145003";67;18;119;3;29;236
"1427";"360470145004";29;11;27;2;16;85
"1428";"360470147001";3;19;11;4;14;51
"1429";"360470147002";57;13;23;2;29;124
"1430";"360470148001";1;1;15;3;5;25
"1431";"360470148002";1;9;29;4;5;48
"1432";"360470149001";6;4;31;4;0;45
"1433";"360470149002";14;13;35;5;8;75
"1434";"360470149003";8;9;21;3;10;51
"1435";"360470149004";20;11;15;1;15;62
"1436";"360470149005";16;23;35;7;17;98
"1437";"360470150001";5;0;24;1;4;34
"1438";"360470150002";8;9;20;2;3;42
"1439";"360470151001";9;4;7;0;12;32
"1440";"360470151002";8;7;16;4;7;42
"1441";"360470151003";19;10;38;2;7;76
"1442";"360470151004";6;11;7;3;10;37
"1443";"360470152001";1;3;19;1;3;27
"1444";"360470152002";1;0;11;4;11;27
"1445";"360470152003";9;2;43;7;10;71
"1446";"360470153001";3;2;8;2;2;17
"1447";"360470153002";3;7;16;4;12;42
"1448";"360470153003";10;12;5;6;5;38
"1449";"360470153004";8;9;9;2;6;34
"1450";"360470154001";1;2;29;6;3;41
"1451";"360470155001";20;10;9;5;26;70
"1452";"360470155002";3;4;9;6;17;39
"1453";"360470155003";5;4;33;4;7;53
"1454";"360470155004";8;8;23;3;16;58
"1455";"360470157001";6;8;24;3;5;46
"1456";"360470157002";15;3;27;1;6;52
"1457";"360470157003";8;19;41;10;9;87
"1458";"360470157004";9;10;7;6;9;41
"1459";"360470159001";10;20;29;10;19;88
"1460";"360470159002";22;16;12;2;6;58
"1461";"360470159003";13;14;15;7;2;51
"1462";"360470159004";13;5;24;2;9;53
"1463";"360470159005";6;6;11;3;2;28
"1464";"360470160001";26;3;17;0;7;53
"1465";"360470160002";34;4;34;1;10;83
"1466";"360470160003";15;23;32;3;12;85
"1467";"360470160004";8;41;60;2;15;126
"1468";"360470161001";19;36;60;3;11;129
"1469";"360470161002";6;7;31;0;16;60
"1470";"360470161003";29;49;32;15;27;152
"1471";"360470162001";8;6;17;1;6;38
"1472";"360470162002";6;1;48;4;8;67
"1473";"360470163001";35;7;28;3;17;90
"1474";"360470163002";32;16;18;3;26;95
"1475";"360470163003";45;26;13;4;16;104
"1476";"360470164001";0;1;4;9;1;15
"1477";"360470165001";19;4;31;0;6;60
"1478";"360470165002";15;6;34;5;8;68
"1479";"360470165003";17;12;26;3;5;63
"1480";"360470165004";27;3;7;9;1;47
"1481";"360470166001";8;3;18;9;4;42
"1482";"360470166002";2;1;9;1;2;15
"1483";"360470167001";17;7;14;14;9;61
"1484";"360470167002";5;2;14;2;9;32
"1485";"360470167003";11;10;16;2;11;50
"1486";"360470167004";18;6;20;16;5;65
"1487";"360470168001";4;2;23;6;4;39
"1488";"360470169001";5;5;7;4;6;27
"1489";"360470169002";11;13;5;4;5;38
"1490";"360470169003";6;16;7;3;15;47
"1491";"360470169004";13;18;24;0;8;63
"1492";"360470169005";20;6;37;7;6;76
"1493";"360470170001";12;5;17;1;18;53
"1494";"360470170002";9;13;24;4;18;68
"1495";"360470170003";10;2;35;6;8;61
"1496";"360470171001";5;5;25;2;3;40
"1497";"360470171002";6;1;8;0;4;19
"1498";"360470171003";5;1;15;4;3;28
"1499";"360470171004";5;3;15;4;5;32
"1500";"360470172001";5;16;73;10;53;157
"1501";"360470172002";5;2;49;8;27;91
"1502";"360470174001";17;15;58;9;14;113
"1503";"360470174002";6;1;39;5;9;60
"1504";"360470175001";4;13;14;5;2;38
"1505";"360470176001";3;2;63;9;1;78
"1506";"360470176002";20;8;61;6;19;114
"1507";"360470177001";57;121;128;30;27;363
"1508";"360470178001";16;5;41;4;17;83
"1509";"360470178002";13;6;57;17;22;115
"1510";"360470179001";221;4;3;1;1;230
"1511";"360470179002";99;54;43;5;12;213
"1512";"360470179003";10;12;50;0;4;76
"1513";"360470180001";21;5;75;19;9;129
"1514";"360470180002";23;9;61;7;23;123
"1515";"360470181001";17;15;16;0;9;57
"1516";"360470181002";13;3;6;1;3;26
"1517";"360470181003";125;24;32;3;17;201
"1518";"360470181004";22;4;18;3;10;57
"1519";"360470182001";6;3;24;1;15;49
"1520";"360470182002";10;6;52;24;25;117
"1521";"360470183001";11;28;28;7;24;98
"1522";"360470183002";46;46;10;6;14;122
"1523";"360470183003";76;65;48;4;11;204
"1524";"360470184001";5;5;39;4;8;61
"1525";"360470184002";4;1;35;5;18;63
"1526";"360470185011";58;14;23;3;10;108
"1527";"360470185012";42;1;23;1;5;72
"1528";"360470185013";89;0;2;0;3;94
"1529";"360470185014";19;3;1;0;4;27
"1530";"360470186001";0;6;41;1;24;72
"1531";"360470186002";14;1;31;4;4;54
"1532";"360470187001";48;50;51;5;20;174
"1533";"360470188001";6;6;65;5;26;108
"1534";"360470188002";4;1;126;5;11;147
"1535";"360470190001";9;1;84;8;19;121
"1536";"360470190002";24;3;29;4;56;116
"1537";"360470190003";22;27;55;6;33;143
"1538";"360470191001";37;88;36;6;57;224
"1539";"360470191002";14;21;23;8;11;77
"1540";"360470191003";20;78;50;10;17;175
"1541";"360470192001";4;2;43;12;13;74
"1542";"360470192002";15;1;69;25;50;160
"1543";"360470193001";108;40;17;4;7;176
"1544";"360470193002";26;12;13;0;0;51
"1545";"360470193003";7;5;4;1;4;21
"1546";"360470193004";5;53;4;2;8;72
"1547";"360470194001";8;4;73;14;17;116
"1548";"360470194002";12;2;36;0;14;64
"1549";"360470194003";3;1;27;6;12;49
"1550";"360470195001";24;34;40;4;1;103
"1551";"360470195002";37;20;32;5;10;104
"1552";"360470195003";17;10;4;2;1;34
"1553";"360470195004";26;14;18;12;2;72
"1554";"360470196001";26;2;34;2;20;84
"1555";"360470196002";10;5;30;3;22;70
"1556";"360470196003";11;5;44;3;25;88
"1557";"360470197001";7;2;74;6;7;96
"1558";"360470197002";22;52;19;14;14;121
"1559";"360470197003";32;17;76;0;7;132
"1560";"360470197004";15;37;22;1;7;82
"1561";"360470198001";3;2;32;3;13;53
"1562";"360470198002";3;0;33;4;25;65
"1563";"360470199001";20;17;44;3;9;93
"1564";"360470199002";75;39;16;4;11;145
"1565";"360470199003";32;65;83;7;27;214
"1566";"360470199004";34;13;15;1;10;73
"1567";"360470200001";7;0;19;1;5;32
"1568";"360470200002";4;25;29;1;17;76
"1569";"360470201001";16;17;9;11;8;61
"1570";"360470201002";51;152;48;7;32;290
"1571";"360470201003";51;13;32;5;15;116
"1572";"360470201004";33;23;14;4;2;76
"1573";"360470202001";1;2;37;4;4;48
"1574";"360470202002";12;4;30;2;11;59
"1575";"360470203001";46;82;57;22;45;252
"1576";"360470203002";29;29;30;4;20;112
"1577";"360470204001";5;1;38;7;12;63
"1578";"360470204002";3;1;38;3;3;48
"1579";"360470205001";9;18;42;13;22;104
"1580";"360470205002";43;57;78;2;19;199
"1581";"360470205003";37;24;10;7;14;92
"1582";"360470206001";3;0;19;2;18;42
"1583";"360470206002";2;3;45;8;17;75
"1584";"360470207001";152;65;20;4;16;257
"1585";"360470207002";46;24;8;0;25;103
"1586";"360470207003";20;5;28;0;6;59
"1587";"360470208001";4;0;53;2;12;71
"1588";"360470208002";5;0;19;1;38;63
"1589";"360470208003";5;2;37;7;16;67
"1590";"360470210001";54;10;45;3;22;134
"1591";"360470210002";9;3;29;4;29;74
"1592";"360470210003";6;18;20;3;16;63
"1593";"360470211001";11;4;39;3;3;60
"1594";"360470211002";29;13;159;8;32;241
"1595";"360470212001";7;2;37;5;21;72
"1596";"360470212002";20;10;17;1;18;66
"1597";"360470212003";2;1;41;3;27;74
"1598";"360470213001";30;18;9;3;13;73
"1599";"360470213002";204;24;10;1;6;245
"1600";"360470213003";93;1;20;1;27;142
"1601";"360470214001";22;11;26;6;28;93
"1602";"360470214002";2;9;31;1;31;74
"1603";"360470215001";73;38;42;5;16;174
"1604";"360470215002";66;38;18;1;13;136
"1605";"360470215003";114;48;17;0;9;188
"1606";"360470215004";50;32;11;0;16;109
"1607";"360470216001";6;4;29;2;9;50
"1608";"360470216002";3;2;29;2;4;40
"1609";"360470216003";8;6;72;5;21;112
"1610";"360470217001";100;95;15;5;33;248
"1611";"360470217002";100;68;18;0;24;210
"1612";"360470218001";16;5;12;1;16;50
"1613";"360470218002";3;0;12;2;1;18
"1614";"360470218003";16;16;26;5;17;80
"1615";"360470219001";78;38;1;0;21;138
"1616";"360470219002";37;1;5;0;17;60
"1617";"360470219003";46;16;28;0;20;110
"1618";"360470220001";4;1;40;3;8;56
"1619";"360470220002";8;9;31;8;11;67
"1620";"360470220003";19;2;12;1;15;49
"1621";"360470220004";2;1;14;4;14;35
"1622";"360470221001";44;15;17;5;13;94
"1623";"360470221002";141;89;76;4;42;352
"1624";"360470221003";44;35;25;1;14;119
"1625";"360470222001";4;8;29;12;9;62
"1626";"360470222002";4;10;7;1;12;34
"1627";"360470222003";3;14;50;6;22;95
"1628";"360470224001";2;1;29;2;10;44
"1629";"360470224002";2;2;31;8;6;49
"1630";"360470224003";18;10;52;1;6;87
"1631";"360470224004";17;9;75;2;9;112
"1632";"360470226001";18;14;90;25;50;197
"1633";"360470226002";31;7;56;9;21;124
"1634";"360470227001";12;26;17;3;27;85
"1635";"360470227002";37;107;63;15;35;257
"1636";"360470227003";39;48;35;10;32;164
"1637";"360470227004";87;48;26;14;46;221
"1638";"360470228001";8;16;39;4;24;91
"1639";"360470228002";3;22;50;21;7;103
"1640";"360470228003";1;5;33;12;16;67
"1641";"360470229001";77;60;55;4;19;215
"1642";"360470229002";110;14;13;6;17;160
"1643";"360470229003";71;27;26;3;15;142
"1644";"360470229004";91;20;31;6;18;166
"1645";"360470230001";32;5;21;5;12;75
"1646";"360470230002";1;1;16;5;6;29
"1647";"360470230003";15;5;75;18;11;124
"1648";"360470231001";102;52;18;1;26;199
"1649";"360470231002";80;65;44;6;26;221
"1650";"360470231003";111;65;8;5;13;202
"1651";"360470232001";0;1;51;8;14;74
"1652";"360470232002";4;1;28;3;7;43
"1653";"360470232003";5;4;7;1;12;29
"1654";"360470232004";5;1;13;2;2;23
"1655";"360470232005";5;13;24;1;10;53
"1656";"360470233001";79;106;41;3;13;242
"1657";"360470233002";92;12;3;0;0;107
"1658";"360470233003";145;106;75;7;59;392
"1659";"360470234001";6;5;24;4;2;41
"1660";"360470234002";10;6;23;2;6;47
"1661";"360470234003";1;4;54;1;8;68
"1662";"360470235001";161;69;87;6;45;368
"1663";"360470235002";38;24;80;34;30;206
"1664";"360470236001";6;1;35;1;3;46
"1665";"360470236002";20;7;23;0;3;53
"1666";"360470236003";4;7;14;0;5;30
"1667";"360470236004";6;2;23;1;4;36
"1668";"360470238001";4;9;10;0;4;27
"1669";"360470238002";21;11;19;2;11;64
"1670";"360470238003";3;2;26;1;4;36
"1671";"360470240001";9;3;12;1;1;26
"1672";"360470240002";11;3;41;5;18;78
"1673";"360470240003";10;9;10;0;2;31
"1674";"360470241001";71;114;67;8;66;326
"1675";"360470241002";40;31;53;4;16;144
"1676";"360470242001";1;1;49;15;12;78
"1677";"360470242002";4;1;23;2;7;37
"1678";"360470243001";118;25;26;3;29;201
"1679";"360470243002";261;55;41;5;22;384
"1680";"360470243003";112;41;29;9;23;214
"1681";"360470244001";14;3;7;2;17;43
"1682";"360470244002";11;7;51;0;6;75
"1683";"360470244003";8;1;509;16;54;588
"1684";"360470245001";65;13;28;5;30;141
"1685";"360470245002";87;86;35;2;30;240
"1686";"360470245003";42;13;17;6;8;86
"1687";"360470245004";16;25;17;2;22;82
"1688";"360470246001";8;2;38;3;4;55
"1689";"360470246002";7;13;29;4;14;67
"1690";"360470246003";14;5;60;4;15;98
"1691";"360470247001";46;42;10;6;18;122
"1692";"360470247002";93;28;25;27;24;197
"1693";"360470248001";2;1;51;1;19;74
"1694";"360470248002";14;10;301;71;36;432
"1695";"360470249001";30;15;17;7;16;85
"1696";"360470249002";28;16;15;5;22;86
"1697";"360470249003";34;89;24;0;23;170
"1698";"360470249004";25;5;3;1;9;43
"1699";"360470250001";23;5;48;66;21;163
"1700";"360470250002";15;43;38;5;11;112
"1701";"360470251001";57;15;18;2;27;119
"1702";"360470251002";67;50;13;6;22;158
"1703";"360470251003";22;5;14;8;14;63
"1704";"360470252001";2;1;18;1;19;41
"1705";"360470252002";37;4;34;3;20;98
"1706";"360470252003";17;2;41;11;8;79
"1707";"360470252004";21;1;59;4;21;106
"1708";"360470253001";38;6;36;5;20;105
"1709";"360470253002";44;13;27;2;12;98
"1710";"360470253003";28;14;37;7;21;107
"1711";"360470254001";5;1;20;3;11;40
"1712";"360470254002";27;6;36;5;15;89
"1713";"360470254003";100;3;23;1;46;173
"1714";"360470255001";106;10;2;0;1;119
"1715";"360470255002";110;4;4;0;1;119
"1716";"360470256001";1;2;52;4;29;88
"1717";"360470256002";29;1;65;1;16;112
"1718";"360470257001";76;10;47;3;42;178
"1719";"360470257002";14;7;57;4;7;89
"1720";"360470257003";29;70;6;5;16;126
"1721";"360470258001";16;3;16;14;28;77
"1722";"360470258002";5;4;36;1;22;68
"1723";"360470258003";59;9;46;1;24;139
"1724";"360470259011";136;18;66;8;35;263
"1725";"360470259021";161;2;2;0;8;173
"1726";"360470260001";13;0;22;8;18;61
"1727";"360470260002";5;0;24;1;25;55
"1728";"360470260003";9;3;47;7;21;87
"1729";"360470261001";45;38;69;4;12;168
"1730";"360470261002";93;10;11;6;15;135
"1731";"360470261003";80;16;28;2;23;149
"1732";"360470261004";77;19;21;1;24;142
"1733";"360470261005";50;6;36;1;30;123
"1734";"360470262001";7;4;48;3;22;84
"1735";"360470262002";4;8;35;13;16;76
"1736";"360470263001";216;41;35;14;47;353
"1737";"360470264001";9;2;19;8;14;52
"1738";"360470264002";775;3;39;1;7;825
"1739";"360470264003";19;4;46;7;28;104
"1740";"360470264004";8;2;6;2;20;38
"1741";"360470265001";30;4;8;5;12;59
"1742";"360470265002";183;10;12;2;11;218
"1743";"360470265003";37;8;24;1;13;83
"1744";"360470265004";93;13;6;4;8;124
"1745";"360470266001";11;6;42;6;13;78
"1746";"360470266002";21;2;33;1;24;81
"1747";"360470266003";9;1;40;9;17;76
"1748";"360470267001";53;15;4;1;9;82
"1749";"360470267002";31;26;17;6;14;94
"1750";"360470267003";23;8;23;3;14;71
"1751";"360470267004";78;8;20;2;20;128
"1752";"360470268001";13;2;20;2;5;42
"1753";"360470268002";4;0;29;0;8;41
"1754";"360470268003";5;0;38;3;30;76
"1755";"360470268004";22;2;16;2;11;53
"1756";"360470269001";50;147;21;6;4;228
"1757";"360470269002";32;28;10;8;20;98
"1758";"360470269003";28;65;21;5;17;136
"1759";"360470270001";8;5;74;1;22;110
"1760";"360470270002";28;9;56;2;9;104
"1761";"360470271001";70;18;56;17;29;190
"1762";"360470271002";48;15;61;4;4;132
"1763";"360470272001";5;0;34;0;5;44
"1764";"360470272002";48;3;24;3;21;99
"1765";"360470272003";13;4;21;6;30;74
"1766";"360470273001";9;54;7;5;3;78
"1767";"360470273002";28;14;43;1;5;91
"1768";"360470273003";29;29;7;0;18;83
"1769";"360470274001";13;4;42;2;4;65
"1770";"360470274002";9;4;65;2;12;92
"1771";"360470275001";49;9;22;1;9;90
"1772";"360470275002";57;10;7;3;40;117
"1773";"360470275003";30;16;10;12;13;81
"1774";"360470275004";22;20;15;1;20;78
"1775";"360470276001";31;4;31;1;16;83
"1776";"360470276002";9;4;27;2;12;54
"1777";"360470276003";39;3;38;29;32;141
"1778";"360470277001";55;6;20;2;4;87
"1779";"360470277002";42;11;27;1;4;85
"1780";"360470277003";54;10;6;2;17;89
"1781";"360470277004";21;3;2;4;3;33
"1782";"360470278001";37;5;39;6;13;100
"1783";"360470278002";32;10;67;1;31;141
"1784";"360470279001";17;30;17;9;13;86
"1785";"360470279002";44;25;17;7;5;98
"1786";"360470279003";13;6;41;10;19;89
"1787";"360470279004";57;4;29;3;14;107
"1788";"360470280001";5;1;35;7;7;55
"1789";"360470280002";16;23;78;6;12;135
"1790";"360470281001";55;13;66;0;20;154
"1791";"360470281002";47;8;13;3;16;87
"1792";"360470281003";32;42;14;6;26;120
"1793";"360470282001";21;0;23;6;12;62
"1794";"360470282002";23;5;37;2;11;78
"1795";"360470282003";1;0;16;1;14;32
"1796";"360470283001";22;12;15;3;21;73
"1797";"360470283002";27;8;31;4;11;81
"1798";"360470283003";40;34;8;7;7;96
"1799";"360470284001";23;4;49;1;4;81
"1800";"360470284002";25;2;33;2;23;85
"1801";"360470284003";9;4;71;0;24;108
"1802";"360470285011";11;4;11;2;43;71
"1803";"360470285021";186;6;9;1;6;208
"1804";"360470286001";25;2;1;0;7;35
"1805";"360470286002";145;1;24;6;8;184
"1806";"360470286003";15;1;2;0;2;20
"1807";"360470286004";5;11;48;8;12;84
"1808";"360470286005";13;7;74;1;8;103
"1809";"360470287001";97;98;34;6;68;303
"1810";"360470287002";61;8;22;23;12;126
"1811";"360470287003";59;29;2;7;18;115
"1812";"360470288001";4;1;18;1;14;38
"1813";"360470288002";12;1;24;4;26;67
"1814";"360470288003";18;1;43;9;17;88
"1815";"360470289001";20;17;22;7;34;100
"1816";"360470289002";44;19;20;2;26;111
"1817";"360470289003";22;10;13;4;23;72
"1818";"360470289004";105;8;8;9;10;140
"1819";"360470290001";54;0;42;2;7;105
"1820";"360470290002";21;4;31;0;6;62
"1821";"360470290003";16;5;35;4;21;81
"1822";"360470291001";38;16;20;5;12;91
"1823";"360470291002";41;11;55;6;22;135
"1824";"360470291003";25;0;12;1;6;44
"1825";"360470292001";13;5;45;3;9;75
"1826";"360470292002";23;1;63;1;6;94
"1827";"360470293001";13;3;2;2;7;27
"1828";"360470293002";14;6;4;2;1;27
"1829";"360470293003";18;5;10;2;8;43
"1830";"360470293004";42;14;14;0;10;80
"1831";"360470294001";16;9;56;2;11;94
"1832";"360470295001";38;9;23;0;5;75
"1833";"360470295002";43;17;10;3;8;81
"1834";"360470295003";19;21;5;0;15;60
"1835";"360470295004";37;3;21;2;6;69
"1836";"360470296001";45;2;58;0;11;116
"1837";"360470296002";17;4;52;5;28;106
"1838";"360470296003";13;2;85;3;7;110
"1839";"360470296004";34;6;61;1;12;114
"1840";"360470297001";31;81;7;6;18;143
"1841";"360470297002";49;13;3;3;8;76
"1842";"360470297003";21;11;15;4;9;60
"1843";"360470298001";20;2;48;3;14;87
"1844";"360470298002";27;22;32;3;24;108
"1845";"360470298003";2;0;27;5;14;48
"1846";"360470299001";17;1;22;4;20;64
"1847";"360470299002";34;15;9;13;13;84
"1848";"360470300001";27;38;59;5;29;158
"1849";"360470300002";14;10;53;12;18;107
"1850";"360470301001";30;7;27;14;14;92
"1851";"360470301002";7;6;18;15;7;53
"1852";"360470301003";21;6;29;3;14;73
"1853";"360470302001";8;4;43;4;12;71
"1854";"360470302002";16;2;23;8;11;60
"1855";"360470302003";5;5;21;6;18;55
"1856";"360470303001";85;29;12;2;17;145
"1857";"360470303002";29;6;8;8;8;59
"1858";"360470303003";45;8;16;8;19;96
"1859";"360470304001";5;8;81;14;21;129
"1860";"360470304002";5;1;54;2;24;86
"1861";"360470304003";20;3;17;12;10;62
"1862";"360470305001";67;81;53;10;61;272
"1863";"360470305002";191;77;34;5;10;317
"1864";"360470305003";85;55;21;2;11;174
"1865";"360470305004";110;41;19;4;10;184
"1866";"360470306001";11;7;68;11;26;123
"1867";"360470307001";52;3;3;0;4;62
"1868";"360470307002";50;9;4;0;7;70
"1869";"360470307003";45;57;84;26;48;260
"1870";"360470308001";70;6;72;28;31;207
"1871";"360470309001";191;13;24;3;27;258
"1872";"360470309002";13;9;15;5;14;56
"1873";"360470311001";36;3;39;5;22;105
"1874";"360470311002";137;26;19;4;11;197
"1875";"360470311003";44;2;11;6;13;76
"1876";"360470313001";68;15;6;9;18;116
"1877";"360470313002";44;11;15;4;19;93
"1878";"360470313003";66;16;28;1;12;123
"1879";"360470313004";88;4;102;1;22;217
"1880";"360470314001";14;2;37;12;11;76
"1881";"360470314002";23;6;17;5;5;56
"1882";"360470314003";19;2;7;2;3;33
"1883";"360470314004";26;0;62;10;12;110
"1884";"360470315001";42;74;55;1;28;200
"1885";"360470315002";66;13;6;2;12;99
"1886";"360470315003";66;20;9;0;28;123
"1887";"360470315004";140;66;16;1;25;248
"1888";"360470317011";67;21;38;4;14;144
"1889";"360470317012";47;23;8;2;14;94
"1890";"360470317013";118;48;12;0;20;198
"1891";"360470317021";206;73;7;6;18;310
"1892";"360470317022";150;17;10;0;26;203
"1893";"360470317023";281;78;16;1;32;408
"1894";"360470319001";90;86;13;0;5;194
"1895";"360470319002";29;15;15;1;9;69
"1896";"360470319003";39;10;27;21;12;109
"1897";"360470321001";59;17;13;1;18;108
"1898";"360470321002";64;25;7;0;8;104
"1899";"360470321003";130;31;5;0;9;175
"1900";"360470321004";95;37;21;6;12;171
"1901";"360470323001";221;13;5;5;13;257
"1902";"360470323002";37;8;8;1;8;62
"1903";"360470323003";52;15;27;3;13;110
"1904";"360470325001";187;40;15;0;6;248
"1905";"360470325002";88;25;18;1;17;149
"1906";"360470325003";175;16;10;0;9;210
"1907";"360470326001";12;10;20;1;24;67
"1908";"360470326002";36;12;7;4;11;70
"1909";"360470326003";104;9;0;0;4;117
"1910";"360470326004";10;16;0;0;5;31
"1911";"360470326005";12;4;23;1;9;49
"1912";"360470327001";136;55;21;3;22;237
"1913";"360470327002";62;17;22;3;12;116
"1914";"360470327003";34;35;3;1;14;87
"1915";"360470328001";4;6;10;1;7;28
"1916";"360470328002";0;2;1;2;1;6
"1917";"360470328003";31;1;1;2;2;37
"1918";"360470328004";7;3;11;7;4;32
"1919";"360470329001";98;24;28;5;22;177
"1920";"360470329002";68;25;23;4;7;127
"1921";"360470329003";39;68;23;1;6;137
"1922";"360470329004";67;20;4;1;17;109
"1923";"360470330001";96;4;2;2;1;105
"1924";"360470330002";7;5;3;9;4;28
"1925";"360470330003";64;20;8;1;7;100
"1926";"360470331001";43;3;33;1;15;95
"1927";"360470331002";99;8;5;4;11;127
"1928";"360470331003";12;1;5;1;6;25
"1929";"360470333001";53;4;18;0;8;83
"1930";"360470333002";14;9;43;2;5;73
"1931";"360470333003";34;5;8;7;7;61
"1932";"360470335001";24;3;41;0;6;74
"1933";"360470335002";7;2;15;2;8;34
"1934";"360470335003";25;15;18;8;19;85
"1935";"360470336001";5;2;1;4;14;26
"1936";"360470336002";7;11;6;6;13;43
"1937";"360470336003";0;0;0;2;4;6
"1938";"360470336004";3;2;5;3;16;29
"1939";"360470336005";2;3;6;4;19;34
"1940";"360470337001";33;13;17;1;18;82
"1941";"360470337002";27;24;12;2;12;77
"1942";"360470337003";76;35;36;2;21;170
"1943";"360470339001";141;24;69;10;11;255
"1944";"360470339002";35;29;14;3;12;93
"1945";"360470339003";31;48;17;2;8;106
"1946";"360470339004";24;6;20;5;3;58
"1947";"360470340001";138;20;11;4;6;179
"1948";"360470340002";0;3;0;2;0;5
"1949";"360470341001";50;15;10;0;1;76
"1950";"360470341002";25;4;12;0;4;45
"1951";"360470341003";70;19;2;6;16;113
"1952";"360470342001";78;18;3;2;12;113
"1953";"360470342002";13;1;6;0;4;24
"1954";"360470342003";42;11;7;4;5;69
"1955";"360470342004";19;0;4;0;2;25
"1956";"360470343001";170;1;8;2;1;182
"1957";"360470343002";100;21;26;3;13;163
"1958";"360470343003";85;19;32;5;20;161
"1959";"360470345001";57;10;25;3;22;117
"1960";"360470345002";64;44;13;13;13;147
"1961";"360470347001";37;5;19;1;2;64
"1962";"360470347002";69;17;18;6;17;127
"1963";"360470347003";56;13;22;3;21;115
"1964";"360470348001";18;8;74;37;38;175
"1965";"360470348002";41;8;36;5;30;120
"1966";"360470349001";47;10;5;1;23;86
"1967";"360470349002";40;11;9;2;14;76
"1968";"360470349003";117;12;48;5;27;209
"1969";"360470349004";45;21;5;0;10;81
"1970";"360470350001";2;1;1;0;1;5
"1971";"360470350002";2;7;17;2;18;46
"1972";"360470351001";82;20;26;1;31;160
"1973";"360470351002";64;5;19;2;6;96
"1974";"360470351003";109;15;43;3;29;199
"1975";"360470352001";36;28;17;4;15;100
"1976";"360470353001";84;53;4;7;23;171
"1977";"360470353002";79;18;23;0;21;141
"1978";"360470353003";115;14;23;6;20;178
"1979";"360470354001";14;5;5;6;2;32
"1980";"360470354002";29;8;3;2;19;61
"1981";"360470354003";5;10;7;0;4;26
"1982";"360470355001";154;20;23;2;22;221
"1983";"360470355002";116;12;12;1;22;163
"1984";"360470355003";98;24;18;6;18;164
"1985";"360470356011";4;4;7;8;3;26
"1986";"360470356021";16;5;5;0;3;29
"1987";"360470356022";14;7;10;9;5;45
"1988";"360470356023";15;15;21;2;4;57
"1989";"360470357001";400;21;31;7;35;494
"1990";"360470359001";77;58;22;0;19;176
"1991";"360470359002";57;7;24;0;10;98
"1992";"360470359003";73;23;23;4;14;137
"1993";"360470359004";139;11;14;2;10;176
"1994";"360470360011";15;12;12;0;7;46
"1995";"360470360012";5;4;14;0;5;28
"1996";"360470360013";28;2;8;0;3;41
"1997";"360470360021";42;26;2;0;21;91
"1998";"360470360022";57;30;6;3;11;107
"1999";"360470361001";27;4;5;2;10;48
"2000";"360470361002";22;9;30;6;10;77
"2001";"360470361003";62;10;2;3;8;85
"2002";"360470362001";128;3;69;2;46;248
"2003";"360470362002";27;3;52;1;24;107
"2004";"360470362003";16;5;34;1;29;85
"2005";"360470363001";37;11;14;4;16;82
"2006";"360470363002";20;6;19;2;29;76
"2007";"360470363003";37;8;22;9;10;86
"2008";"360470363004";19;1;11;5;3;39
"2009";"360470364001";54;51;61;3;57;226
"2010";"360470364002";19;7;64;1;22;113
"2011";"360470365011";25;9;17;8;3;62
"2012";"360470365012";33;7;50;19;22;131
"2013";"360470365021";36;31;82;19;43;211
"2014";"360470366001";29;7;21;7;6;70
"2015";"360470366002";10;8;22;8;20;68
"2016";"360470366003";43;4;10;0;8;65
"2017";"360470367001";20;13;44;6;25;108
"2018";"360470367002";1;1;16;8;3;29
"2019";"360470369001";55;15;26;19;15;130
"2020";"360470369002";18;5;18;3;32;76
"2021";"360470369003";80;14;30;6;21;151
"2022";"360470369004";57;10;25;0;34;126
"2023";"360470370001";9;1;81;20;10;121
"2024";"360470370002";16;3;46;0;16;81
"2025";"360470370003";2;1;99;12;7;121
"2026";"360470370004";1;4;29;11;3;48
"2027";"360470371001";15;6;7;0;13;41
"2028";"360470371002";43;9;13;5;11;81
"2029";"360470371003";19;3;30;7;10;69
"2030";"360470371004";16;2;24;1;9;52
"2031";"360470371005";16;6;22;15;17;76
"2032";"360470373001";106;10;4;0;27;147
"2033";"360470373002";20;5;6;8;17;56
"2034";"360470373003";70;22;6;1;4;103
"2035";"360470373004";49;27;8;5;18;107
"2036";"360470374011";17;2;41;7;4;71
"2037";"360470374012";18;14;46;9;18;105
"2038";"360470374013";26;3;37;4;2;72
"2039";"360470374021";6;20;24;6;16;72
"2040";"360470374022";27;0;23;2;4;56
"2041";"360470374023";4;1;2;1;2;10
"2042";"360470374024";7;2;27;4;11;51
"2043";"360470375001";34;9;5;3;6;57
"2044";"360470375002";63;11;24;6;41;145
"2045";"360470375003";28;16;26;4;20;94
"2046";"360470377001";42;13;7;2;5;69
"2047";"360470377002";98;15;16;6;7;142
"2048";"360470377003";198;24;6;5;21;254
"2049";"360470377004";98;16;13;12;21;160
"2050";"360470379001";49;20;5;6;20;100
"2051";"360470379002";37;8;54;12;20;131
"2052";"360470379003";37;9;28;9;15;98
"2053";"360470381001";32;4;12;3;15;66
"2054";"360470381002";51;9;1;6;9;76
"2055";"360470381003";31;54;29;2;24;140
"2056";"360470381004";48;9;8;5;19;89
"2057";"360470382001";3;1;22;6;7;39
"2058";"360470382002";153;21;6;6;2;188
"2059";"360470382003";19;3;1;0;1;24
"2060";"360470383001";92;35;15;2;13;157
"2061";"360470383002";65;15;26;1;17;124
"2062";"360470383003";24;19;17;6;10;76
"2063";"360470383004";93;6;11;2;11;123
"2064";"360470385001";58;8;15;5;27;113
"2065";"360470385002";28;2;12;5;14;61
"2066";"360470385003";82;39;11;0;12;144
"2067";"360470385004";27;9;29;3;5;73
"2068";"360470386001";29;5;117;66;26;243
"2069";"360470386002";10;2;84;17;26;139
"2070";"360470387001";12;5;16;0;51;84
"2071";"360470387002";143;3;15;0;17;178
"2072";"360470387003";21;10;30;2;12;75
"2073";"360470387004";107;29;25;4;45;210
"2074";"360470388001";19;2;14;3;4;42
"2075";"360470388002";23;7;32;1;16;79
"2076";"360470388003";6;1;45;8;12;72
"2077";"360470388004";11;0;17;10;2;40
"2078";"360470389001";74;22;18;3;36;153
"2079";"360470389002";61;49;24;14;49;197
"2080";"360470389003";40;30;58;9;33;170
"2081";"360470390001";12;1;38;7;6;64
"2082";"360470390002";19;1;14;5;6;45
"2083";"360470391001";105;11;30;6;17;169
"2084";"360470391002";64;30;30;20;37;181
"2085";"360470392001";6;616;46;4;14;686
"2086";"360470392002";10;24;28;7;13;82
"2087";"360470393001";36;10;46;7;46;145
"2088";"360470393002";40;15;32;3;32;122
"2089";"360470393003";95;74;15;4;66;254
"2090";"360470394001";13;33;32;8;16;102
"2091";"360470394002";18;4;28;1;1;52
"2092";"360470394003";13;1;22;6;7;49
"2093";"360470395001";74;22;33;6;25;160
"2094";"360470395002";51;8;22;5;51;137
"2095";"360470395003";39;1;38;6;46;130
"2096";"360470396001";7;1;20;8;7;43
"2097";"360470396002";35;2;42;12;13;104
"2098";"360470397001";41;18;49;5;27;140
"2099";"360470397002";68;14;16;4;20;122
"2100";"360470397003";70;15;23;5;43;156
"2101";"360470398001";19;35;82;57;35;228
"2102";"360470398002";7;19;21;48;15;110
"2103";"360470399001";103;15;41;1;21;181
"2104";"360470399002";53;36;20;3;23;135
"2105";"360470399003";15;12;13;0;19;59
"2106";"360470400001";23;3;60;64;16;166
"2107";"360470400002";3;2;22;1;11;39
"2108";"360470400003";13;13;40;2;31;99
"2109";"360470401001";38;7;13;2;6;66
"2110";"360470401002";83;11;28;6;19;147
"2111";"360470401003";36;14;34;1;34;119
"2112";"360470402001";13;7;61;22;26;129
"2113";"360470402002";10;8;43;11;15;87
"2114";"360470403001";56;22;30;4;20;132
"2115";"360470403002";48;14;22;8;22;114
"2116";"360470403003";30;23;46;6;24;129
"2117";"360470404001";22;5;39;11;12;89
"2118";"360470404002";8;10;60;10;18;106
"2119";"360470405001";55;54;91;52;31;283
"2120";"360470405002";29;4;6;2;10;51
"2121";"360470406001";15;2;57;12;14;100
"2122";"360470406002";7;1;76;0;7;91
"2123";"360470406003";24;0;54;2;15;95
"2124";"360470407001";0;1;1;3;0;5
"2125";"360470408001";6;3;16;3;11;39
"2126";"360470408002";17;3;23;6;13;62
"2127";"360470408003";7;5;80;7;25;124
"2128";"360470409001";86;24;30;6;26;172
"2129";"360470409002";95;13;22;2;26;158
"2130";"360470409003";68;4;19;1;17;109
"2131";"360470410001";17;55;81;13;14;180
"2132";"360470410002";12;2;53;6;4;77
"2133";"360470411001";50;18;16;5;10;99
"2134";"360470411002";22;8;17;5;18;70
"2135";"360470411003";19;0;15;1;17;52
"2136";"360470412001";30;5;67;37;18;157
"2137";"360470412002";16;3;251;24;26;320
"2138";"360470413001";24;14;24;7;11;80
"2139";"360470413002";33;2;23;2;19;79
"2140";"360470413003";38;3;29;7;27;104
"2141";"360470414011";11;26;22;5;9;73
"2142";"360470414012";4;26;374;5;15;424
"2143";"360470414021";50;2;12;7;4;75
"2144";"360470414022";16;2;10;3;3;34
"2145";"360470415001";60;15;24;6;15;120
"2146";"360470415002";85;20;41;8;37;191
"2147";"360470415003";144;5;24;0;14;187
"2148";"360470416001";14;9;54;8;11;96
"2149";"360470416002";17;3;31;2;2;55
"2150";"360470417001";26;2;14;0;5;47
"2151";"360470417002";26;4;1;1;8;40
"2152";"360470417003";29;9;25;1;12;76
"2153";"360470417004";15;6;8;2;12;43
"2154";"360470418001";39;6;21;3;20;89
"2155";"360470418002";24;6;20;0;12;62
"2156";"360470419001";72;13;30;2;20;137
"2157";"360470419002";50;15;13;3;26;107
"2158";"360470419003";64;13;7;3;9;96
"2159";"360470420001";19;5;22;2;12;60
"2160";"360470420002";11;4;69;9;10;103
"2161";"360470421001";45;30;35;1;21;132
"2162";"360470421002";40;19;11;6;26;102
"2163";"360470421003";38;33;18;2;32;123
"2164";"360470421004";39;37;37;9;11;133
"2165";"360470422001";21;1;22;4;15;63
"2166";"360470422002";8;6;76;12;7;109
"2167";"360470422003";20;0;28;11;20;79
"2168";"360470423001";51;33;44;3;33;164
"2169";"360470423002";81;36;27;9;31;184
"2170";"360470423003";30;10;21;0;13;74
"2171";"360470424001";4;4;52;8;33;101
"2172";"360470424002";13;3;64;16;11;107
"2173";"360470424003";17;2;71;6;1;97
"2174";"360470425001";63;41;43;1;8;156
"2175";"360470425002";59;99;15;9;14;196
"2176";"360470425003";43;52;82;10;14;201
"2177";"360470426001";20;14;53;5;21;113
"2178";"360470426002";15;6;59;14;11;105
"2179";"360470426003";4;5;28;5;7;49
"2180";"360470427001";141;86;35;2;15;279
"2181";"360470427002";79;33;45;0;25;182
"2182";"360470427003";96;63;19;3;26;207
"2183";"360470427004";32;57;44;6;14;153
"2184";"360470428001";14;4;35;4;9;66
"2185";"360470428002";36;4;36;8;4;88
"2186";"360470428003";15;13;26;4;12;70
"2187";"360470429001";52;34;27;1;26;140
"2188";"360470429002";53;27;36;3;16;135
"2189";"360470429003";60;56;13;3;22;154
"2190";"360470429004";164;24;2;0;15;205
"2191";"360470430001";13;1;50;9;9;82
"2192";"360470430002";21;29;25;5;8;88
"2193";"360470430003";20;9;74;2;6;111
"2194";"360470431001";58;8;27;2;26;121
"2195";"360470431002";135;11;12;1;32;191
"2196";"360470431003";102;19;5;3;16;145
"2197";"360470431004";74;45;12;0;20;151
"2198";"360470432001";14;7;45;3;9;78
"2199";"360470432002";26;2;45;1;42;116
"2200";"360470432003";17;10;78;8;16;129
"2201";"360470433001";73;7;3;1;3;87
"2202";"360470433002";35;30;11;1;15;92
"2203";"360470433003";36;15;2;1;30;84
"2204";"360470434001";34;10;52;15;12;123
"2205";"360470434002";3;0;37;3;13;56
"2206";"360470434003";80;4;36;0;11;131
"2207";"360470435001";155;29;14;1;18;217
"2208";"360470435002";77;26;21;6;29;159
"2209";"360470435003";44;20;13;5;21;103
"2210";"360470436001";18;4;36;8;17;83
"2211";"360470436002";11;18;15;2;9;55
"2212";"360470436003";12;3;50;0;11;76
"2213";"360470437001";79;8;43;2;12;144
"2214";"360470437002";92;22;9;1;20;144
"2215";"360470437003";104;120;8;3;19;254
"2216";"360470437004";71;33;6;1;7;118
"2217";"360470438001";18;10;28;2;12;70
"2218";"360470438002";30;21;86;19;35;191
"2219";"360470439001";28;13;48;8;28;125
"2220";"360470439002";52;18;58;3;19;150
"2221";"360470439003";15;29;31;2;22;99
"2222";"360470440001";23;3;21;4;2;53
"2223";"360470440002";3;0;286;12;2;303
"2224";"360470440003";8;5;53;20;31;117
"2225";"360470441001";72;55;29;2;22;180
"2226";"360470441002";73;20;28;6;22;149
"2227";"360470441003";82;19;25;8;13;147
"2228";"360470442001";26;34;39;8;10;117
"2229";"360470442002";12;2;31;9;1;55
"2230";"360470443001";31;5;7;3;8;54
"2231";"360470443002";103;35;32;6;22;198
"2232";"360470443003";72;29;35;2;20;158
"2233";"360470443004";57;9;26;2;16;110
"2234";"360470444001";11;1;47;4;10;73
"2235";"360470444002";14;3;19;6;2;44
"2236";"360470444003";106;7;63;3;9;188
"2237";"360470445001";40;4;51;2;13;110
"2238";"360470445002";35;36;57;7;13;148
"2239";"360470445003";91;154;44;5;8;302
"2240";"360470446001";3;1;41;4;24;73
"2241";"360470446002";8;1;45;9;13;76
"2242";"360470447001";180;36;55;4;32;307
"2243";"360470447002";116;106;40;10;42;314
"2244";"360470448001";17;7;46;5;14;89
"2245";"360470448002";12;9;54;6;7;88
"2246";"360470449001";17;14;2;4;11;48
"2247";"360470449002";108;34;9;1;3;155
"2248";"360470449003";31;84;66;11;25;217
"2249";"360470449004";8;98;101;70;74;351
"2250";"360470450001";0;9;55;11;16;91
"2251";"360470452001";2;2;38;3;1;46
"2252";"360470452002";34;5;18;5;4;66
"2253";"360470453001";39;69;74;34;77;293
"2254";"360470453002";92;102;59;15;49;317
"2255";"360470454001";7;3;31;2;33;76
"2256";"360470454002";5;2;24;6;6;43
"2257";"360470456001";19;18;40;11;38;126
"2258";"360470456002";62;11;32;6;13;124
"2259";"360470458001";13;6;100;4;8;131
"2260";"360470458002";1;0;18;7;3;29
"2261";"360470460001";9;7;39;6;19;80
"2262";"360470460002";19;8;21;2;38;88
"2263";"360470460003";5;10;46;12;27;100
"2264";"360470462011";59;6;39;10;15;129
"2265";"360470462012";8;11;318;5;12;354
"2266";"360470462021";11;0;19;2;25;57
"2267";"360470462022";8;1;79;16;18;122
"2268";"360470464001";6;4;36;12;5;63
"2269";"360470464002";2;0;13;2;11;28
"2270";"360470468001";3;69;121;13;22;228
"2271";"360470470001";2;2;34;3;4;45
"2272";"360470470002";3;3;10;3;2;21
"2273";"360470472001";0;1;8;16;0;25
"2274";"360470472002";16;16;73;5;27;137
"2275";"360470472003";1;1;25;10;1;38
"2276";"360470474001";4;5;19;5;5;38
"2277";"360470474002";0;0;22;8;3;33
"2278";"360470476001";16;75;52;12;14;169
"2279";"360470476002";2;4;11;4;6;27
"2280";"360470476003";5;4;22;2;9;42
"2281";"360470477001";73;21;35;15;50;194
"2282";"360470477002";85;29;40;5;50;209
"2283";"360470478001";23;109;79;14;44;269
"2284";"360470478002";7;5;19;4;11;46
"2285";"360470478003";20;4;62;23;17;126
"2286";"360470480001";80;12;75;2;44;213
"2287";"360470480002";24;14;58;15;43;154
"2288";"360470481001";20;14;16;2;16;68
"2289";"360470481002";17;5;17;4;14;57
"2290";"360470481003";62;42;40;8;24;176
"2291";"360470482001";68;45;107;23;16;259
"2292";"360470482002";11;21;91;47;32;202
"2293";"360470482003";30;3;73;3;8;117
"2294";"360470482004";158;95;52;7;15;327
"2295";"360470484001";52;39;38;10;11;150
"2296";"360470484002";13;3;78;7;16;117
"2297";"360470484003";12;1;34;7;11;65
"2298";"360470485001";120;71;127;23;138;479
"2299";"360470485002";138;133;49;13;54;387
"2300";"360470486001";12;72;48;7;52;191
"2301";"360470486002";80;38;55;9;29;211
"2302";"360470486003";5;209;33;10;76;333
"2303";"360470488001";5;12;55;2;29;103
"2304";"360470488002";11;4;102;2;9;128
"2305";"360470488003";10;4;35;2;6;57
"2306";"360470489001";154;10;0;0;0;164
"2307";"360470489002";37;1;4;2;6;50
"2308";"360470489003";59;4;1;0;3;67
"2309";"360470490001";97;20;32;1;14;164
"2310";"360470490002";84;6;46;4;9;149
"2311";"360470490003";15;8;59;2;23;107
"2312";"360470491001";9;18;3;1;0;31
"2313";"360470491002";20;438;10;2;31;501
"2314";"360470491003";69;79;7;0;32;187
"2315";"360470491004";4;14;4;3;3;28
"2316";"360470492001";43;16;28;21;10;118
"2317";"360470492002";30;35;62;15;46;188
"2318";"360470492003";12;31;41;17;23;124
"2319";"360470493001";230;27;4;2;8;271
"2320";"360470493002";279;61;14;0;30;384
"2321";"360470493003";23;30;12;0;24;89
"2322";"360470493004";21;10;3;1;10;45
"2323";"360470493005";77;88;9;3;23;200
"2324";"360470494001";78;10;16;5;9;118
"2325";"360470494002";75;3;30;2;15;125
"2326";"360470494003";20;5;24;3;10;62
"2327";"360470494004";1;0;10;0;3;14
"2328";"360470495001";31;26;7;4;11;79
"2329";"360470495002";37;68;21;2;31;159
"2330";"360470495003";29;63;14;3;33;142
"2331";"360470496001";25;22;37;8;93;185
"2332";"360470496002";22;16;37;5;22;102
"2333";"360470496003";8;1;40;11;23;83
"2334";"360470497001";19;9;15;7;21;71
"2335";"360470497002";40;26;11;13;29;119
"2336";"360470497003";120;60;29;4;61;274
"2337";"360470498001";99;39;22;6;38;204
"2338";"360470498002";26;23;16;9;12;86
"2339";"360470498003";17;17;62;24;19;139
"2340";"360470499001";17;12;11;0;10;50
"2341";"360470499002";57;7;20;7;37;128
"2342";"360470500001";9;4;17;6;9;45
"2343";"360470500002";30;16;23;7;15;91
"2344";"360470500003";54;3;33;3;7;100
"2345";"360470501001";17;3;18;4;20;62
"2346";"360470501002";21;12;5;4;11;53
"2347";"360470501003";33;31;27;5;39;135
"2348";"360470502021";18;6;35;6;7;72
"2349";"360470502022";14;6;27;4;6;57
"2350";"360470503001";17;70;28;12;20;147
"2351";"360470503002";54;24;8;2;15;103
"2352";"360470503003";18;55;25;4;21;123
"2353";"360470504001";3;3;14;3;2;25
"2354";"360470504002";38;18;33;3;20;112
"2355";"360470504003";70;29;42;27;29;197
"2356";"360470505001";52;16;1;1;3;73
"2357";"360470505002";79;54;10;1;53;197
"2358";"360470505003";58;90;9;2;29;188
"2359";"360470506001";79;37;20;0;10;146
"2360";"360470506002";66;18;43;13;7;147
"2361";"360470506003";58;9;5;1;16;89
"2362";"360470506004";68;13;13;9;23;126
"2363";"360470507001";15;26;71;18;42;172
"2364";"360470508011";168;22;4;1;7;202
"2365";"360470508012";669;20;13;0;18;720
"2366";"360470508031";694;35;5;1;17;752
"2367";"360470508041";124;50;20;5;7;206
"2368";"360470508042";159;53;73;5;17;307
"2369";"360470508043";163;4;61;2;15;245
"2370";"360470509001";17;37;83;19;26;182
"2371";"360470509002";18;4;21;0;14;57
"2372";"360470510011";82;21;3;5;2;113
"2373";"360470510012";220;83;11;0;27;341
"2374";"360470510021";70;16;9;3;9;107
"2375";"360470510022";84;7;38;0;10;139
"2376";"360470510023";80;17;3;2;1;103
"2377";"360470511001";13;26;2;3;7;51
"2378";"360470511002";83;74;32;0;47;236
"2379";"360470511003";47;37;18;3;18;123
"2380";"360470512001";107;41;11;8;25;192
"2381";"360470512002";174;18;11;0;10;213
"2382";"360470512003";68;21;10;0;2;101
"2383";"360470512004";68;53;7;2;5;135
"2384";"360470513001";26;65;57;3;34;185
"2385";"360470513002";50;69;23;3;3;148
"2386";"360470513003";138;100;47;10;79;374
"2387";"360470513004";27;81;19;4;15;146
"2388";"360470514001";43;11;44;7;9;114
"2389";"360470514002";54;49;22;0;16;141
"2390";"360470514003";115;57;24;2;16;214
"2391";"360470514004";379;32;31;2;9;453
"2392";"360470515001";90;103;42;8;26;269
"2393";"360470516011";86;5;8;0;6;105
"2394";"360470516012";143;15;19;2;6;185
"2395";"360470516013";146;51;91;8;32;328
"2396";"360470516021";172;13;4;2;6;197
"2397";"360470516022";290;38;24;9;57;418
"2398";"360470517001";28;57;22;1;24;132
"2399";"360470517002";31;299;41;4;37;412
"2400";"360470518001";43;2;49;7;4;105
"2401";"360470518002";72;15;39;13;8;147
"2402";"360470518003";28;15;17;5;12;77
"2403";"360470519001";107;252;42;3;50;454
"2404";"360470519002";60;39;31;13;36;179
"2405";"360470519003";72;224;88;6;59;449
"2406";"360470520001";42;8;34;18;1;103
"2407";"360470520002";21;16;22;4;6;69
"2408";"360470520003";24;24;5;2;7;62
"2409";"360470523001";71;281;6;4;106;468
"2410";"360470523002";55;120;1;0;38;214
"2411";"360470523003";100;27;18;5;20;170
"2412";"360470523004";12;30;9;1;9;61
"2413";"360470523005";45;38;8;1;30;122
"2414";"360470525001";61;52;15;7;62;197
"2415";"360470525002";45;15;10;0;19;89
"2416";"360470526001";26;25;50;11;27;139
"2417";"360470526002";97;11;34;7;26;175
"2418";"360470526003";3;7;31;6;1;48
"2419";"360470527001";32;31;34;3;40;140
"2420";"360470527002";12;61;4;2;24;103
"2421";"360470527003";32;37;27;3;53;152
"2422";"360470527004";41;55;4;8;54;162
"2423";"360470527005";41;115;1;0;18;175
"2424";"360470527006";53;52;7;5;16;133
"2425";"360470527007";13;11;5;0;13;42
"2426";"360470528001";33;1;33;9;7;83
"2427";"360470528002";3;1;61;11;15;91
"2428";"360470529001";2;10;14;0;6;32
"2429";"360470529002";33;18;3;1;11;66
"2430";"360470529003";7;44;19;6;31;107
"2431";"360470530001";51;4;32;1;7;95
"2432";"360470530002";48;5;31;1;7;92
"2433";"360470530003";31;18;48;14;16;127
"2434";"360470531001";4;9;10;5;17;45
"2435";"360470531002";3;20;9;0;2;34
"2436";"360470531003";1;6;0;1;0;8
"2437";"360470531004";3;1;20;2;0;26
"2438";"360470532001";14;5;46;2;14;81
"2439";"360470532002";41;4;17;3;9;74
"2440";"360470533001";1;1;1;0;3;6
"2441";"360470533002";0;0;3;0;1;4
"2442";"360470533003";0;2;1;0;8;11
"2443";"360470533004";2;5;3;3;2;15
"2444";"360470533005";2;11;6;4;8;31
"2445";"360470534001";64;6;50;3;16;139
"2446";"360470534002";16;1;13;0;3;33
"2447";"360470534003";13;8;9;0;16;46
"2448";"360470534004";26;38;21;1;9;95
"2449";"360470535001";0;0;3;1;6;10
"2450";"360470535002";0;1;1;12;2;16
"2451";"360470535003";0;5;9;1;6;21
"2452";"360470535004";2;12;15;5;6;40
"2453";"360470537001";0;1;8;2;5;16
"2454";"360470537002";1;2;30;7;11;51
"2455";"360470538001";49;2;28;3;9;91
"2456";"360470538002";186;7;22;6;26;247
"2457";"360470538003";34;22;89;2;25;172
"2458";"360470539001";0;0;16;6;5;27
"2459";"360470539002";5;1;2;4;2;14
"2460";"360470542001";32;3;71;17;33;156
"2461";"360470542002";20;7;49;4;32;112
"2462";"360470542003";5;2;41;3;23;74
"2463";"360470543001";2;12;26;7;5;52
"2464";"360470543002";11;100;66;12;31;220
"2465";"360470544001";10;1;44;3;28;86
"2466";"360470544002";19;1;70;7;5;102
"2467";"360470544003";1;0;67;3;11;82
"2468";"360470545001";0;1;10;0;2;13
"2469";"360470545002";2;19;7;0;1;29
"2470";"360470545003";27;31;2;0;3;63
"2471";"360470545004";0;0;0;0;1;1
"2472";"360470545005";164;26;7;1;3;201
"2473";"360470545006";45;11;5;0;5;66
"2474";"360470546001";18;5;38;4;10;75
"2475";"360470546002";111;6;38;3;8;166
"2476";"360470546003";41;5;44;2;13;105
"2477";"360470547001";54;10;4;8;2;78
"2478";"360470547002";22;12;49;3;7;93
"2479";"360470547003";31;28;30;3;12;104
"2480";"360470548001";28;1;48;26;4;107
"2481";"360470548002";97;23;109;33;5;267
"2482";"360470549001";52;71;29;6;12;170
"2483";"360470549002";84;276;107;5;68;540
"2484";"360470550001";22;4;30;16;7;79
"2485";"360470550002";11;2;100;19;8;140
"2486";"360470550003";28;2;44;3;9;86
"2487";"360470551001";58;128;55;7;42;290
"2488";"360470551002";57;62;17;6;31;173
"2489";"360470551003";173;58;17;12;39;299
"2490";"360470551004";38;35;6;1;24;104
"2491";"360470552001";73;3;31;1;14;122
"2492";"360470552002";22;10;46;2;8;88
"2493";"360470552003";21;4;41;3;8;77
"2494";"360470553001";32;163;59;12;49;315
"2495";"360470553002";30;74;21;4;30;159
"2496";"360470553003";35;161;52;6;56;310
"2497";"360470554001";24;8;35;4;18;89
"2498";"360470554002";14;2;37;1;11;65
"2499";"360470554003";17;14;54;0;23;108
"2500";"360470555001";279;344;218;18;166;1025
"2501";"360470556001";5;2;76;6;13;102
"2502";"360470556002";8;4;56;2;13;83
"2503";"360470556003";12;2;31;5;12;62
"2504";"360470557001";76;44;19;1;43;183
"2505";"360470557002";67;124;66;1;50;308
"2506";"360470558001";28;1;17;2;9;57
"2507";"360470558002";48;12;58;12;12;142
"2508";"360470560001";12;0;72;33;6;123
"2509";"360470560002";24;3;41;2;7;77
"2510";"360470560003";13;1;26;21;2;63
"2511";"360470561001";26;11;32;0;23;92
"2512";"360470561002";18;1;5;3;17;44
"2513";"360470561003";14;8;34;4;35;95
"2514";"360470561004";9;8;41;0;23;81
"2515";"360470562001";1;1;16;15;11;44
"2516";"360470562002";5;0;27;49;2;83
"2517";"360470563001";28;25;15;7;15;90
"2518";"360470563002";71;69;48;4;33;225
"2519";"360470563003";39;33;22;3;25;122
"2520";"360470563004";71;60;92;6;27;256
"2521";"360470564001";4;6;15;8;12;45
"2522";"360470564002";3;1;26;25;4;59
"2523";"360470564003";0;0;8;2;5;15
"2524";"360470565001";44;139;70;7;53;313
"2525";"360470565002";82;10;17;2;17;128
"2526";"360470565003";25;20;7;0;25;77
"2527";"360470566001";19;4;27;13;5;68
"2528";"360470566002";12;1;26;9;9;57
"2529";"360470568001";6;3;36;19;12;76
"2530";"360470568002";6;1;23;14;11;55
"2531";"360470569001";38;114;7;1;83;243
"2532";"360470569002";55;38;27;5;44;169
"2533";"360470570001";5;2;9;3;4;23
"2534";"360470570002";15;2;5;1;1;24
"2535";"360470570003";4;1;3;5;1;14
"2536";"360470570004";7;8;37;16;15;83
"2537";"360470571001";18;29;26;3;32;108
"2538";"360470571002";12;5;17;7;16;57
"2539";"360470571003";19;15;6;9;21;70
"2540";"360470571004";8;9;17;5;12;51
"2541";"360470572001";231;6;3;10;3;253
"2542";"360470572002";414;0;7;7;4;432
"2543";"360470573001";37;12;18;4;13;84
"2544";"360470573002";34;7;21;2;25;89
"2545";"360470573003";34;17;13;3;11;78
"2546";"360470574001";39;8;23;23;16;109
"2547";"360470574002";8;2;7;11;13;41
"2548";"360470575001";14;24;6;2;27;73
"2549";"360470575002";33;16;17;1;26;93
"2550";"360470575003";25;14;20;5;18;82
"2551";"360470575004";13;11;12;8;18;62
"2552";"360470576001";13;7;35;17;12;84
"2553";"360470576002";8;5;35;15;10;73
"2554";"360470578001";75;4;64;37;13;193
"2555";"360470578002";37;13;79;1;25;155
"2556";"360470579001";5;6;19;2;17;49
"2557";"360470579002";11;10;107;31;56;215
"2558";"360470580001";45;69;38;0;27;179
"2559";"360470580002";28;21;38;1;16;104
"2560";"360470582001";32;1;47;7;13;100
"2561";"360470582002";2;10;7;5;6;30
"2562";"360470582003";70;13;50;1;11;145
"2563";"360470584001";29;4;38;5;8;84
"2564";"360470584002";102;13;74;21;40;250
"2565";"360470586001";6;4;35;18;17;80
"2566";"360470586002";6;2;27;10;8;53
"2567";"360470588001";25;8;85;10;16;144
"2568";"360470588002";80;8;20;0;19;127
"2569";"360470589001";28;17;37;7;22;111
"2570";"360470589002";41;16;29;5;14;105
"2571";"360470590001";41;3;70;5;48;167
"2572";"360470591001";28;9;11;3;3;54
"2573";"360470591002";27;5;19;3;9;63
"2574";"360470591003";11;10;12;7;10;50
"2575";"360470591004";13;32;13;0;14;72
"2576";"360470592001";31;0;15;4;7;57
"2577";"360470592002";24;9;64;14;12;123
"2578";"360470592003";13;5;17;3;17;55
"2579";"360470593001";11;4;63;10;15;103
"2580";"360470593002";67;27;5;1;18;118
"2581";"360470594011";3;1;15;6;5;30
"2582";"360470594012";4;1;43;28;34;110
"2583";"360470594013";18;5;53;28;16;120
"2584";"360470594014";10;3;46;48;37;144
"2585";"360470594015";53;3;26;9;11;102
"2586";"360470594016";16;6;31;12;11;76
"2587";"360470594021";6;5;17;8;19;55
"2588";"360470594022";48;0;35;10;7;100
"2589";"360470594023";3;0;41;17;3;64
"2590";"360470594024";4;0;36;14;13;67
"2591";"360470596001";1;7;1;5;4;18
"2592";"360470596002";2;1;5;2;0;10
"2593";"360470596003";3;1;55;18;13;90
"2594";"360470598001";12;1;19;43;11;86
"2595";"360470598002";18;1;12;55;6;92
"2596";"360470600001";11;1;13;5;3;33
"2597";"360470600002";13;2;83;32;23;153
"2598";"360470600003";33;4;115;64;16;232
"2599";"360470600004";14;1;30;6;7;58
"2600";"360470600005";14;6;55;12;8;95
"2601";"360470606001";24;5;29;4;13;75
"2602";"360470606002";6;6;27;30;8;77
"2603";"360470608001";27;5;44;30;13;119
"2604";"360470608002";7;2;36;16;18;79
"2605";"360470608003";102;11;33;5;25;176
"2606";"360470610021";14;7;29;4;1;55
"2607";"360470610022";88;21;14;0;8;131
"2608";"360470610031";12;8;27;2;11;60
"2609";"360470610032";15;3;11;8;15;52
"2610";"360470610041";18;20;56;0;15;109
"2611";"360470610042";11;2;36;2;7;58
"2612";"360470610043";19;2;53;3;7;84
"2613";"360470610044";42;0;11;1;10;64
"2614";"360470610045";59;4;26;3;27;119
"2615";"360470612001";7;10;30;19;12;78
"2616";"360470616001";4;12;109;27;15;167
"2617";"360470620001";7;9;22;14;16;68
"2618";"360470620002";5;4;47;6;15;77
"2619";"360470622001";28;7;76;24;28;163
"2620";"360470622002";21;81;53;52;30;237
"2621";"360470626001";10;0;40;33;4;87
"2622";"360470626002";60;8;29;22;12;131
"2623";"360470628001";19;6;25;29;21;100
"2624";"360470628002";20;11;36;39;17;123
"2625";"360470628003";7;0;21;18;13;59
"2626";"360470628004";11;0;65;52;31;159
"2627";"360470632001";31;4;6;5;9;55
"2628";"360470632002";1;1;6;5;4;17
"2629";"360470636001";3;4;55;7;14;83
"2630";"360470638001";0;1;4;3;4;12
"2631";"360470638002";6;2;27;15;7;57
"2632";"360470640001";46;1;46;21;15;129
"2633";"360470640002";1;1;16;4;6;28
"2634";"360470642001";8;11;35;27;20;101
"2635";"360470642002";23;1;26;15;9;74
"2636";"360470644001";3;5;53;12;11;84
"2637";"360470644002";24;6;36;42;12;120
"2638";"360470646001";5;5;28;11;6;55
"2639";"360470646002";7;4;47;24;10;92
"2640";"360470648001";68;14;32;37;28;179
"2641";"360470648002";8;3;40;17;23;91
"2642";"360470650001";4;7;36;4;6;57
"2643";"360470650002";42;1;35;31;14;123
"2644";"360470652001";6;143;47;12;25;233
"2645";"360470654001";1;1;37;6;2;47
"2646";"360470654002";11;1;13;10;9;44
"2647";"360470656001";12;13;27;8;11;71
"2648";"360470656002";1;0;17;7;6;31
"2649";"360470658001";6;2;67;10;12;97
"2650";"360470658002";13;0;45;17;6;81
"2651";"360470660001";9;0;28;10;2;49
"2652";"360470660002";5;1;18;8;7;39
"2653";"360470662001";12;16;55;28;21;132
"2654";"360470666001";5;36;19;11;10;81
"2655";"360470670001";11;0;27;28;4;70
"2656";"360470670002";52;8;98;41;18;217
"2657";"360470672001";100;12;81;79;15;287
"2658";"360470674001";61;11;40;22;51;185
"2659";"360470674002";25;15;44;64;12;160
"2660";"360470676001";32;4;37;57;9;139
"2661";"360470676002";12;50;36;37;8;143
"2662";"360470678001";22;1;146;35;19;223
"2663";"360470678002";28;4;36;53;4;125
"2664";"360470680001";13;8;40;18;5;84
"2665";"360470680002";19;57;49;52;9;186
"2666";"360470682001";30;14;62;39;12;157
"2667";"360470682002";61;3;29;32;5;130
"2668";"360470686001";5;3;30;15;18;71
"2669";"360470686002";7;1;25;18;10;61
"2670";"360470688001";20;2;38;22;13;95
"2671";"360470688002";26;0;17;15;3;61
"2672";"360470690001";13;2;26;15;8;64
"2673";"360470690002";31;8;31;28;8;106
"2674";"360470692001";59;4;54;67;18;202
"2675";"360470692002";31;1;43;13;6;94
"2676";"360470696011";40;4;66;8;19;137
"2677";"360470696012";70;2;171;26;27;296
"2678";"360470696021";7;8;48;11;11;85
"2679";"360470696022";43;4;67;34;12;160
"2680";"360470696023";32;3;141;31;18;225
"2681";"360470698001";6;0;12;6;4;28
"2682";"360470698002";13;4;49;26;18;110
"2683";"360470700001";1;2;6;8;11;28
"2684";"360470700002";3;4;66;10;20;103
"2685";"360470702011";15;4;21;20;6;66
"2686";"360470702012";12;1;3;16;5;37
"2687";"360470702013";13;1;18;25;7;64
"2688";"360470702014";10;8;119;26;19;182
"2689";"360470702015";20;5;78;26;30;159
"2690";"360470702021";0;2;0;0;0;2
"2691";"360470706001";3;1;24;17;15;60
"2692";"360470706002";15;6;46;27;20;114
"2693";"360470720001";51;6;103;54;27;241
"2694";"360470722001";35;1;58;19;6;119
"2695";"360470722002";24;9;58;32;13;136
"2696";"360470724001";14;1;20;2;4;41
"2697";"360470724002";14;11;62;46;13;146
"2698";"360470726001";54;21;79;55;21;230
"2699";"360470728001";51;9;54;11;12;137
"2700";"360470728002";37;8;18;30;8;101
"2701";"360470730001";10;20;96;48;13;187
"2702";"360470730002";25;12;23;23;10;93
"2703";"360470732001";34;5;68;6;19;132
"2704";"360470732002";53;8;39;36;12;148
"2705";"360470734001";15;1;22;8;4;50
"2706";"360470734002";12;2;31;8;4;57
"2707";"360470736001";66;1;19;21;5;112
"2708";"360470736002";11;2;8;8;3;32
"2709";"360470736003";18;9;18;7;20;72
"2710";"360470738001";33;11;36;9;15;104
"2711";"360470738002";11;1;10;3;4;29
"2712";"360470738003";30;6;15;9;17;77
"2713";"360470740001";82;11;77;26;12;208
"2714";"360470740002";40;10;75;11;16;152
"2715";"360470742001";38;11;141;13;12;215
"2716";"360470742002";47;8;31;9;17;112
"2717";"360470744001";2;0;57;4;9;72
"2718";"360470744002";4;1;43;2;4;54
"2719";"360470746001";25;7;23;8;6;69
"2720";"360470746002";6;9;70;1;8;94
"2721";"360470748001";27;12;51;7;12;109
"2722";"360470748002";4;3;20;5;1;33
"2723";"360470750001";3;2;38;6;16;65
"2724";"360470750002";37;2;30;4;14;87
"2725";"360470752001";1;1;48;6;5;61
"2726";"360470754001";4;0;11;8;2;25
"2727";"360470754002";2;3;5;2;4;16
"2728";"360470756001";7;4;40;7;12;70
"2729";"360470756002";1;0;10;7;1;19
"2730";"360470758001";5;2;43;21;15;86
"2731";"360470758002";17;0;22;5;3;47
"2732";"360470760001";2;0;12;4;0;18
"2733";"360470760002";20;1;3;0;2;26
"2734";"360470760003";14;12;11;1;12;50
"2735";"360470762001";133;0;15;7;2;157
"2736";"360470762002";18;1;49;4;4;76
"2737";"360470762003";24;6;20;1;6;57
"2738";"360470764001";59;5;21;8;3;96
"2739";"360470764002";38;5;20;6;6;75
"2740";"360470764003";41;16;31;2;6;96
"2741";"360470766001";156;7;44;7;29;243
"2742";"360470768001";29;8;27;7;14;85
"2743";"360470768002";6;10;53;2;16;87
"2744";"360470768003";40;3;86;4;42;175
"2745";"360470770001";59;20;41;6;19;145
"2746";"360470770002";41;14;68;27;51;201
"2747";"360470772001";54;7;75;17;19;172
"2748";"360470772002";67;23;27;6;9;132
"2749";"360470774001";21;4;78;1;4;108
"2750";"360470774002";84;29;59;13;10;195
"2751";"360470776001";46;3;2;5;7;63
"2752";"360470776002";24;54;28;12;6;124
"2753";"360470776003";16;4;40;11;10;81
"2754";"360470780001";16;0;15;7;7;45
"2755";"360470780002";139;1;45;8;7;200
"2756";"360470782001";30;5;13;14;14;76
"2757";"360470782002";169;5;49;4;11;238
"2758";"360470784001";28;7;36;2;13;86
"2759";"360470784002";54;17;43;20;6;140
"2760";"360470786001";50;3;21;3;27;104
"2761";"360470786002";29;23;30;3;16;101
"2762";"360470786003";312;24;70;11;21;438
"2763";"360470788001";23;4;37;4;11;79
"2764";"360470788002";72;6;28;14;22;142
"2765";"360470788003";14;10;25;12;30;91
"2766";"360470790001";63;169;28;20;13;293
"2767";"360470790002";126;333;65;12;23;559
"2768";"360470790003";11;4;18;5;5;43
"2769";"360470790004";22;4;41;18;10;95
"2770";"360470792001";46;96;50;19;27;238
"2771";"360470792002";133;24;12;22;31;222
"2772";"360470792003";135;32;74;27;38;306
"2773";"360470794001";61;18;61;29;28;197
"2774";"360470794002";35;20;16;12;11;94
"2775";"360470796011";119;62;25;13;35;254
"2776";"360470796012";117;122;36;4;16;295
"2777";"360470796021";125;20;37;3;31;216
"2778";"360470796022";185;32;30;4;14;265
"2779";"360470798011";83;144;38;1;13;279
"2780";"360470798012";56;42;53;5;30;186
"2781";"360470798021";295;29;9;0;9;342
"2782";"360470798022";132;63;7;1;25;228
"2783";"360470798023";159;93;24;11;24;311
"2784";"360470800001";187;47;13;1;20;268
"2785";"360470800002";62;29;27;2;14;134
"2786";"360470800003";23;13;18;3;20;77
"2787";"360470802001";63;13;32;4;17;129
"2788";"360470802002";69;20;41;6;9;145
"2789";"360470802003";389;96;39;1;11;536
"2790";"360470804001";103;32;32;2;16;185
"2791";"360470804002";35;15;7;2;10;69
"2792";"360470804003";32;20;46;3;13;114
"2793";"360470806001";38;14;55;6;23;136
"2794";"360470806002";82;22;45;7;18;174
"2795";"360470808001";5;5;24;4;5;43
"2796";"360470810001";63;21;30;2;21;137
"2797";"360470810002";13;16;128;7;10;174
"2798";"360470814001";44;6;30;7;24;111
"2799";"360470814002";45;7;107;13;22;194
"2800";"360470816001";37;3;100;6;20;166
"2801";"360470816002";49;75;47;7;22;200
"2802";"360470818001";88;31;34;3;12;168
"2803";"360470818002";37;3;15;4;17;76
"2804";"360470818003";65;50;50;3;15;183
"2805";"360470820001";85;52;65;2;26;230
"2806";"360470820002";230;13;104;2;7;356
"2807";"360470820003";82;17;40;3;15;157
"2808";"360470822001";150;41;32;0;17;240
"2809";"360470822002";528;73;41;3;14;659
"2810";"360470822003";175;27;67;3;10;282
"2811";"360470822004";66;16;73;3;30;188
"2812";"360470824001";25;12;35;4;15;91
"2813";"360470824002";48;16;27;4;14;109
"2814";"360470824003";62;18;179;10;8;277
"2815";"360470824004";21;16;38;6;22;103
"2816";"360470826001";20;13;25;4;8;70
"2817";"360470826002";14;27;57;12;28;138
"2818";"360470826003";69;18;53;10;18;168
"2819";"360470826004";31;55;55;15;16;172
"2820";"360470828001";44;32;29;6;12;123
"2821";"360470828002";36;34;42;13;33;158
"2822";"360470828003";53;16;52;5;24;150
"2823";"360470830001";86;2;64;14;15;181
"2824";"360470830002";25;8;30;8;12;83
"2825";"360470830003";104;1;36;2;5;148
"2826";"360470830004";190;11;2;1;2;206
"2827";"360470832001";13;7;33;7;11;71
"2828";"360470832002";18;0;23;8;13;62
"2829";"360470834001";9;0;13;8;9;39
"2830";"360470834002";25;2;32;6;5;70
"2831";"360470836001";29;7;31;25;14;106
"2832";"360470836002";40;66;20;18;22;166
"2833";"360470838001";47;18;32;8;8;113
"2834";"360470838002";17;3;32;2;5;59
"2835";"360470840001";20;4;44;24;9;101
"2836";"360470840002";24;2;40;32;14;112
"2837";"360470846001";42;36;40;23;11;152
"2838";"360470846002";15;26;54;20;14;129
"2839";"360470848001";39;2;22;14;10;87
"2840";"360470848002";23;6;15;11;7;62
"2841";"360470850001";37;4;24;29;15;109
"2842";"360470852001";0;1;0;4;1;6
"2843";"360470854001";34;4;10;5;8;61
"2844";"360470854002";60;10;29;14;10;123
"2845";"360470856001";112;10;42;4;13;181
"2846";"360470856002";52;2;33;2;8;97
"2847";"360470856003";41;4;71;5;10;131
"2848";"360470858001";18;3;15;9;10;55
"2849";"360470858002";54;9;20;18;17;118
"2850";"360470860001";13;18;31;8;35;105
"2851";"360470860002";61;31;35;4;5;136
"2852";"360470860003";23;11;20;5;6;65
"2853";"360470862001";26;17;43;3;7;96
"2854";"360470862002";38;12;72;5;12;139
"2855";"360470862003";39;10;18;5;16;88
"2856";"360470864001";22;13;98;44;20;197
"2857";"360470864002";20;22;52;18;10;122
"2858";"360470866001";116;33;39;4;16;208
"2859";"360470866002";83;15;63;4;28;193
"2860";"360470866003";49;21;32;0;15;117
"2861";"360470868001";27;2;14;6;7;56
"2862";"360470868002";73;17;97;1;15;203
"2863";"360470868003";56;20;48;16;39;179
"2864";"360470870001";18;1;28;4;10;61
"2865";"360470870002";27;26;33;3;24;113
"2866";"360470870003";12;3;26;12;11;64
"2867";"360470872001";6;3;11;4;4;28
"2868";"360470872002";13;2;36;6;4;61
"2869";"360470872003";36;4;21;9;20;90
"2870";"360470874011";25;41;74;26;18;184
"2871";"360470874012";150;37;56;8;9;260
"2872";"360470876001";316;11;21;5;11;364
"2873";"360470876002";22;1;23;4;10;60
"2874";"360470878001";33;20;49;5;14;121
"2875";"360470878002";0;7;5;6;2;20
"2876";"360470878003";43;12;20;7;9;91
"2877";"360470880001";25;10;39;10;14;98
"2878";"360470880002";34;10;0;0;2;46
"2879";"360470880003";60;12;45;1;28;146
"2880";"360470882001";48;9;43;3;6;109
"2881";"360470882002";66;8;21;2;20;117
"2882";"360470882003";28;2;13;1;15;59
"2883";"360470882004";38;5;63;2;28;136
"2884";"360470884001";55;10;27;3;42;137
"2885";"360470884002";30;9;18;1;33;91
"2886";"360470884003";70;9;35;6;42;162
"2887";"360470886001";65;2;34;0;14;115
"2888";"360470886002";206;26;28;6;15;281
"2889";"360470886003";110;0;65;29;19;223
"2890";"360470888001";39;15;53;1;15;123
"2891";"360470888002";24;2;28;5;7;66
"2892";"360470888003";28;6;31;11;5;81
"2893";"360470890001";45;4;20;11;13;93
"2894";"360470890002";34;7;26;2;18;87
"2895";"360470890003";51;4;3;0;9;67
"2896";"360470890004";59;19;26;1;21;126
"2897";"360470890005";10;9;16;0;9;44
"2898";"360470890006";5;1;7;2;6;21
"2899";"360470892001";433;2;14;1;24;474
"2900";"360470892002";26;4;15;0;36;81
"2901";"360470892003";79;4;8;2;29;122
"2902";"360470892004";10;1;3;2;12;28
"2903";"360470894001";15;2;3;6;5;31
"2904";"360470894002";21;4;15;3;19;62
"2905";"360470894003";36;7;5;0;16;64
"2906";"360470894004";12;3;9;1;9;34
"2907";"360470896001";21;9;7;4;9;50
"2908";"360470896002";47;12;50;11;12;132
"2909";"360470896003";57;15;17;4;19;112
"2910";"360470898001";54;8;40;3;13;118
"2911";"360470898002";26;5;26;7;28;92
"2912";"360470900001";8;0;23;2;8;41
"2913";"360470900002";1;0;1;1;2;5
"2914";"360470900003";15;3;5;6;9;38
"2915";"360470900004";16;12;9;6;8;51
"2916";"360470900005";52;17;36;1;13;119
"2917";"360470900006";262;11;10;0;15;298
"2918";"360470900007";8;0;2;3;9;22
"2919";"360470902001";20;5;1;5;12;43
"2920";"360470902002";1;1;3;1;0;6
"2921";"360470902003";2;1;4;1;4;12
"2922";"360470902004";41;1;9;4;18;73
"2923";"360470902005";7;4;9;1;0;21
"2924";"360470906001";63;1;1;1;12;78
"2925";"360470906002";104;9;9;1;60;183
"2926";"360470906003";204;5;0;4;3;216
"2927";"360470908001";554;27;29;18;31;659
"2928";"360470908002";19;3;2;3;0;27
"2929";"360470908003";52;3;5;0;19;79
"2930";"360470910001";202;5;4;0;1;212
"2931";"360470910002";210;2;0;0;1;213
"2932";"360470910003";18;0;1;0;0;19
"2933";"360470910004";7;1;6;6;20;40
"2934";"360470912001";43;1;3;0;1;48
"2935";"360470912002";50;2;0;0;2;54
"2936";"360470912003";162;3;1;0;2;168
"2937";"360470916001";30;0;1;3;5;39
"2938";"360470916002";36;13;12;5;10;76
"2939";"360470916003";17;12;25;7;16;77
"2940";"360470916004";83;8;74;4;33;202
"2941";"360470918001";25;2;6;4;9;46
"2942";"360470918002";11;5;20;13;5;54
"2943";"360470920001";18;4;3;0;11;36
"2944";"360470920002";163;9;5;6;7;190
"2945";"360470920003";46;8;39;70;26;189
"2946";"360470922001";40;10;24;4;18;96
"2947";"360470922002";21;1;15;7;4;48
"2948";"360470924001";26;4;25;5;21;81
"2949";"360470924002";10;3;45;7;2;67
"2950";"360470924003";38;1;1;1;3;44
"2951";"360470928001";32;1;89;12;6;140
"2952";"360470928002";40;1;72;32;12;157
"2953";"360470930001";15;1;30;1;8;55
"2954";"360470930002";22;14;78;21;4;139
"2955";"360470932001";12;63;97;114;15;301
"2956";"360470934001";18;1;33;13;3;68
"2957";"360470934002";39;6;26;26;9;106
"2958";"360470936001";28;1;13;17;1;60
"2959";"360470936002";17;4;27;10;6;64
"2960";"360470938001";31;6;33;11;12;93
"2961";"360470938002";16;2;24;8;5;55
"2962";"360470944011";127;1;7;14;1;150
"2963";"360470944012";14;7;55;12;11;99
"2964";"360470944013";78;14;18;21;15;146
"2965";"360470944014";17;33;9;19;30;108
"2966";"360470944021";221;45;14;5;5;290
"2967";"360470946001";1;4;9;19;6;39
"2968";"360470946002";5;0;7;1;4;17
"2969";"360470946003";25;28;45;39;5;142
"2970";"360470950001";96;6;30;4;21;157
"2971";"360470950002";23;2;26;11;10;72
"2972";"360470954001";14;2;29;13;1;59
"2973";"360470954002";42;4;23;12;11;92
"2974";"360470954003";45;4;40;1;17;107
"2975";"360470956001";37;7;28;13;14;99
"2976";"360470956002";57;3;101;13;19;193
"2977";"360470958001";40;9;18;27;14;108
"2978";"360470958002";29;7;97;27;28;188
"2979";"360470960001";26;17;26;59;9;137
"2980";"360470962001";41;5;57;27;18;148
"2981";"360470964001";25;0;35;25;10;95
"2982";"360470964002";132;10;47;12;28;229
"2983";"360470966001";23;5;54;15;14;111
"2984";"360470966002";23;1;38;14;10;86
"2985";"360470968001";54;8;33;0;22;117
"2986";"360470968002";25;5;37;7;3;77
"2987";"360470970001";28;2;39;8;10;87
"2988";"360470970002";32;2;55;14;8;111
"2989";"360470974001";141;7;32;5;11;196
"2990";"360470974002";31;5;45;10;13;104
"2991";"360470982001";68;12;7;2;1;90
"2992";"360470982002";326;4;4;5;4;343
"2993";"360470984001";38;5;58;6;10;117
"2994";"360470986001";32;3;23;9;14;81
"2995";"360470986002";25;2;21;13;9;70
"2996";"360470988001";38;7;32;2;17;96
"2997";"360470988002";58;2;43;4;10;117
"2998";"360470990001";126;58;59;12;14;269
"2999";"360470992001";34;11;47;13;18;123
"3000";"360470994001";71;23;73;21;11;199
"3001";"360470996001";118;9;82;12;12;233
"3002";"360470996002";25;5;34;13;9;86
"3003";"360470998001";39;3;54;15;12;123
"3004";"360470998002";24;12;48;5;9;98
"3005";"360471004001";26;3;53;16;20;118
"3006";"360471006001";44;6;53;11;12;126
"3007";"360471006002";29;6;49;12;14;110
"3008";"360471008001";50;3;43;22;11;129
"3009";"360471008002";21;2;26;3;4;56
"3010";"360471010001";27;7;34;9;14;91
"3011";"360471010002";41;4;41;11;27;124
"3012";"360471012001";25;3;39;12;2;81
"3013";"360471012002";28;0;36;13;9;86
"3014";"360471014001";40;5;13;5;5;68
"3015";"360471014002";64;5;4;4;6;83
"3016";"360471016001";30;4;16;9;8;67
"3017";"360471018001";11;2;12;19;5;49
"3018";"360471020001";41;1;26;12;10;90
"3019";"360471022001";56;8;72;16;27;179
"3020";"360471024001";94;16;70;7;10;197
"3021";"360471026001";78;13;87;29;18;225
"3022";"360471028001";9;48;22;13;9;101
"3023";"360471028002";13;2;33;12;10;70
"3024";"360471034001";257;16;17;4;5;299
"3025";"360471058011";7;0;3;0;3;13
"3026";"360471058012";10;1;6;0;6;23
"3027";"360471058013";0;0;9;1;1;11
"3028";"360471058041";2;0;8;2;1;13
"3029";"360471058042";5;2;3;1;0;11
"3030";"360471058043";5;1;2;2;3;13
"3031";"360471058044";9;2;14;5;5;35
"3032";"360471070001";23;29;16;18;4;90
"3033";"360471078001";9;2;20;7;2;40
"3034";"360471078002";24;7;5;10;1;47
"3035";"360471078003";20;2;19;9;4;54
"3036";"360471078004";42;1;2;0;3;48
"3037";"360471098001";36;4;23;24;18;105
"3038";"360471098002";18;16;74;94;25;227
"3039";"360471104001";22;6;78;38;28;172
"3040";"360471104002";102;11;29;10;8;160
"3041";"360471104003";12;2;10;2;2;28
"3042";"360471104004";44;11;23;20;15;113
"3043";"360471106001";115;7;2;1;1;126
"3044";"360471106002";135;3;0;1;1;140
"3045";"360471110001";257;11;7;13;1;289
"3046";"360471110002";31;6;0;6;3;46
"3047";"360471116001";37;4;35;14;12;102
"3048";"360471116002";27;8;32;15;23;105
"3049";"360471118001";65;9;24;7;16;121
"3050";"360471118002";49;13;54;12;32;160
"3051";"360471120001";24;12;16;0;28;80
"3052";"360471120002";91;9;59;5;18;182
"3053";"360471122001";31;12;47;9;27;126
"3054";"360471122002";54;13;44;9;17;137
"3055";"360471124001";17;5;17;9;22;70
"3056";"360471124002";19;7;20;3;16;65
"3057";"360471124003";39;1;9;6;16;71
"3058";"360471126001";33;3;14;2;7;59
"3059";"360471126002";54;4;16;3;16;93
"3060";"360471126003";30;8;13;3;14;68
"3061";"360471128001";45;5;23;1;16;90
"3062";"360471128002";23;4;8;3;24;62
"3063";"360471128003";68;9;19;4;35;135
"3064";"360471130001";3;1;1;0;1;6
"3065";"360471130002";90;12;7;1;3;113
"3066";"360471130003";63;11;13;1;16;104
"3067";"360471130004";19;4;42;7;10;82
"3068";"360471132001";15;10;14;7;7;53
"3069";"360471132002";24;5;46;22;14;111
"3070";"360471134001";2;0;3;3;7;15
"3071";"360471134002";38;0;1;0;0;39
"3072";"360471134003";14;1;4;6;3;28
"3073";"360471142011";18;18;19;9;14;78
"3074";"360471142012";12;3;84;23;15;137
"3075";"360471142021";65;15;58;9;20;167
"3076";"360471142022";51;15;45;6;15;132
"3077";"360471144001";1;5;19;14;22;61
"3078";"360471144002";130;3;13;8;18;172
"3079";"360471144003";5;5;8;8;19;45
"3080";"360471144004";16;3;7;5;2;33
"3081";"360471146001";102;16;61;19;24;222
"3082";"360471146002";41;10;66;22;41;180
"3083";"360471150001";26;6;12;5;11;60
"3084";"360471150002";34;5;32;14;10;95
"3085";"360471150003";27;4;15;6;18;70
"3086";"360471152001";18;8;634;17;162;839
"3087";"360471152002";63;10;14;1;14;102
"3088";"360471152003";39;13;14;2;33;101
"3089";"360471156001";21;10;41;1;11;84
"3090";"360471156002";311;2;6;0;1;320
"3091";"360471156003";22;8;0;3;1;34
"3092";"360471156004";38;32;7;1;12;90
"3093";"360471158001";48;1;12;5;9;75
"3094";"360471158002";31;6;7;0;9;53
"3095";"360471158003";24;12;10;3;11;60
"3096";"360471160001";8;5;4;4;2;23
"3097";"360471160002";43;7;5;2;8;65
"3098";"360471160003";6;8;6;3;9;32
"3099";"360471162001";47;22;12;3;11;95
"3100";"360471162002";14;2;9;1;9;35
"3101";"360471162003";7;2;23;1;11;44
"3102";"360471164001";18;30;16;5;5;74
"3103";"360471164002";34;8;18;3;6;69
"3104";"360471164003";37;9;6;4;16;72
"3105";"360471166001";20;4;23;9;20;76
"3106";"360471166002";11;5;36;25;18;95
"3107";"360471166003";33;8;20;12;13;86
"3108";"360471168001";17;12;27;8;50;114
"3109";"360471168002";42;68;18;16;31;175
"3110";"360471170001";45;20;28;9;5;107
"3111";"360471170002";19;23;44;6;32;124
"3112";"360471172011";44;13;83;11;32;183
"3113";"360471172012";91;86;33;10;43;263
"3114";"360471172021";129;17;28;2;21;197
"3115";"360471172022";72;22;55;6;54;209
"3116";"360471174001";49;29;40;15;52;185
"3117";"360471174002";32;70;102;13;136;353
"3118";"360471176011";44;11;57;17;54;183
"3119";"360471176012";70;43;33;7;35;188
"3120";"360471176021";50;11;114;17;29;221
"3121";"360471176022";127;19;97;5;40;288
"3122";"360471178001";43;47;50;16;40;196
"3123";"360471180001";8;46;14;16;12;96
"3124";"360471182011";71;19;47;6;19;162
"3125";"360471182012";30;9;50;9;50;148
"3126";"360471182021";87;18;23;8;42;178
"3127";"360471182022";90;31;50;9;41;221
"3128";"360471184001";47;26;36;6;52;167
"3129";"360471184002";68;35;73;20;39;235
"3130";"360471184003";45;10;39;25;45;164
"3131";"360471186001";28;11;45;14;25;123
"3132";"360471186002";56;12;37;4;25;134
"3133";"360471188001";35;15;68;8;57;183
"3134";"360471188002";52;10;20;1;37;120
"3135";"360471188003";51;16;17;1;30;115
"3136";"360471190001";109;11;54;11;19;204
"3137";"360471190002";78;3;28;4;35;148
"3138";"360471192001";72;6;49;16;31;174
"3139";"360471192002";52;6;32;0;14;104
"3140";"360471192003";16;5;16;14;29;80
"3141";"360471194001";5;25;40;2;10;82
"3142";"360471194002";48;7;42;14;17;128
"3143";"360471194003";94;15;43;4;17;173
"3144";"360471196001";43;23;57;16;23;162
"3145";"360471196002";29;16;13;6;21;85
"3146";"360471196003";64;5;58;1;16;144
"3147";"360471196004";72;28;38;4;13;155
"3148";"360471198001";19;12;37;19;23;110
"3149";"360471198002";27;13;78;8;38;164
"3150";"360471198003";41;27;41;18;81;208
"3151";"360471200001";45;6;20;6;19;96
"3152";"360471200002";59;11;24;6;17;117
"3153";"360471202001";32;8;13;2;25;80
"3154";"360471202002";12;7;26;5;31;81
"3155";"360471208001";11;4;47;1;26;89
"3156";"360471208002";58;17;80;11;37;203
"3157";"360471208003";15;2;2;3;2;24
"3158";"360471208004";40;0;1;1;5;47
"3159";"360471208005";57;14;59;37;22;189
"3160";"360471210001";64;2;4;1;0;71
"3161";"360471210002";32;1;0;0;0;33
"3162";"360471214001";39;1;7;0;0;47
"3163";"360471214002";237;2;0;1;0;240
"3164";"360471220001";121;27;111;54;18;331
"3165";"360471220002";269;6;77;43;85;480
"3166";"360471237001";9;14;78;6;34;141
"3167";"360471237002";19;13;52;6;18;108
"3168";"360471237003";12;23;72;13;56;176
"3169";"360471502001";15;1;31;5;11;63
"3170";"360471502002";12;9;47;5;13;86
"3171";"360471502003";35;118;58;14;19;244
"3172";"360471522001";71;156;74;32;26;359
"3173";"360471522002";12;21;20;24;13;90
"3174";"360471522003";15;13;62;22;12;124
"3175";"360594043002";0;4;0;0;1;5
"3176";"360594043003";3;0;1;0;0;4
"3177";"360610001001";0;2;0;0;0;2
"3178";"360610002011";34;7;8;0;14;63
"3179";"360610002012";50;23;18;1;3;95
"3180";"360610002021";42;31;3;0;20;96
"3181";"360610002022";40;35;18;2;6;101
"3182";"360610002023";93;5;7;0;2;107
"3183";"360610002024";120;10;3;0;1;134
"3184";"360610002025";64;27;6;1;8;106
"3185";"360610005001";0;5;0;0;0;5
"3186";"360610006001";31;21;9;4;31;96
"3187";"360610006002";64;13;56;0;8;141
"3188";"360610006003";13;17;5;0;31;66
"3189";"360610006004";19;5;7;1;27;59
"3190";"360610006005";35;7;3;1;4;50
"3191";"360610006006";1;2;27;0;2;32
"3192";"360610007001";76;204;83;5;28;396
"3193";"360610008001";11;17;15;1;113;157
"3194";"360610008002";17;7;8;1;40;73
"3195";"360610008003";3;5;5;0;38;51
"3196";"360610008004";2;5;1;0;6;14
"3197";"360610008005";11;21;16;1;4;53
"3198";"360610008006";32;172;28;3;79;314
"3199";"360610009001";36;91;84;3;50;264
"3200";"360610010010";0;1;0;0;0;1
"3201";"360610010011";26;4;4;3;0;37
"3202";"360610010021";24;4;4;0;0;32
"3203";"360610010022";59;7;4;1;2;73
"3204";"360610010023";370;3;13;3;3;392
"3205";"360610012001";65;9;19;5;10;108
"3206";"360610012002";2;14;47;6;7;76
"3207";"360610012003";35;9;4;2;3;53
"3208";"360610013001";12;67;18;0;7;104
"3209";"360610013002";14;65;40;4;14;137
"3210";"360610014011";2;35;19;1;9;66
"3211";"360610014012";20;14;4;0;1;39
"3212";"360610014021";60;91;16;3;25;195
"3213";"360610014022";39;45;7;6;48;145
"3214";"360610015010";0;3;0;0;1;4
"3215";"360610015011";18;166;48;2;15;249
"3216";"360610015012";8;12;26;3;8;57
"3217";"360610015013";22;37;29;7;18;113
"3218";"360610015020";0;1;0;0;0;1
"3219";"360610015021";133;88;39;5;38;303
"3220";"360610015022";42;74;45;2;15;178
"3221";"360610016001";16;23;23;5;109;176
"3222";"360610016002";142;29;3;0;81;255
"3223";"360610016003";8;77;5;6;96;192
"3224";"360610016004";107;93;10;2;24;236
"3225";"360610016005";48;184;33;7;65;337
"3226";"360610018001";33;96;4;8;34;175
"3227";"360610018002";35;140;7;4;64;250
"3228";"360610018003";110;160;15;5;58;348
"3229";"360610018004";19;17;5;0;41;82
"3230";"360610018005";36;191;15;1;128;371
"3231";"360610018006";16;27;4;0;96;143
"3232";"360610018007";29;41;13;2;82;167
"3233";"360610020001";61;1;2;0;0;64
"3234";"360610020002";44;2;31;0;3;80
"3235";"360610020003";8;1;11;2;1;23
"3236";"360610021001";61;87;73;10;40;271
"3237";"360610021002";19;34;29;6;16;104
"3238";"360610022011";65;36;20;1;30;152
"3239";"360610022012";112;231;9;3;28;383
"3240";"360610022013";365;34;4;1;2;406
"3241";"360610022014";4;4;3;0;2;13
"3242";"360610022021";118;85;30;3;53;289
"3243";"360610024001";496;45;10;2;6;559
"3244";"360610024002";305;2;3;0;1;311
"3245";"360610025001";141;18;4;1;11;175
"3246";"360610025002";1;17;1;4;4;27
"3247";"360610025003";358;6;0;0;0;364
"3248";"360610026011";175;229;30;5;57;496
"3249";"360610026012";103;134;15;3;36;291
"3250";"360610026021";95;64;47;19;39;264
"3251";"360610026022";112;224;35;3;38;412
"3252";"360610027001";19;19;11;1;31;81
"3253";"360610028001";56;40;3;0;12;111
"3254";"360610028002";95;24;16;6;8;149
"3255";"360610028003";130;119;30;4;14;297
"3256";"360610028004";79;164;28;8;16;295
"3257";"360610029001";8;110;6;1;46;171
"3258";"360610029002";13;11;3;0;51;78
"3259";"360610029003";10;67;7;0;48;132
"3260";"360610029004";0;30;21;0;18;69
"3261";"360610030011";139;173;5;5;28;350
"3262";"360610030012";88;217;4;5;62;376
"3263";"360610030013";118;45;9;4;24;200
"3264";"360610030014";143;65;9;5;37;259
"3265";"360610030021";148;102;34;8;31;323
"3266";"360610030022";90;645;12;4;39;790
"3267";"360610031001";27;156;45;9;48;285
"3268";"360610032001";117;231;19;11;43;421
"3269";"360610032002";41;95;4;6;42;188
"3270";"360610032003";28;26;11;12;19;96
"3271";"360610032004";17;22;3;2;7;51
"3272";"360610032005";96;66;20;5;17;204
"3273";"360610032006";135;114;19;9;57;334
"3274";"360610032007";19;41;10;4;22;96
"3275";"360610033001";99;207;52;8;78;444
"3276";"360610033002";25;43;44;1;23;136
"3277";"360610033003";19;29;39;6;18;111
"3278";"360610034001";207;223;18;5;56;509
"3279";"360610034002";146;108;30;12;30;326
"3280";"360610034003";90;144;48;19;58;359
"3281";"360610034004";123;110;22;6;38;299
"3282";"360610036011";16;65;3;2;18;104
"3283";"360610036012";68;126;5;2;43;244
"3284";"360610036013";37;90;7;4;68;206
"3285";"360610036021";80;211;37;4;40;372
"3286";"360610036022";18;68;18;1;27;132
"3287";"360610037001";20;35;41;2;9;107
"3288";"360610037002";24;34;42;14;20;134
"3289";"360610037003";17;68;34;4;12;135
"3290";"360610038001";186;124;12;1;46;369
"3291";"360610038002";40;16;0;1;20;77
"3292";"360610038003";53;77;5;6;31;172
"3293";"360610038004";75;35;4;3;30;147
"3294";"360610038005";66;69;3;6;25;169
"3295";"360610038006";63;33;7;8;19;130
"3296";"360610038007";62;52;6;13;17;150
"3297";"360610039001";32;36;43;1;17;129
"3298";"360610039002";20;99;29;1;7;156
"3299";"360610039003";0;1;3;0;1;5
"3300";"360610039004";29;82;53;8;17;189
"3301";"360610040001";132;37;7;3;14;193
"3302";"360610040002";29;20;6;3;7;65
"3303";"360610040003";33;39;6;10;13;101
"3304";"360610040004";39;14;2;5;10;70
"3305";"360610040005";83;33;13;7;19;155
"3306";"360610040006";136;53;9;9;27;234
"3307";"360610041001";28;71;6;2;90;197
"3308";"360610041002";7;20;6;1;76;110
"3309";"360610041003";21;13;5;4;80;123
"3310";"360610041004";78;74;3;0;85;240
"3311";"360610041005";20;34;11;3;73;141
"3312";"360610041006";69;128;54;8;49;308
"3313";"360610042001";37;136;28;5;11;217
"3314";"360610042002";35;38;18;3;18;112
"3315";"360610043001";65;120;15;4;170;374
"3316";"360610043002";140;138;8;0;56;342
"3317";"360610043003";61;173;35;9;99;377
"3318";"360610044001";36;7;6;2;7;58
"3319";"360610044002";6;8;2;3;0;19
"3320";"360610044003";4;12;2;0;1;19
"3321";"360610044004";2;1;2;0;2;7
"3322";"360610044005";3;8;13;3;2;29
"3323";"360610044006";6;0;0;2;1;9
"3324";"360610044007";19;7;13;3;8;50
"3325";"360610044008";17;11;14;1;3;46
"3326";"360610045001";44;252;185;11;110;602
"3327";"360610047001";19;24;24;7;18;92
"3328";"360610047002";71;144;33;7;61;316
"3329";"360610048001";5;4;3;0;1;13
"3330";"360610048002";2;4;13;2;2;23
"3331";"360610048003";21;4;13;1;5;44
"3332";"360610048004";31;109;13;0;11;164
"3333";"360610048005";83;13;16;1;16;129
"3334";"360610048006";56;8;5;0;14;83
"3335";"360610048007";2;1;6;0;3;12
"3336";"360610049001";97;224;83;15;105;524
"3337";"360610049002";66;110;12;3;32;223
"3338";"360610049003";26;25;20;2;12;85
"3339";"360610050001";30;19;14;2;9;74
"3340";"360610050002";16;22;12;6;6;62
"3341";"360610050003";8;65;17;0;15;105
"3342";"360610050004";11;66;13;0;9;99
"3343";"360610050005";19;36;3;4;16;78
"3344";"360610052001";18;315;24;0;25;382
"3345";"360610052002";59;146;51;0;25;281
"3346";"360610054001";44;123;38;9;38;252
"3347";"360610054002";7;3;25;3;2;40
"3348";"360610054003";5;18;3;0;9;35
"3349";"360610055011";17;143;11;3;11;185
"3350";"360610055012";0;10;6;1;4;21
"3351";"360610055013";1;11;2;1;1;16
"3352";"360610055021";21;82;44;3;34;184
"3353";"360610055022";54;140;21;4;59;278
"3354";"360610056001";40;85;36;6;14;181
"3355";"360610056002";20;62;10;5;6;103
"3356";"360610056003";29;28;11;1;7;76
"3357";"360610057001";24;63;7;0;15;109
"3358";"360610057002";18;41;4;4;17;84
"3359";"360610058001";37;144;66;3;58;308
"3360";"360610059001";7;4;24;0;7;42
"3361";"360610059002";11;92;15;0;4;122
"3362";"360610059003";34;52;1;0;13;100
"3363";"360610059004";1;4;4;0;4;13
"3364";"360610059005";1;11;2;1;2;17
"3365";"360610060001";4;0;8;1;1;14
"3366";"360610060002";14;11;6;1;11;43
"3367";"360610060003";0;3;1;0;0;4
"3368";"360610061001";39;89;14;2;22;166
"3369";"360610061002";16;22;14;5;5;62
"3370";"360610061003";17;182;36;4;53;292
"3371";"360610062001";10;12;37;1;9;69
"3372";"360610062002";1;18;3;0;3;25
"3373";"360610063001";15;53;22;6;9;105
"3374";"360610063002";18;11;24;1;24;78
"3375";"360610063003";39;28;20;2;9;98
"3376";"360610063004";10;44;3;0;13;70
"3377";"360610063005";21;73;10;1;11;116
"3378";"360610064001";35;13;14;1;21;84
"3379";"360610064002";236;10;3;1;2;252
"3380";"360610064003";6;7;10;3;11;37
"3381";"360610064004";59;22;26;7;21;135
"3382";"360610064005";32;17;18;2;12;81
"3383";"360610064006";2;0;3;1;1;7
"3384";"360610065001";17;110;12;6;13;158
"3385";"360610065002";59;205;6;3;14;287
"3386";"360610065003";31;87;7;1;19;145
"3387";"360610065004";34;107;10;2;34;187
"3388";"360610065005";31;200;9;1;13;254
"3389";"360610066001";18;38;11;0;32;99
"3390";"360610066002";81;13;7;4;16;121
"3391";"360610066003";41;18;3;0;3;65
"3392";"360610066004";12;5;12;5;2;36
"3393";"360610066005";67;10;6;0;18;101
"3394";"360610066006";4;4;4;0;2;14
"3395";"360610066007";47;6;6;0;44;103
"3396";"360610066008";95;40;24;0;6;165
"3397";"360610066009";6;2;6;1;1;16
"3398";"360610067001";84;364;4;16;14;482
"3399";"360610067002";59;173;34;13;40;319
"3400";"360610067003";49;74;15;6;5;149
"3401";"360610067004";20;29;30;6;16;101
"3402";"360610068001";31;78;22;1;14;146
"3403";"360610068002";22;18;6;1;7;54
"3404";"360610068003";32;44;15;0;6;97
"3405";"360610068004";60;19;11;0;11;101
"3406";"360610068005";14;27;11;1;7;60
"3407";"360610068006";78;108;26;2;31;245
"3408";"360610069001";199;30;55;10;34;328
"3409";"360610070001";45;102;9;2;13;171
"3410";"360610070002";67;56;18;7;15;163
"3411";"360610070003";40;23;16;0;22;101
"3412";"360610070004";1;12;12;2;5;32
"3413";"360610070005";2;1;6;1;1;11
"3414";"360610070006";70;23;5;0;11;109
"3415";"360610071001";5;9;5;0;7;26
"3416";"360610071002";14;15;4;1;7;41
"3417";"360610071003";24;59;13;1;13;110
"3418";"360610071004";27;52;4;3;9;95
"3419";"360610071005";37;64;38;2;16;157
"3420";"360610072001";16;5;1;2;0;24
"3421";"360610072002";21;30;6;2;18;77
"3422";"360610072003";51;48;35;7;15;156
"3423";"360610072004";44;70;27;1;20;162
"3424";"360610072005";10;57;10;3;8;88
"3425";"360610072006";8;10;1;0;5;24
"3426";"360610072007";14;15;0;0;4;33
"3427";"360610073001";27;14;6;2;4;53
"3428";"360610073002";24;23;0;1;5;53
"3429";"360610073003";30;33;5;1;8;77
"3430";"360610073004";31;299;13;8;15;366
"3431";"360610073005";34;18;5;3;7;67
"3432";"360610073006";35;72;15;2;13;137
"3433";"360610074001";10;34;15;1;10;70
"3434";"360610074002";5;61;9;3;7;85
"3435";"360610074003";24;131;60;5;25;245
"3436";"360610075001";10;63;53;1;22;149
"3437";"360610075002";16;16;14;1;6;53
"3438";"360610075003";54;118;3;11;12;198
"3439";"360610076001";16;137;37;0;31;221
"3440";"360610076002";30;46;17;1;54;148
"3441";"360610077001";38;100;9;8;18;173
"3442";"360610077002";14;29;10;2;15;70
"3443";"360610077003";40;83;27;8;17;175
"3444";"360610077004";52;29;33;5;14;133
"3445";"360610077005";31;7;7;1;7;53
"3446";"360610078001";6;15;1;1;4;27
"3447";"360610078002";21;34;11;1;3;70
"3448";"360610078003";13;17;4;3;1;38
"3449";"360610078004";34;41;18;2;10;105
"3450";"360610078005";36;11;8;1;3;59
"3451";"360610078006";20;7;2;0;5;34
"3452";"360610078007";24;5;4;2;0;35
"3453";"360610079001";25;166;36;0;29;256
"3454";"360610079002";4;11;9;9;2;35
"3455";"360610079003";42;39;22;1;11;115
"3456";"360610079004";8;84;12;4;5;113
"3457";"360610080001";33;71;17;2;14;137
"3458";"360610080002";14;29;19;2;8;72
"3459";"360610080003";4;7;14;0;5;30
"3460";"360610080004";20;40;10;1;5;76
"3461";"360610080005";27;12;6;1;23;69
"3462";"360610081001";19;31;7;3;19;79
"3463";"360610081002";39;34;18;1;13;105
"3464";"360610081003";31;12;10;2;8;63
"3465";"360610081004";30;25;7;9;11;82
"3466";"360610081005";85;38;13;2;25;163
"3467";"360610081006";28;65;5;3;16;117
"3468";"360610082001";15;89;52;4;19;179
"3469";"360610082002";8;25;24;1;7;65
"3470";"360610082003";12;9;6;4;7;38
"3471";"360610083001";111;115;23;1;17;267
"3472";"360610083002";22;43;7;3;3;78
"3473";"360610083003";110;94;88;4;20;316
"3474";"360610084001";0;14;1;0;3;18
"3475";"360610084002";54;177;69;8;42;350
"3476";"360610086011";2;15;10;0;3;30
"3477";"360610086012";8;16;24;2;5;55
"3478";"360610086021";1;19;69;0;3;92
"3479";"360610086031";1;12;4;0;6;23
"3480";"360610086032";0;1;24;0;2;27
"3481";"360610086033";2;1;6;0;4;13
"3482";"360610086034";39;7;9;1;1;57
"3483";"360610087001";33;136;29;4;35;237
"3484";"360610087002";51;52;2;4;9;118
"3485";"360610087003";19;25;5;4;5;58
"3486";"360610087004";32;24;6;1;7;70
"3487";"360610087005";17;11;12;2;17;59
"3488";"360610088001";9;31;17;1;9;67
"3489";"360610088002";13;22;8;0;3;46
"3490";"360610088003";0;5;6;0;0;11
"3491";"360610088004";0;4;5;1;0;10
"3492";"360610088005";6;6;4;0;2;18
"3493";"360610088006";0;6;23;1;1;31
"3494";"360610088007";5;0;2;0;1;8
"3495";"360610089001";18;10;3;3;13;47
"3496";"360610089002";46;31;9;1;13;100
"3497";"360610089003";33;22;21;2;10;88
"3498";"360610089004";7;15;15;1;56;94
"3499";"360610089005";28;8;10;4;3;53
"3500";"360610090001";20;52;59;0;14;145
"3501";"360610090002";4;6;145;0;5;160
"3502";"360610090003";6;24;105;2;3;140
"3503";"360610090004";18;9;2;1;1;31
"3504";"360610090005";1;9;10;0;7;27
"3505";"360610090006";6;18;3;0;6;33
"3506";"360610091001";117;80;30;1;44;272
"3507";"360610091002";30;22;14;1;19;86
"3508";"360610091003";61;12;3;1;10;87
"3509";"360610091004";22;41;14;1;6;84
"3510";"360610092001";26;146;97;2;60;331
"3511";"360610093001";7;9;19;5;3;43
"3512";"360610093002";14;24;11;3;14;66
"3513";"360610093003";4;2;0;0;1;7
"3514";"360610093004";5;1;2;0;1;9
"3515";"360610093005";27;14;3;0;13;57
"3516";"360610093006";120;16;5;1;3;145
"3517";"360610093007";236;20;16;4;5;281
"3518";"360610094001";4;33;52;3;22;114
"3519";"360610095001";49;129;34;3;56;271
"3520";"360610095002";45;47;32;11;39;174
"3521";"360610096001";3;129;57;2;57;248
"3522";"360610097001";2;7;14;0;2;25
"3523";"360610097002";72;16;4;0;12;104
"3524";"360610097003";4;0;2;0;0;6
"3525";"360610097004";342;25;2;0;14;383
"3526";"360610098001";22;66;3;0;4;95
"3527";"360610098002";17;73;5;2;16;113
"3528";"360610098003";51;21;14;2;10;98
"3529";"360610098004";19;11;8;0;4;42
"3530";"360610098005";5;30;1;2;6;44
"3531";"360610098006";21;35;54;0;10;120
"3532";"360610098007";16;10;4;1;13;44
"3533";"360610099000";0;0;0;0;1;1
"3534";"360610099001";91;198;227;25;113;654
"3535";"360610100001";18;24;21;4;9;76
"3536";"360610100002";15;22;14;2;7;60
"3537";"360610101001";13;87;34;2;28;164
"3538";"360610102001";3;26;67;6;9;111
"3539";"360610103001";60;44;34;2;15;155
"3540";"360610104001";15;152;58;0;43;268
"3541";"360610106011";3;16;10;1;3;33
"3542";"360610106012";9;12;26;2;3;52
"3543";"360610106013";20;75;17;1;6;119
"3544";"360610106014";2;3;7;1;1;14
"3545";"360610106015";5;2;7;0;1;15
"3546";"360610106016";1;2;24;2;3;32
"3547";"360610106021";3;24;3;1;3;34
"3548";"360610106022";6;44;13;3;15;81
"3549";"360610106023";2;14;6;0;2;24
"3550";"360610108001";14;5;3;0;12;34
"3551";"360610108002";8;7;8;0;4;27
"3552";"360610108003";6;15;24;0;6;51
"3553";"360610108004";3;1;12;1;1;18
"3554";"360610108005";31;11;61;4;16;123
"3555";"360610108006";12;13;11;0;23;59
"3556";"360610108007";15;35;17;0;6;73
"3557";"360610109001";5;94;20;0;61;180
"3558";"360610110001";11;22;5;0;7;45
"3559";"360610110002";2;14;10;0;5;31
"3560";"360610110003";22;33;18;2;19;94
"3561";"360610110004";8;4;2;3;3;20
"3562";"360610110005";14;51;2;1;3;71
"3563";"360610110006";30;33;11;3;22;99
"3564";"360610111001";47;40;44;3;28;162
"3565";"360610111002";15;6;20;4;12;57
"3566";"360610111003";130;35;34;5;14;218
"3567";"360610112011";9;31;40;4;11;95
"3568";"360610112021";3;78;89;2;39;211
"3569";"360610112031";8;10;7;0;10;35
"3570";"360610112032";3;5;10;0;3;21
"3571";"360610113001";12;120;44;0;66;242
"3572";"360610114011";8;10;20;1;6;45
"3573";"360610114012";9;17;84;1;14;125
"3574";"360610114021";7;26;11;1;18;63
"3575";"360610114022";11;18;13;3;14;59
"3576";"360610115001";9;62;51;3;19;144
"3577";"360610115002";18;119;79;2;12;230
"3578";"360610116001";12;14;19;1;2;48
"3579";"360610116002";10;4;11;1;5;31
"3580";"360610116003";7;34;9;1;4;55
"3581";"360610117001";23;58;24;4;16;125
"3582";"360610118001";4;11;1;0;0;16
"3583";"360610118002";0;3;11;1;3;18
"3584";"360610118003";22;15;5;0;2;44
"3585";"360610118004";3;7;15;1;6;32
"3586";"360610118005";21;3;2;3;5;34
"3587";"360610118006";23;6;17;7;3;56
"3588";"360610118007";12;5;10;0;2;29
"3589";"360610118008";2;0;12;1;1;16
"3590";"360610119001";73;50;37;5;29;194
"3591";"360610119002";51;155;158;1;16;381
"3592";"360610120001";7;10;17;3;1;38
"3593";"360610120002";11;8;11;1;6;37
"3594";"360610120003";21;5;24;3;8;61
"3595";"360610120004";1;10;22;12;9;54
"3596";"360610121001";37;91;20;2;12;162
"3597";"360610121002";8;6;5;0;0;19
"3598";"360610121003";44;18;11;1;25;99
"3599";"360610121004";34;78;14;3;16;145
"3600";"360610121005";81;76;7;0;28;192
"3601";"360610121006";22;52;19;0;20;113
"3602";"360610122001";10;3;9;1;7;30
"3603";"360610122002";3;2;6;0;5;16
"3604";"360610122003";3;15;6;5;7;36
"3605";"360610122004";2;9;10;0;4;25
"3606";"360610124001";48;29;16;2;13;108
"3607";"360610124002";17;3;14;1;9;44
"3608";"360610124003";5;7;9;1;1;23
"3609";"360610124004";15;20;1;0;1;37
"3610";"360610124005";3;7;8;0;0;18
"3611";"360610124006";8;0;3;3;3;17
"3612";"360610124007";2;0;9;1;3;15
"3613";"360610124008";0;0;1;0;1;2
"3614";"360610125001";15;206;30;1;25;277
"3615";"360610125002";15;309;49;1;22;396
"3616";"360610126001";14;47;51;3;14;129
"3617";"360610126002";12;9;18;1;6;46
"3618";"360610126003";3;13;7;1;2;26
"3619";"360610126004";22;5;14;2;8;51
"3620";"360610126005";8;6;15;1;7;37
"3621";"360610126006";17;13;17;3;4;54
"3622";"360610126007";25;7;15;2;11;60
"3623";"360610126008";18;4;5;1;4;32
"3624";"360610127001";41;103;15;0;8;167
"3625";"360610127002";50;56;19;1;23;149
"3626";"360610127003";64;23;12;0;18;117
"3627";"360610127004";99;177;46;5;11;338
"3628";"360610127005";4;34;12;1;6;57
"3629";"360610128001";15;6;28;2;6;57
"3630";"360610128002";4;1;7;0;6;18
"3631";"360610128003";4;9;23;0;6;42
"3632";"360610128004";3;6;29;5;7;50
"3633";"360610128005";3;9;26;2;8;48
"3634";"360610129001";110;241;112;14;48;525
"3635";"360610129002";47;93;91;17;36;284
"3636";"360610130001";5;2;9;5;1;22
"3637";"360610130002";2;7;13;3;3;28
"3638";"360610130003";8;9;15;1;4;37
"3639";"360610130004";8;13;20;0;7;48
"3640";"360610131001";1;36;17;1;16;71
"3641";"360610131002";17;106;22;0;8;153
"3642";"360610132001";20;3;14;0;6;43
"3643";"360610132002";24;16;16;0;7;63
"3644";"360610132003";18;12;7;1;4;42
"3645";"360610132004";80;15;17;0;9;121
"3646";"360610132005";35;11;8;3;4;61
"3647";"360610132006";3;5;3;1;3;15
"3648";"360610132007";14;9;16;0;5;44
"3649";"360610133001";26;1;3;0;7;37
"3650";"360610133002";69;138;11;0;19;237
"3651";"360610133003";39;80;25;1;17;162
"3652";"360610133004";17;74;23;1;16;131
"3653";"360610133005";57;69;14;2;8;150
"3654";"360610134001";28;17;3;1;8;57
"3655";"360610134002";18;12;2;0;7;39
"3656";"360610134003";22;5;9;1;4;41
"3657";"360610134004";9;29;7;1;4;50
"3658";"360610134005";23;23;3;0;8;57
"3659";"360610134006";24;30;17;2;3;76
"3660";"360610134007";28;24;39;0;10;101
"3661";"360610134008";9;33;48;3;1;94
"3662";"360610134009";35;13;4;0;5;57
"3663";"360610135001";72;117;96;3;17;305
"3664";"360610135002";46;30;41;0;21;138
"3665";"360610136001";57;10;9;3;11;90
"3666";"360610136002";53;2;3;2;5;65
"3667";"360610136003";20;14;19;3;14;70
"3668";"360610136004";58;16;25;3;17;119
"3669";"360610136005";4;3;30;2;3;42
"3670";"360610136006";16;1;7;0;6;30
"3671";"360610136007";31;2;12;1;2;48
"3672";"360610136008";60;15;11;0;9;95
"3673";"360610137001";5;21;24;1;13;64
"3674";"360610137002";8;22;33;1;8;72
"3675";"360610137003";16;133;17;2;18;186
"3676";"360610137004";5;35;49;1;23;113
"3677";"360610137005";1;6;20;1;7;35
"3678";"360610137006";2;34;25;1;4;66
"3679";"360610138001";11;4;7;0;18;40
"3680";"360610138002";34;7;8;0;4;53
"3681";"360610138003";13;6;6;5;4;34
"3682";"360610138004";104;54;16;1;13;188
"3683";"360610138005";28;11;6;1;4;50
"3684";"360610138006";34;13;10;0;2;59
"3685";"360610138007";16;13;24;1;12;66
"3686";"360610138008";41;1;3;3;7;55
"3687";"360610138009";22;7;13;2;3;47
"3688";"360610139001";27;21;10;1;12;71
"3689";"360610139002";51;22;8;0;15;96
"3690";"360610139003";38;24;18;2;10;92
"3691";"360610139004";30;46;3;0;4;83
"3692";"360610139005";14;123;2;2;38;179
"3693";"360610139006";5;18;7;0;10;40
"3694";"360610139007";29;32;19;0;5;85
"3695";"360610140001";30;18;14;0;10;72
"3696";"360610140002";14;34;8;5;14;75
"3697";"360610140003";5;10;13;1;17;46
"3698";"360610140004";2;2;12;1;4;21
"3699";"360610140005";16;6;20;0;3;45
"3700";"360610140006";11;6;10;0;1;28
"3701";"360610142001";2;2;10;1;1;16
"3702";"360610142002";4;8;11;0;3;26
"3703";"360610142003";2;3;4;0;2;11
"3704";"360610142004";5;5;12;1;3;26
"3705";"360610142005";8;15;1;0;5;29
"3706";"360610142006";3;10;8;3;4;28
"3707";"360610143001";20;252;184;10;115;581
"3708";"360610144011";10;1;8;1;1;21
"3709";"360610144012";25;8;5;0;8;46
"3710";"360610144013";45;3;9;0;2;59
"3711";"360610144014";5;6;3;1;3;18
"3712";"360610144021";9;10;15;0;5;39
"3713";"360610144022";46;10;2;0;4;62
"3714";"360610144023";24;2;9;2;4;41
"3715";"360610144024";19;14;26;1;7;67
"3716";"360610144025";52;12;12;0;6;82
"3717";"360610145001";7;23;26;0;8;64
"3718";"360610145002";2;1;5;1;11;20
"3719";"360610145003";6;63;133;0;19;221
"3720";"360610145004";7;33;68;0;8;116
"3721";"360610146011";14;40;25;0;6;85
"3722";"360610146012";20;28;2;1;12;63
"3723";"360610146013";31;27;21;0;6;85
"3724";"360610146014";46;8;4;1;2;61
"3725";"360610146021";32;12;15;0;5;64
"3726";"360610146022";21;6;8;0;4;39
"3727";"360610146023";42;11;3;0;9;65
"3728";"360610146024";28;7;1;0;7;43
"3729";"360610146025";5;26;12;2;5;50
"3730";"360610146026";23;9;3;0;11;46
"3731";"360610147001";33;20;14;0;8;75
"3732";"360610148011";8;46;14;1;9;78
"3733";"360610148012";10;11;16;1;3;41
"3734";"360610148021";46;68;11;2;17;144
"3735";"360610148022";30;22;17;4;20;93
"3736";"360610148023";12;19;9;0;3;43
"3737";"360610148024";14;3;6;0;3;26
"3738";"360610148025";31;7;25;0;3;66
"3739";"360610149001";20;52;84;0;6;162
"3740";"360610149002";29;4;12;0;9;54
"3741";"360610149003";4;10;18;0;13;45
"3742";"360610149004";9;26;28;1;3;67
"3743";"360610149005";15;7;23;3;5;53
"3744";"360610150011";1;2;5;2;3;13
"3745";"360610150012";4;7;11;0;4;26
"3746";"360610150021";1;4;13;0;2;20
"3747";"360610150022";2;2;12;2;3;21
"3748";"360610150023";3;3;7;0;5;18
"3749";"360610150024";8;4;8;0;2;22
"3750";"360610151001";52;15;7;2;2;78
"3751";"360610151002";344;9;12;0;1;366
"3752";"360610151003";45;13;4;2;2;66
"3753";"360610151004";38;30;30;0;6;104
"3754";"360610152001";212;5;5;1;2;225
"3755";"360610152002";194;8;2;0;8;212
"3756";"360610152003";18;2;10;1;6;37
"3757";"360610152004";5;1;12;3;4;25
"3758";"360610152005";3;3;10;1;1;18
"3759";"360610152006";13;17;13;0;6;49
"3760";"360610153001";22;23;8;2;14;69
"3761";"360610153002";7;17;41;3;9;77
"3762";"360610153003";1;24;73;0;3;101
"3763";"360610153004";6;32;91;2;6;137
"3764";"360610153005";20;6;7;3;4;40
"3765";"360610153006";12;18;26;0;6;62
"3766";"360610153007";9;12;13;1;6;41
"3767";"360610154001";65;72;5;1;22;165
"3768";"360610154002";16;1;2;0;9;28
"3769";"360610154003";56;11;12;0;13;92
"3770";"360610154004";6;9;2;0;1;18
"3771";"360610154005";40;37;3;2;4;86
"3772";"360610154006";45;48;8;0;10;111
"3773";"360610154007";6;11;4;0;5;26
"3774";"360610154008";45;17;9;0;8;79
"3775";"360610154009";34;3;8;3;3;51
"3776";"360610155001";2;4;17;0;1;24
"3777";"360610155002";6;8;33;0;2;49
"3778";"360610155003";0;3;5;0;1;9
"3779";"360610155004";1;2;9;0;1;13
"3780";"360610155005";1;2;7;0;0;10
"3781";"360610155006";5;16;29;3;7;60
"3782";"360610156011";8;8;2;0;2;20
"3783";"360610156012";42;5;13;0;8;68
"3784";"360610156013";27;7;22;1;5;62
"3785";"360610156014";3;10;4;0;0;17
"3786";"360610156021";60;30;21;0;9;120
"3787";"360610157001";20;8;5;3;8;44
"3788";"360610157002";15;11;2;2;10;40
"3789";"360610157003";10;46;11;1;9;77
"3790";"360610157004";38;13;12;2;4;69
"3791";"360610157005";14;16;7;2;3;42
"3792";"360610157006";62;44;12;7;9;134
"3793";"360610157007";30;80;10;2;20;142
"3794";"360610157008";8;2;4;1;6;21
"3795";"360610158011";14;62;8;1;7;92
"3796";"360610158012";29;105;12;0;18;164
"3797";"360610158013";18;12;14;7;3;54
"3798";"360610158014";4;10;11;1;9;35
"3799";"360610158021";30;10;16;0;4;60
"3800";"360610158022";76;23;24;0;2;125
"3801";"360610159001";15;3;14;0;0;32
"3802";"360610159002";17;3;11;0;5;36
"3803";"360610159003";12;1;6;0;16;35
"3804";"360610159004";13;12;8;0;9;42
"3805";"360610159005";34;46;14;1;7;102
"3806";"360610159006";31;22;15;7;14;89
"3807";"360610159007";48;10;6;0;10;74
"3808";"360610160011";10;2;9;0;3;24
"3809";"360610160012";3;4;13;1;4;25
"3810";"360610160013";14;2;9;3;5;33
"3811";"360610160014";12;1;6;7;2;28
"3812";"360610160021";8;19;9;1;6;43
"3813";"360610160022";17;13;3;2;2;37
"3814";"360610161001";40;12;13;2;5;72
"3815";"360610161002";15;7;9;0;2;33
"3816";"360610161003";54;2;11;6;13;86
"3817";"360610161004";15;9;11;2;5;42
"3818";"360610161005";22;9;8;1;4;44
"3819";"360610161006";33;13;19;0;3;68
"3820";"360610162001";16;10;4;0;1;31
"3821";"360610162002";19;7;2;1;3;32
"3822";"360610162003";139;17;6;1;4;167
"3823";"360610162004";140;39;14;3;4;200
"3824";"360610162005";69;11;14;0;15;109
"3825";"360610163001";14;7;21;0;5;47
"3826";"360610163002";25;5;16;0;6;52
"3827";"360610163003";79;11;12;0;15;117
"3828";"360610163004";14;17;19;1;4;55
"3829";"360610163005";11;41;42;2;9;105
"3830";"360610164001";77;21;23;1;8;130
"3831";"360610164002";100;29;7;3;10;149
"3832";"360610164003";115;29;10;1;1;156
"3833";"360610164004";38;5;1;0;2;46
"3834";"360610165001";17;23;31;9;8;88
"3835";"360610165002";10;7;4;1;5;27
"3836";"360610165003";18;14;8;0;5;45
"3837";"360610165004";13;7;4;0;8;32
"3838";"360610165005";28;11;12;0;10;61
"3839";"360610166001";42;31;1;0;24;98
"3840";"360610166002";69;43;2;1;7;122
"3841";"360610166003";47;128;13;0;17;205
"3842";"360610166004";127;14;7;1;13;162
"3843";"360610166005";62;7;7;0;4;80
"3844";"360610166006";126;31;18;1;7;183
"3845";"360610167001";6;2;14;0;13;35
"3846";"360610167002";4;8;9;0;2;23
"3847";"360610167003";3;14;11;1;8;37
"3848";"360610167004";16;44;15;2;7;84
"3849";"360610167005";12;19;10;3;11;55
"3850";"360610168001";161;6;9;1;3;180
"3851";"360610168002";83;9;32;1;1;126
"3852";"360610168003";10;11;11;1;10;43
"3853";"360610169001";16;14;14;0;7;51
"3854";"360610169002";23;96;11;1;8;139
"3855";"360610169003";7;49;8;3;11;78
"3856";"360610169004";46;42;16;2;23;129
"3857";"360610169005";5;8;14;6;2;35
"3858";"360610169006";9;4;3;0;3;19
"3859";"360610170001";9;3;1;1;1;15
"3860";"360610170002";32;13;23;0;12;80
"3861";"360610170003";44;10;20;3;14;91
"3862";"360610170004";6;12;3;2;2;25
"3863";"360610170005";44;35;9;3;8;99
"3864";"360610171001";14;27;16;0;14;71
"3865";"360610171002";11;20;6;0;10;47
"3866";"360610171003";3;11;15;5;9;43
"3867";"360610171004";103;8;6;0;2;119
"3868";"360610171005";20;3;23;0;4;50
"3869";"360610171006";10;7;17;0;1;35
"3870";"360610172001";112;302;30;4;23;471
"3871";"360610172002";47;0;1;1;3;52
"3872";"360610172003";37;19;9;5;4;74
"3873";"360610172004";36;126;11;3;25;201
"3874";"360610172005";6;14;3;0;23;46
"3875";"360610173001";15;12;14;2;8;51
"3876";"360610173002";20;4;4;0;3;31
"3877";"360610173003";91;27;25;0;8;151
"3878";"360610173004";32;28;9;2;7;78
"3879";"360610173005";8;5;8;2;5;28
"3880";"360610173006";73;11;13;1;7;105
"3881";"360610173007";6;5;8;1;11;31
"3882";"360610174011";34;11;5;0;1;51
"3883";"360610174012";69;25;5;1;3;103
"3884";"360610174013";55;50;15;1;8;129
"3885";"360610174021";165;28;9;0;128;330
"3886";"360610175001";12;6;23;6;11;58
"3887";"360610175002";3;7;8;1;1;20
"3888";"360610175003";101;6;6;0;18;131
"3889";"360610175004";3;2;4;2;11;22
"3890";"360610175005";6;0;4;1;1;12
"3891";"360610175006";15;17;8;0;20;60
"3892";"360610175007";28;33;12;3;13;89
"3893";"360610177001";44;15;13;0;6;78
"3894";"360610177002";46;13;6;1;0;66
"3895";"360610177003";11;13;8;0;10;42
"3896";"360610177004";402;10;5;1;7;425
"3897";"360610177005";39;20;20;0;3;82
"3898";"360610177006";108;7;6;0;2;123
"3899";"360610177007";15;16;15;0;2;48
"3900";"360610177008";31;15;10;3;5;64
"3901";"360610178001";66;36;25;7;7;141
"3902";"360610178002";53;50;26;10;35;174
"3903";"360610178003";138;139;12;3;19;311
"3904";"360610179001";50;6;9;3;21;89
"3905";"360610179002";5;6;2;0;1;14
"3906";"360610179003";19;15;12;1;1;48
"3907";"360610179004";16;22;10;0;25;73
"3908";"360610179005";28;5;6;0;3;42
"3909";"360610179006";66;37;20;1;10;134
"3910";"360610179007";10;11;4;0;14;39
"3911";"360610180001";172;30;15;4;4;225
"3912";"360610180002";148;53;58;7;18;284
"3913";"360610180003";99;89;27;3;16;234
"3914";"360610180004";49;2;5;1;1;58
"3915";"360610181001";18;5;9;0;7;39
"3916";"360610181002";10;1;9;0;6;26
"3917";"360610181003";35;20;7;1;4;67
"3918";"360610181004";72;4;10;0;2;88
"3919";"360610181005";27;3;9;1;2;42
"3920";"360610181006";9;7;2;1;10;29
"3921";"360610182001";26;105;2;0;10;143
"3922";"360610182002";150;20;9;1;10;190
"3923";"360610182003";53;84;9;1;32;179
"3924";"360610182004";57;14;11;2;2;86
"3925";"360610182005";112;8;4;2;3;129
"3926";"360610183001";36;14;6;6;11;73
"3927";"360610183002";24;10;5;0;3;42
"3928";"360610183003";30;4;8;1;11;54
"3929";"360610183004";46;6;9;1;25;87
"3930";"360610183005";3;23;17;0;8;51
"3931";"360610183006";37;99;9;3;13;161
"3932";"360610183007";44;55;11;0;28;138
"3933";"360610184001";46;40;87;2;16;191
"3934";"360610184002";15;16;5;0;12;48
"3935";"360610184003";42;8;3;1;0;54
"3936";"360610184004";97;6;2;0;3;108
"3937";"360610185001";24;5;9;0;2;40
"3938";"360610185002";39;18;23;4;4;88
"3939";"360610185003";2;4;4;0;1;11
"3940";"360610186001";103;13;7;1;0;124
"3941";"360610186002";68;31;20;2;5;126
"3942";"360610186003";67;1;1;1;2;72
"3943";"360610187001";29;10;12;0;5;56
"3944";"360610187002";17;10;5;3;4;39
"3945";"360610187003";22;11;7;1;8;49
"3946";"360610187004";33;5;5;4;7;54
"3947";"360610187005";85;34;17;1;4;141
"3948";"360610187006";53;23;9;0;6;91
"3949";"360610188001";53;38;17;0;7;115
"3950";"360610188002";71;137;41;4;40;293
"3951";"360610188003";84;51;29;1;16;181
"3952";"360610188004";105;53;7;7;13;185
"3953";"360610189001";35;22;13;0;10;80
"3954";"360610189002";72;39;12;0;9;132
"3955";"360610189003";439;20;5;0;6;470
"3956";"360610189004";66;123;12;0;14;215
"3957";"360610189005";85;55;16;1;11;168
"3958";"360610189006";154;13;8;0;3;178
"3959";"360610190001";130;104;43;4;16;297
"3960";"360610191001";18;13;3;1;5;40
"3961";"360610191002";13;18;11;3;6;51
"3962";"360610191003";8;4;1;1;2;16
"3963";"360610191004";31;15;6;0;6;58
"3964";"360610191005";38;67;9;1;16;131
"3965";"360610191006";67;56;8;5;11;147
"3966";"360610192001";157;55;12;1;5;230
"3967";"360610192002";71;9;2;0;2;84
"3968";"360610192003";3;0;0;0;0;3
"3969";"360610193001";35;39;12;0;12;98
"3970";"360610193002";130;65;7;1;17;220
"3971";"360610193003";106;49;7;0;9;171
"3972";"360610193004";56;53;7;2;19;137
"3973";"360610193005";77;72;9;3;12;173
"3974";"360610193006";51;25;9;2;12;99
"3975";"360610194001";201;25;6;4;5;241
"3976";"360610194002";71;55;14;1;11;152
"3977";"360610194003";53;17;7;0;7;84
"3978";"360610194004";97;30;7;5;6;145
"3979";"360610195001";5;17;6;3;3;34
"3980";"360610195002";25;48;10;0;7;90
"3981";"360610195003";117;188;2;3;13;323
"3982";"360610195004";76;85;6;0;12;179
"3983";"360610195005";85;43;5;0;7;140
"3984";"360610196001";82;6;3;0;5;96
"3985";"360610196002";61;24;14;2;6;107
"3986";"360610196003";50;29;25;0;30;134
"3987";"360610197011";58;70;19;3;7;157
"3988";"360610197021";106;60;21;2;22;211
"3989";"360610198001";79;96;38;6;27;246
"3990";"360610198002";6;39;11;2;12;70
"3991";"360610199001";27;62;21;6;5;121
"3992";"360610199002";59;28;4;4;2;97
"3993";"360610199003";30;2;3;2;0;37
"3994";"360610199004";10;12;4;1;1;28
"3995";"360610199005";17;9;8;2;6;42
"3996";"360610199006";20;42;12;1;9;84
"3997";"360610200001";99;48;12;0;10;169
"3998";"360610200002";134;216;66;0;69;485
"3999";"360610201011";2;5;5;0;2;14
"4000";"360610201021";17;111;12;1;15;156
"4001";"360610201022";222;165;10;0;10;407
"4002";"360610201023";22;60;3;0;7;92
"4003";"360610201024";88;40;4;0;7;139
"4004";"360610203001";20;13;3;4;4;44
"4005";"360610203002";2;13;13;2;5;35
"4006";"360610205001";9;13;14;2;5;43
"4007";"360610205002";15;0;11;1;0;27
"4008";"360610205003";4;2;13;1;1;21
"4009";"360610206001";199;88;25;1;23;336
"4010";"360610206002";149;30;25;16;21;241
"4011";"360610207011";10;3;6;2;0;21
"4012";"360610207012";4;8;8;0;0;20
"4013";"360610208001";93;26;7;0;4;130
"4014";"360610208002";198;100;27;1;16;342
"4015";"360610208003";54;29;25;4;12;124
"4016";"360610209011";48;83;42;1;8;182
"4017";"360610209012";112;22;6;1;7;148
"4018";"360610210001";128;11;18;8;5;170
"4019";"360610210002";90;12;12;0;1;115
"4020";"360610210003";90;15;14;1;14;134
"4021";"360610210004";196;11;3;0;2;212
"4022";"360610211001";17;22;12;0;4;55
"4023";"360610211002";51;29;5;1;3;89
"4024";"360610211003";82;157;8;1;18;266
"4025";"360610211004";76;12;3;1;2;94
"4026";"360610211005";47;9;5;0;0;61
"4027";"360610211006";8;22;13;3;1;47
"4028";"360610211007";35;10;8;1;9;63
"4029";"360610212001";73;38;17;0;6;134
"4030";"360610212002";4;7;5;0;0;16
"4031";"360610212003";28;2;1;0;1;32
"4032";"360610212004";82;37;14;1;3;137
"4033";"360610213031";106;19;7;1;10;143
"4034";"360610213032";12;9;41;8;5;75
"4035";"360610213033";297;68;4;0;13;382
"4036";"360610213034";110;45;9;0;11;175
"4037";"360610214001";103;11;15;0;1;130
"4038";"360610214002";110;21;7;3;4;145
"4039";"360610215001";34;65;17;0;11;127
"4040";"360610215002";107;48;25;3;18;201
"4041";"360610216001";192;89;6;2;32;321
"4042";"360610216002";72;32;3;0;6;113
"4043";"360610216003";226;149;14;0;12;401
"4044";"360610216004";133;146;4;1;14;298
"4045";"360610216005";232;89;9;1;15;346
"4046";"360610217031";23;54;18;6;6;107
"4047";"360610218001";64;79;22;1;7;173
"4048";"360610218002";304;128;21;2;29;484
"4049";"360610218003";152;101;22;4;29;308
"4050";"360610218004";97;98;27;4;16;242
"4051";"360610219001";65;32;22;3;24;146
"4052";"360610219002";47;33;1;9;10;100
"4053";"360610219003";186;3;13;1;4;207
"4054";"360610219004";78;4;5;0;0;87
"4055";"360610220001";44;70;20;5;18;157
"4056";"360610220002";38;40;9;4;43;134
"4057";"360610220003";39;47;1;0;0;87
"4058";"360610220004";204;87;10;1;8;310
"4059";"360610220005";139;60;4;4;15;222
"4060";"360610221021";150;23;15;5;13;206
"4061";"360610221022";52;36;22;6;3;119
"4062";"360610222001";43;74;43;1;29;190
"4063";"360610222002";49;177;29;0;41;296
"4064";"360610223011";84;64;9;2;11;170
"4065";"360610223012";209;90;1;0;15;315
"4066";"360610223013";186;125;7;1;20;339
"4067";"360610223014";126;68;4;0;6;204
"4068";"360610223021";128;121;18;1;11;279
"4069";"360610224001";135;28;5;2;17;187
"4070";"360610224002";86;69;29;6;22;212
"4071";"360610224003";156;13;6;2;2;179
"4072";"360610224004";229;17;14;3;2;265
"4073";"360610225001";338;139;20;0;36;533
"4074";"360610225002";106;15;25;0;11;157
"4075";"360610225003";129;99;10;4;31;273
"4076";"360610225004";181;19;3;0;7;210
"4077";"360610225005";226;28;11;0;23;288
"4078";"360610226001";113;83;24;0;12;232
"4079";"360610226002";88;21;8;1;20;138
"4080";"360610226003";97;154;43;1;20;315
"4081";"360610227001";254;70;27;1;27;379
"4082";"360610227002";174;11;17;2;7;211
"4083";"360610227003";224;90;10;15;17;356
"4084";"360610228001";149;72;21;0;13;255
"4085";"360610228002";20;13;16;0;11;60
"4086";"360610228003";108;58;6;0;8;180
"4087";"360610228004";36;25;7;0;11;79
"4088";"360610229001";28;9;2;2;4;45
"4089";"360610229002";67;77;6;0;18;168
"4090";"360610229003";197;74;7;1;32;311
"4091";"360610229004";92;44;3;1;8;148
"4092";"360610229005";122;64;6;1;19;212
"4093";"360610230001";65;15;8;2;5;95
"4094";"360610230002";76;105;16;1;6;204
"4095";"360610230003";145;34;33;1;16;229
"4096";"360610230004";338;33;13;1;9;394
"4097";"360610230005";159;20;5;1;1;186
"4098";"360610231001";169;45;11;1;14;240
"4099";"360610231002";243;156;19;4;120;542
"4100";"360610231003";290;56;31;1;50;428
"4101";"360610232001";79;18;6;0;13;116
"4102";"360610232002";364;30;2;2;7;405
"4103";"360610232003";301;13;2;0;4;320
"4104";"360610232004";380;56;8;1;11;456
"4105";"360610233001";334;313;20;0;28;695
"4106";"360610233002";174;47;11;1;13;246
"4107";"360610233003";265;163;20;0;22;470
"4108";"360610234001";314;233;12;9;26;594
"4109";"360610234002";233;76;39;5;7;360
"4110";"360610235011";37;29;16;1;3;86
"4111";"360610235012";343;137;9;3;30;522
"4112";"360610235013";36;7;3;10;4;60
"4113";"360610235014";178;42;6;5;11;242
"4114";"360610235021";142;77;8;5;14;246
"4115";"360610236001";86;8;27;2;9;132
"4116";"360610236002";111;8;5;1;5;130
"4117";"360610236003";16;4;1;0;4;25
"4118";"360610236004";214;37;11;3;4;269
"4119";"360610237001";275;246;24;4;20;569
"4120";"360610237002";254;140;9;1;34;438
"4121";"360610237003";178;55;26;1;33;293
"4122";"360610238011";5;4;5;1;0;15
"4123";"360610238021";0;2;0;0;2;4
"4124";"360610239001";48;18;4;0;4;74
"4125";"360610239002";77;91;7;1;17;193
"4126";"360610240001";2;42;0;0;0;44
"4127";"360610241001";185;44;12;7;8;256
"4128";"360610241002";85;51;19;3;8;166
"4129";"360610241003";106;157;1;0;7;271
"4130";"360610241004";163;102;2;0;6;273
"4131";"360610241005";125;36;4;0;8;173
"4132";"360610242001";39;8;11;2;14;74
"4133";"360610242002";14;5;11;0;52;82
"4134";"360610242003";61;14;23;3;7;108
"4135";"360610243011";169;43;3;1;6;222
"4136";"360610243012";182;27;15;2;28;254
"4137";"360610243013";10;34;3;0;5;52
"4138";"360610243021";627;52;17;3;4;703
"4139";"360610243023";106;1;0;0;5;112
"4140";"360610245001";131;113;3;2;6;255
"4141";"360610245002";124;121;7;0;7;259
"4142";"360610245003";171;75;6;0;15;267
"4143";"360610245004";117;77;10;0;18;222
"4144";"360610245005";81;42;8;1;16;148
"4145";"360610245006";116;74;13;1;12;216
"4146";"360610245007";156;107;10;2;10;285
"4147";"360610247001";114;48;19;0;15;196
"4148";"360610247002";94;150;8;0;16;268
"4149";"360610247003";96;93;4;2;10;205
"4150";"360610247004";140;230;2;1;19;392
"4151";"360610247005";280;82;11;4;1;378
"4152";"360610249001";116;34;26;1;5;182
"4153";"360610251001";63;69;28;1;11;172
"4154";"360610251002";156;58;12;1;6;233
"4155";"360610253001";81;29;5;1;4;120
"4156";"360610253002";140;323;5;1;21;490
"4157";"360610253003";94;128;13;1;10;246
"4158";"360610253004";29;21;39;0;16;105
"4159";"360610253005";319;97;4;0;21;441
"4160";"360610253006";127;75;13;0;4;219
"4161";"360610255001";69;13;22;1;3;108
"4162";"360610255002";141;50;10;0;38;239
"4163";"360610255003";160;15;3;0;12;190
"4164";"360610255004";27;9;7;0;4;47
"4165";"360610257001";153;105;18;1;35;312
"4166";"360610257002";42;94;18;2;10;166
"4167";"360610257003";45;37;29;0;6;117
"4168";"360610259001";238;89;31;8;10;376
"4169";"360610259002";113;41;17;4;8;183
"4170";"360610261001";105;98;7;1;16;227
"4171";"360610261002";78;46;2;0;5;131
"4172";"360610261003";71;5;4;1;10;91
"4173";"360610261004";55;27;9;0;12;103
"4174";"360610261005";87;32;154;0;34;307
"4175";"360610261006";111;26;10;0;0;147
"4176";"360610261007";86;105;2;0;12;205
"4177";"360610263001";125;38;5;3;16;187
"4178";"360610263002";89;74;4;0;7;174
"4179";"360610263003";124;96;11;3;13;247
"4180";"360610263004";110;89;17;0;11;227
"4181";"360610263005";81;113;13;0;18;225
"4182";"360610265001";90;15;1;0;4;110
"4183";"360610265002";80;41;18;10;31;180
"4184";"360610265003";156;113;19;1;5;294
"4185";"360610265004";137;49;2;1;24;213
"4186";"360610265005";31;18;7;0;10;66
"4187";"360610267001";72;18;14;0;4;108
"4188";"360610269001";104;20;9;0;5;138
"4189";"360610269002";68;23;7;0;9;107
"4190";"360610269003";27;4;11;2;11;55
"4191";"360610269004";26;33;4;1;21;85
"4192";"360610269005";67;66;7;2;22;164
"4193";"360610269006";375;47;7;3;14;446
"4194";"360610271001";161;187;9;0;14;371
"4195";"360610271002";49;136;13;3;25;226
"4196";"360610271003";227;52;35;7;11;332
"4197";"360610271004";97;92;15;0;11;215
"4198";"360610271005";98;7;6;1;5;117
"4199";"360610273001";162;38;31;3;18;252
"4200";"360610273002";57;0;1;0;8;66
"4201";"360610273003";81;44;22;4;11;162
"4202";"360610273004";56;29;4;0;7;96
"4203";"360610275001";20;10;6;0;4;40
"4204";"360610275002";2;1;6;3;1;13
"4205";"360610277001";146;98;11;1;13;269
"4206";"360610277002";86;44;3;0;5;138
"4207";"360610277003";103;82;6;0;8;199
"4208";"360610277004";22;26;2;1;2;53
"4209";"360610279001";31;30;12;0;15;88
"4210";"360610279002";185;170;12;0;13;380
"4211";"360610279003";99;104;12;1;15;231
"4212";"360610279004";186;91;8;0;18;303
"4213";"360610279005";46;73;13;3;13;148
"4214";"360610279006";40;36;2;1;6;85
"4215";"360610279007";30;28;0;0;4;62
"4216";"360610281001";18;14;7;0;5;44
"4217";"360610281002";68;46;28;4;11;157
"4218";"360610283001";1;23;0;0;14;38
"4219";"360610283002";684;190;28;2;36;940
"4220";"360610283003";176;27;11;0;4;218
"4221";"360610283004";239;131;11;0;14;395
"4222";"360610285001";166;91;8;0;54;319
"4223";"360610285002";153;106;16;1;9;285
"4224";"360610285003";119;54;1;0;7;181
"4225";"360610285004";205;158;9;0;18;390
"4226";"360610287001";113;221;44;0;31;409
"4227";"360610287002";105;90;8;3;11;217
"4228";"360610287003";155;392;13;4;33;597
"4229";"360610291001";148;52;4;1;7;212
"4230";"360610291002";52;35;5;0;14;106
"4231";"360610291003";123;17;6;1;5;152
"4232";"360610291004";122;67;8;0;17;214
"4233";"360610291005";532;97;4;0;290;923
"4234";"360610291006";96;38;19;1;9;163
"4235";"360610291007";113;41;4;1;17;176
"4236";"360610293001";145;125;17;0;27;314
"4237";"360610293002";37;54;6;0;20;117
"4238";"360610293003";77;88;12;1;23;201
"4239";"360610293004";129;63;14;0;29;235
"4240";"360610293005";137;14;11;1;15;178
"4241";"360610295001";142;221;56;0;13;432
"4242";"360610295002";79;271;59;0;21;430
"4243";"360610295003";151;79;20;0;11;261
"4244";"360610295004";92;29;18;0;18;157
"4245";"360610297001";26;84;25;3;5;143
"4246";"360610299001";169;51;9;0;2;231
"4247";"360610299002";80;238;71;20;30;439
"4248";"360610303001";114;145;19;2;11;291
"4249";"360610303002";78;72;21;1;18;190
"4250";"360610303003";83;113;15;0;13;224
"4251";"360610307001";73;84;44;1;21;223
"4252";"360610307002";6;10;10;1;1;28
"4253";"360610307003";74;32;12;1;7;126
"4254";"360610309001";118;19;21;2;15;175
"4255";"360610309002";68;28;15;1;17;129
"4256";"360610309003";125;8;16;0;22;171
"4257";"360610309004";219;83;66;3;32;403
"4258";"360610311001";45;70;31;3;10;159
"4259";"360610317031";5;27;19;2;2;55
"4260";"360610317032";0;33;21;1;5;60
"4261";"360610317041";26;35;26;0;13;100
"4262";"360610317042";0;4;4;1;3;12
"4263";"360610317043";10;10;19;1;4;44
"4264";"360610317044";13;24;24;5;8;74
"4265";"360610319001";0;16;7;1;1;25
"4266";"360810001001";19;44;174;36;26;299
"4267";"360810002001";40;6;47;22;29;144
"4268";"360810002002";56;18;48;8;22;152
"4269";"360810004001";62;23;60;19;36;200
"4270";"360810004002";69;17;54;19;52;211
"4271";"360810004003";93;29;115;21;33;291
"4272";"360810006001";26;3;44;9;10;92
"4273";"360810006002";23;16;53;25;34;151
"4274";"360810006003";54;39;63;36;35;227
"4275";"360810007001";51;23;48;8;27;157
"4276";"360810007002";38;48;59;14;30;189
"4277";"360810007003";69;31;115;31;14;260
"4278";"360810007004";53;64;111;39;28;295
"4279";"360810008001";45;10;69;30;42;196
"4280";"360810008002";48;11;96;30;27;212
"4281";"360810010001";44;10;32;6;30;122
"4282";"360810010002";102;5;94;48;62;311
"4283";"360810012001";54;4;35;16;11;120
"4284";"360810012002";21;6;87;28;10;152
"4285";"360810012003";81;6;80;18;20;205
"4286";"360810014001";69;5;70;36;31;211
"4287";"360810014002";41;6;42;19;25;133
"4288";"360810014003";54;3;43;28;58;186
"4289";"360810016001";84;7;54;15;31;191
"4290";"360810016002";81;15;78;29;31;234
"4291";"360810018001";115;22;41;10;37;225
"4292";"360810018002";47;8;109;21;35;220
"4293";"360810019001";18;48;361;81;100;608
"4294";"360810020001";83;6;47;26;32;194
"4295";"360810022001";52;73;56;15;30;226
"4296";"360810022002";53;15;29;14;27;138
"4297";"360810024001";48;3;36;15;12;114
"4298";"360810024002";18;14;70;16;28;146
"4299";"360810025001";28;39;3;4;4;78
"4300";"360810025002";63;5;0;0;1;69
"4301";"360810025003";194;5;0;2;2;203
"4302";"360810025004";121;4;2;0;2;129
"4303";"360810025005";129;5;7;0;1;142
"4304";"360810025006";43;5;6;1;1;56
"4305";"360810026001";10;1;32;18;13;74
"4306";"360810026002";62;39;106;10;32;249
"4307";"360810028001";108;41;137;44;54;384
"4308";"360810028002";47;4;61;26;23;161
"4309";"360810030001";34;7;59;18;24;142
"4310";"360810031001";9;11;37;8;19;84
"4311";"360810031002";11;16;100;11;41;179
"4312";"360810032001";70;6;80;34;38;228
"4313";"360810033001";28;41;63;1;25;158
"4314";"360810033002";12;22;59;30;17;140
"4315";"360810033003";11;9;114;24;19;177
"4316";"360810033004";2;3;50;22;14;91
"4317";"360810034001";46;22;45;36;42;191
"4318";"360810034002";31;35;51;36;28;181
"4319";"360810036001";46;7;102;64;41;260
"4320";"360810036002";56;10;50;18;35;169
"4321";"360810037001";49;27;6;1;10;93
"4322";"360810038001";44;11;48;13;35;151
"4323";"360810038002";58;4;51;18;20;151
"4324";"360810039001";19;17;95;56;27;214
"4325";"360810040011";28;13;59;18;17;135
"4326";"360810040012";37;6;67;12;23;145
"4327";"360810040021";37;11;61;37;33;179
"4328";"360810042001";47;7;42;16;36;148
"4329";"360810042002";94;41;43;10;27;215
"4330";"360810042003";32;7;20;9;18;86
"4331";"360810043001";321;28;16;11;11;387
"4332";"360810043002";1;0;42;34;4;81
"4333";"360810044011";48;74;43;34;26;225
"4334";"360810044012";48;15;48;34;16;161
"4335";"360810045001";21;18;24;15;85;163
"4336";"360810045002";1;0;6;2;0;9
"4337";"360810045003";5;13;3;0;3;24
"4338";"360810047001";28;19;58;17;9;131
"4339";"360810047002";124;26;4;2;2;158
"4340";"360810050001";3;2;5;6;0;16
"4341";"360810051001";63;62;58;8;26;217
"4342";"360810051002";24;26;53;52;13;168
"4343";"360810052001";79;7;22;9;18;135
"4344";"360810052002";47;8;43;18;36;152
"4345";"360810053001";36;169;32;3;42;282
"4346";"360810053002";121;2;26;0;19;168
"4347";"360810053003";25;7;13;1;8;54
"4348";"360810053004";29;7;72;1;26;135
"4349";"360810054001";5;2;33;13;17;70
"4350";"360810054002";28;2;39;10;37;116
"4351";"360810054003";72;47;66;20;52;257
"4352";"360810054004";40;8;46;16;32;142
"4353";"360810055001";28;116;127;19;39;329
"4354";"360810057001";99;37;76;3;31;246
"4355";"360810057002";73;1;42;0;5;121
"4356";"360810057003";70;120;54;3;27;274
"4357";"360810058001";45;4;81;59;38;227
"4358";"360810058002";18;3;13;10;33;77
"4359";"360810058003";22;6;53;47;38;166
"4360";"360810058004";20;13;37;29;18;117
"4361";"360810059001";27;13;68;2;31;141
"4362";"360810059002";45;73;66;0;15;199
"4363";"360810059003";19;63;67;5;241;395
"4364";"360810061001";19;46;41;0;17;123
"4365";"360810061002";57;91;58;0;9;215
"4366";"360810061003";32;40;9;2;37;120
"4367";"360810061004";19;30;44;3;9;105
"4368";"360810062011";7;2;28;2;6;45
"4369";"360810062012";122;9;59;17;14;221
"4370";"360810062021";3;4;19;6;26;58
"4371";"360810062022";12;14;59;9;24;118
"4372";"360810062023";21;7;38;24;42;132
"4373";"360810062024";6;0;41;7;8;62
"4374";"360810062025";16;4;16;14;15;65
"4375";"360810062026";10;2;25;26;5;68
"4376";"360810062027";61;3;38;26;36;164
"4377";"360810063001";28;31;46;4;22;131
"4378";"360810063002";52;29;62;1;19;163
"4379";"360810063003";80;29;19;2;8;138
"4380";"360810063004";23;70;17;0;20;130
"4381";"360810065011";71;131;25;1;8;236
"4382";"360810065012";32;8;69;1;22;132
"4383";"360810065013";27;9;56;5;6;103
"4384";"360810065021";21;168;76;2;17;284
"4385";"360810065022";8;2;32;7;3;52
"4386";"360810065023";55;16;94;5;22;192
"4387";"360810069001";23;24;94;1;10;152
"4388";"360810069002";27;12;63;5;18;125
"4389";"360810069003";25;79;45;1;41;191
"4390";"360810071001";16;14;28;1;17;76
"4391";"360810071002";29;2;6;4;8;49
"4392";"360810071003";35;10;37;2;6;90
"4393";"360810071004";35;149;151;5;46;386
"4394";"360810073001";57;9;38;2;5;111
"4395";"360810073002";42;2;30;1;6;81
"4396";"360810073003";47;14;47;0;12;120
"4397";"360810075001";38;6;108;3;25;180
"4398";"360810075002";96;178;15;0;40;329
"4399";"360810075003";19;19;50;1;14;103
"4400";"360810077001";27;10;96;11;23;167
"4401";"360810079001";48;13;76;21;35;193
"4402";"360810079002";35;4;19;13;17;88
"4403";"360810081001";47;18;87;40;20;212
"4404";"360810083001";20;6;161;19;18;224
"4405";"360810083002";89;26;70;14;51;250
"4406";"360810085001";14;11;47;54;13;139
"4407";"360810085002";9;10;67;60;19;165
"4408";"360810086001";28;12;78;11;42;171
"4409";"360810086002";31;10;32;35;22;130
"4410";"360810087001";122;14;21;1;7;165
"4411";"360810087002";28;38;16;13;6;101
"4412";"360810087003";65;22;3;0;3;93
"4413";"360810088001";38;8;50;27;71;194
"4414";"360810088002";32;16;52;16;37;153
"4415";"360810091001";15;1;15;3;13;47
"4416";"360810091002";26;2;92;15;24;159
"4417";"360810094001";51;9;91;17;40;208
"4418";"360810094002";55;32;55;17;82;241
"4419";"360810095001";29;9;31;3;7;79
"4420";"360810095002";12;14;34;8;22;90
"4421";"360810096001";91;3;77;23;96;290
"4422";"360810096002";76;32;87;14;52;261
"4423";"360810097001";59;5;14;6;14;98
"4424";"360810097002";5;8;24;2;9;48
"4425";"360810097003";1;7;16;5;16;45
"4426";"360810097004";20;9;21;5;24;79
"4427";"360810098001";63;8;71;28;35;205
"4428";"360810098002";130;45;58;2;81;316
"4429";"360810099001";2;22;3;2;1;30
"4430";"360810100001";61;4;29;6;44;144
"4431";"360810100002";150;11;51;29;119;360
"4432";"360810101001";29;7;37;9;26;108
"4433";"360810101002";18;43;45;4;6;116
"4434";"360810102001";29;1;65;12;24;131
"4435";"360810102002";70;14;54;11;41;190
"4436";"360810103001";42;34;23;2;13;114
"4437";"360810103002";9;29;25;10;14;87
"4438";"360810103003";24;3;45;1;19;92
"4439";"360810103004";28;8;21;3;9;69
"4440";"360810104001";96;15;58;5;66;240
"4441";"360810104002";71;12;85;25;70;263
"4442";"360810105001";24;6;10;0;0;40
"4443";"360810105002";45;11;3;0;4;63
"4444";"360810105003";31;12;16;6;8;73
"4445";"360810105004";14;3;20;5;6;48
"4446";"360810106001";33;9;105;12;51;210
"4447";"360810106002";115;18;97;26;105;361
"4448";"360810107011";1;12;6;12;0;31
"4449";"360810108001";73;3;81;19;355;531
"4450";"360810108002";53;17;146;22;105;343
"4451";"360810110001";18;3;54;13;31;119
"4452";"360810110002";100;26;94;14;67;301
"4453";"360810111001";40;7;24;17;12;100
"4454";"360810111002";11;6;48;2;20;87
"4455";"360810112001";65;10;55;10;42;182
"4456";"360810112002";25;11;69;4;52;161
"4457";"360810113001";23;9;11;2;15;60
"4458";"360810113002";41;11;43;1;24;120
"4459";"360810113003";12;20;39;2;23;96
"4460";"360810114001";61;41;69;14;34;219
"4461";"360810115001";18;30;104;5;62;219
"4462";"360810115002";5;14;49;2;36;106
"4463";"360810116001";80;13;31;19;31;174
"4464";"360810116002";36;10;104;19;48;217
"4465";"360810117001";19;9;44;3;10;85
"4466";"360810117002";15;17;13;2;14;61
"4467";"360810117003";43;67;113;1;25;249
"4468";"360810117004";38;7;29;7;13;94
"4469";"360810118001";33;5;111;29;87;265
"4470";"360810118002";33;0;35;12;50;130
"4471";"360810119001";12;25;37;2;16;92
"4472";"360810119002";14;1;36;2;3;56
"4473";"360810120001";16;3;31;7;12;69
"4474";"360810120002";16;2;74;18;103;213
"4475";"360810121001";17;12;56;2;12;99
"4476";"360810121002";12;15;23;0;14;64
"4477";"360810122001";74;7;54;11;41;187
"4478";"360810122002";73;7;46;21;49;196
"4479";"360810123011";39;54;52;32;40;217
"4480";"360810123012";12;8;62;14;36;132
"4481";"360810123013";9;6;11;8;15;49
"4482";"360810124001";32;1;30;12;34;109
"4483";"360810124002";40;11;65;29;41;186
"4484";"360810125001";21;9;66;12;22;130
"4485";"360810125002";25;11;12;3;7;58
"4486";"360810126011";43;13;63;27;62;208
"4487";"360810126012";34;10;35;17;43;139
"4488";"360810126021";31;7;43;6;54;141
"4489";"360810126022";34;23;51;18;37;163
"4490";"360810128001";8;2;13;9;13;45
"4491";"360810128002";33;12;54;6;29;134
"4492";"360810130001";3;1;7;8;9;28
"4493";"360810130002";24;9;33;12;16;94
"4494";"360810132001";13;2;47;1;4;67
"4495";"360810132002";18;32;35;14;45;144
"4496";"360810134001";45;6;39;0;4;94
"4497";"360810134002";50;5;51;8;4;118
"4498";"360810134003";71;12;22;2;3;110
"4499";"360810134004";6;1;17;1;7;32
"4500";"360810135001";22;1;32;7;20;82
"4501";"360810136001";18;3;20;0;13;54
"4502";"360810136002";6;18;10;2;8;44
"4503";"360810137001";30;20;127;19;27;223
"4504";"360810138001";48;3;26;0;15;92
"4505";"360810138002";99;8;155;21;47;330
"4506";"360810140001";75;6;68;4;10;163
"4507";"360810140002";69;2;106;4;11;192
"4508";"360810141001";27;14;22;1;8;72
"4509";"360810141002";14;0;127;22;35;198
"4510";"360810142011";24;13;74;3;33;147
"4511";"360810142012";57;11;80;24;55;227
"4512";"360810142021";74;32;137;17;105;365
"4513";"360810142022";34;17;42;9;39;141
"4514";"360810143001";28;6;79;0;16;129
"4515";"360810143002";51;175;77;2;37;342
"4516";"360810144001";34;17;134;25;70;280
"4517";"360810145001";7;1;88;26;27;149
"4518";"360810145002";7;5;63;11;11;97
"4519";"360810147001";17;4;26;6;6;59
"4520";"360810147002";25;7;18;5;13;68
"4521";"360810147003";29;25;67;1;32;154
"4522";"360810148001";75;12;78;34;69;268
"4523";"360810149001";47;22;26;3;21;119
"4524";"360810149002";38;16;273;0;25;352
"4525";"360810150001";228;8;40;20;37;333
"4526";"360810150002";53;5;52;6;22;138
"4527";"360810151001";22;11;41;3;34;111
"4528";"360810151002";43;23;58;5;21;150
"4529";"360810152001";49;4;83;17;61;214
"4530";"360810152002";53;13;45;59;62;232
"4531";"360810153001";13;3;83;16;14;129
"4532";"360810153002";19;5;51;2;23;100
"4533";"360810154001";53;7;34;8;14;116
"4534";"360810154002";26;25;108;23;32;214
"4535";"360810155001";25;86;71;1;32;215
"4536";"360810155002";13;45;46;1;27;132
"4537";"360810156001";31;7;86;18;83;225
"4538";"360810156002";68;17;82;20;124;311
"4539";"360810157001";25;91;41;42;22;221
"4540";"360810158011";38;13;32;22;59;164
"4541";"360810158012";50;9;33;17;33;142
"4542";"360810158013";73;49;74;25;52;273
"4543";"360810158021";41;20;74;11;40;186
"4544";"360810158022";61;25;113;19;84;302
"4545";"360810158023";51;8;62;8;63;192
"4546";"360810159001";34;1;56;2;11;104
"4547";"360810159002";20;11;16;33;17;97
"4548";"360810159003";11;3;29;4;12;59
"4549";"360810159004";25;20;78;4;6;133
"4550";"360810161001";34;4;27;3;13;81
"4551";"360810161002";48;5;20;1;9;83
"4552";"360810163001";9;6;32;4;10;61
"4553";"360810163002";15;28;7;0;2;52
"4554";"360810163003";114;13;3;4;8;142
"4555";"360810164001";33;12;96;14;90;245
"4556";"360810164002";67;7;63;12;68;217
"4557";"360810166001";127;12;128;10;55;332
"4558";"360810166002";42;25;57;4;31;159
"4559";"360810168001";131;6;46;13;53;249
"4560";"360810168002";52;12;81;26;30;201
"4561";"360810169001";35;2;8;4;4;53
"4562";"360810169002";21;6;42;2;9;80
"4563";"360810169003";8;5;40;1;20;74
"4564";"360810169004";15;15;16;0;6;52
"4565";"360810170001";33;4;76;7;44;164
"4566";"360810170002";80;13;42;11;43;189
"4567";"360810171001";5;25;45;8;26;109
"4568";"360810172001";52;9;55;18;54;188
"4569";"360810172002";40;32;17;6;23;118
"4570";"360810174001";37;14;20;16;17;104
"4571";"360810174002";53;6;75;35;48;217
"4572";"360810176001";17;4;30;24;15;90
"4573";"360810176002";22;4;21;10;15;72
"4574";"360810178001";52;11;35;15;51;164
"4575";"360810178002";56;7;38;10;39;150
"4576";"360810179001";12;2;69;6;8;97
"4577";"360810179002";13;33;51;9;27;133
"4578";"360810180001";28;9;55;30;24;146
"4579";"360810181011";49;1;19;0;4;73
"4580";"360810181012";37;8;23;1;4;73
"4581";"360810181013";39;13;20;2;7;81
"4582";"360810181021";28;8;4;2;14;56
"4583";"360810181022";15;7;18;3;12;55
"4584";"360810181023";30;17;8;2;4;61
"4585";"360810182001";30;13;39;19;18;119
"4586";"360810182002";81;2;37;19;22;161
"4587";"360810183001";4;4;8;0;7;23
"4588";"360810183002";57;9;11;0;13;90
"4589";"360810183003";90;19;17;5;4;135
"4590";"360810183004";62;8;29;0;20;119
"4591";"360810183005";21;56;18;3;7;105
"4592";"360810184011";160;23;56;49;49;337
"4593";"360810184021";35;10;40;16;20;121
"4594";"360810184022";16;5;31;8;11;71
"4595";"360810185011";10;4;18;3;13;48
"4596";"360810185012";8;1;1;3;3;16
"4597";"360810185013";40;18;37;1;17;113
"4598";"360810185021";21;2;27;0;3;53
"4599";"360810185022";24;7;17;1;12;61
"4600";"360810185023";11;118;9;3;21;162
"4601";"360810186001";85;9;34;41;35;204
"4602";"360810187001";3;5;31;4;24;67
"4603";"360810187002";26;3;28;0;7;64
"4604";"360810187003";18;1;48;8;27;102
"4605";"360810188001";14;3;22;20;15;74
"4606";"360810189001";170;27;35;4;27;263
"4607";"360810189002";35;5;126;7;27;200
"4608";"360810189003";22;2;16;2;4;46
"4609";"360810190001";20;4;58;13;25;120
"4610";"360810190002";21;4;40;32;19;116
"4611";"360810192001";49;2;27;16;16;110
"4612";"360810192002";36;17;19;22;22;116
"4613";"360810194001";23;1;17;41;19;101
"4614";"360810194002";28;4;37;32;29;130
"4615";"360810196001";63;6;32;10;23;134
"4616";"360810196002";59;5;78;34;26;202
"4617";"360810198001";29;42;18;10;25;124
"4618";"360810198002";94;4;44;17;25;184
"4619";"360810198003";15;1;10;19;5;50
"4620";"360810199001";1;0;86;23;28;138
"4621";"360810199002";6;17;142;44;46;255
"4622";"360810202001";21;1;72;35;28;157
"4623";"360810204001";14;9;24;44;36;127
"4624";"360810204002";42;14;42;39;46;183
"4625";"360810205001";20;8;76;25;18;147
"4626";"360810205002";31;2;18;17;12;80
"4627";"360810206001";50;11;101;118;72;352
"4628";"360810208001";15;2;64;5;39;125
"4629";"360810208002";21;107;83;82;66;359
"4630";"360810212001";11;13;40;11;93;168
"4631";"360810212002";45;8;40;7;25;125
"4632";"360810214001";183;6;52;1;9;251
"4633";"360810214002";138;7;45;5;8;203
"4634";"360810214003";62;29;123;37;68;319
"4635";"360810216001";32;4;22;1;16;75
"4636";"360810216002";20;14;75;3;6;118
"4637";"360810216003";28;3;41;16;18;106
"4638";"360810219001";0;6;58;33;10;107
"4639";"360810220011";13;1;42;3;14;73
"4640";"360810220012";70;3;79;3;14;169
"4641";"360810220013";77;9;19;6;5;116
"4642";"360810220014";30;0;2;0;0;32
"4643";"360810220021";2;0;22;2;4;30
"4644";"360810220022";50;0;48;6;7;111
"4645";"360810220023";65;7;55;2;17;146
"4646";"360810220024";94;3;75;4;19;195
"4647";"360810229001";1;0;11;2;0;14
"4648";"360810230001";15;5;24;4;37;85
"4649";"360810230002";23;0;16;1;63;103
"4650";"360810232001";10;0;13;4;2;29
"4651";"360810232002";31;3;99;1;20;154
"4652";"360810232003";23;6;74;4;51;158
"4653";"360810235001";62;32;22;3;31;150
"4654";"360810235002";44;13;8;0;16;81
"4655";"360810235003";43;4;19;1;12;79
"4656";"360810235004";17;18;17;1;27;80
"4657";"360810236001";9;3;39;5;21;77
"4658";"360810236002";65;18;5;1;27;116
"4659";"360810238001";10;5;22;2;27;66
"4660";"360810238002";18;10;8;2;39;77
"4661";"360810238003";88;2;22;0;10;122
"4662";"360810238004";17;6;21;0;16;60
"4663";"360810240001";28;75;13;1;32;149
"4664";"360810240002";44;20;26;6;34;130
"4665";"360810240003";65;10;7;0;9;91
"4666";"360810243001";18;9;18;24;27;96
"4667";"360810243002";13;5;25;49;25;117
"4668";"360810243003";24;23;103;44;61;255
"4669";"360810243004";64;1;69;102;37;273
"4670";"360810245001";1;1;1;4;0;7
"4671";"360810245002";10;0;37;2;7;56
"4672";"360810245003";2;8;8;2;0;20
"4673";"360810245004";71;1;53;5;13;143
"4674";"360810246001";1;0;9;0;9;19
"4675";"360810247001";17;3;37;6;21;84
"4676";"360810249001";123;64;73;2;18;280
"4677";"360810249002";78;10;53;2;17;160
"4678";"360810249003";7;9;70;2;14;102
"4679";"360810251001";29;13;14;2;3;61
"4680";"360810251002";13;1;31;0;13;58
"4681";"360810251003";69;20;70;7;18;184
"4682";"360810251004";103;35;7;3;23;171
"4683";"360810253011";35;5;34;1;9;84
"4684";"360810253012";68;22;26;4;10;130
"4685";"360810253013";107;1;3;2;9;122
"4686";"360810253014";57;14;18;2;10;101
"4687";"360810253021";57;3;4;0;4;68
"4688";"360810253022";112;31;100;0;31;274
"4689";"360810254001";38;8;56;27;47;176
"4690";"360810254002";12;6;32;22;11;83
"4691";"360810254003";171;14;19;2;19;225
"4692";"360810254004";43;3;7;2;7;62
"4693";"360810254005";76;6;82;48;25;237
"4694";"360810254006";20;6;20;23;24;93
"4695";"360810255001";25;10;80;22;58;195
"4696";"360810257001";16;38;131;21;56;262
"4697";"360810258001";11;7;28;48;13;107
"4698";"360810258002";85;4;18;11;22;140
"4699";"360810259001";41;9;77;4;50;181
"4700";"360810259002";35;27;53;2;37;154
"4701";"360810260001";34;3;9;3;18;67
"4702";"360810260002";32;6;20;32;11;101
"4703";"360810261001";26;16;9;2;27;80
"4704";"360810261002";45;3;32;0;12;92
"4705";"360810261003";62;229;20;1;39;351
"4706";"360810261004";58;30;72;3;27;190
"4707";"360810262001";28;3;42;28;23;124
"4708";"360810263001";57;189;83;1;43;373
"4709";"360810263002";83;43;74;4;66;270
"4710";"360810263003";23;2;39;1;14;79
"4711";"360810264001";22;5;21;25;23;96
"4712";"360810264002";40;5;22;14;21;102
"4713";"360810265001";24;22;101;10;31;188
"4714";"360810265002";42;3;36;1;25;107
"4715";"360810266001";31;10;24;15;17;97
"4716";"360810267001";55;119;29;60;24;287
"4717";"360810267002";50;9;39;2;16;116
"4718";"360810267003";42;14;115;47;38;256
"4719";"360810269011";23;28;13;5;31;100
"4720";"360810269012";48;2;3;1;4;58
"4721";"360810269013";33;2;11;0;2;48
"4722";"360810269014";18;3;11;47;34;113
"4723";"360810269021";139;12;35;1;14;201
"4724";"360810269022";47;7;37;0;25;116
"4725";"360810270001";30;17;48;21;51;167
"4726";"360810271001";97;48;21;20;14;200
"4727";"360810271002";60;4;35;1;27;127
"4728";"360810271003";57;1;54;0;20;132
"4729";"360810271004";33;17;11;0;4;65
"4730";"360810271005";47;5;11;1;12;76
"4731";"360810272001";13;2;60;18;17;110
"4732";"360810272002";12;1;23;5;44;85
"4733";"360810273001";25;24;6;2;3;60
"4734";"360810273002";108;5;7;0;10;130
"4735";"360810273003";133;18;7;1;14;173
"4736";"360810273004";23;11;24;1;26;85
"4737";"360810273005";90;20;82;2;19;213
"4738";"360810274001";23;1;44;8;14;90
"4739";"360810275001";30;5;6;0;2;43
"4740";"360810275002";85;10;84;3;39;221
"4741";"360810275003";93;17;49;22;53;234
"4742";"360810276001";97;25;57;35;24;238
"4743";"360810277001";30;1;5;0;2;38
"4744";"360810277002";55;13;37;5;36;146
"4745";"360810277003";99;3;8;3;14;127
"4746";"360810277004";36;9;12;16;39;112
"4747";"360810277005";175;9;18;28;53;283
"4748";"360810278001";84;7;5;7;15;118
"4749";"360810278002";43;5;2;6;1;57
"4750";"360810279001";43;7;58;41;16;165
"4751";"360810279002";64;3;18;20;14;119
"4752";"360810279003";24;22;5;33;16;100
"4753";"360810279004";6;6;6;4;0;22
"4754";"360810280001";27;2;18;19;38;104
"4755";"360810281001";78;11;34;12;12;147
"4756";"360810281002";55;6;26;3;8;98
"4757";"360810281003";15;10;14;6;9;54
"4758";"360810281004";55;5;16;1;17;94
"4759";"360810282001";44;4;38;17;16;119
"4760";"360810283001";24;19;6;0;5;54
"4761";"360810283002";27;8;5;1;6;47
"4762";"360810283003";13;21;5;5;20;64
"4763";"360810283004";64;19;2;4;16;105
"4764";"360810283005";134;6;5;8;4;157
"4765";"360810284001";37;4;42;17;24;124
"4766";"360810284002";36;6;10;11;20;83
"4767";"360810285001";9;2;6;5;5;27
"4768";"360810285002";18;2;37;4;2;63
"4769";"360810285003";31;10;24;1;4;70
"4770";"360810285004";37;45;14;38;22;156
"4771";"360810287001";24;9;9;32;5;79
"4772";"360810287002";5;7;15;0;9;36
"4773";"360810287003";61;26;57;9;25;178
"4774";"360810287004";63;11;8;5;3;90
"4775";"360810288001";11;4;19;12;6;52
"4776";"360810288002";34;27;11;22;13;107
"4777";"360810288003";31;4;14;10;23;82
"4778";"360810288004";44;3;27;29;16;119
"4779";"360810289001";48;10;26;6;15;105
"4780";"360810289002";29;5;73;0;8;115
"4781";"360810289003";106;32;40;1;33;212
"4782";"360810291001";9;5;52;24;12;102
"4783";"360810291002";25;3;39;0;25;92
"4784";"360810291003";48;12;19;5;35;119
"4785";"360810291004";42;15;39;11;23;130
"4786";"360810293001";22;11;49;16;36;134
"4787";"360810294001";34;0;31;17;10;92
"4788";"360810294002";27;22;24;23;10;106
"4789";"360810294003";47;3;43;15;17;125
"4790";"360810294004";6;1;21;12;10;50
"4791";"360810294005";26;6;28;13;41;114
"4792";"360810294006";22;3;12;22;14;73
"4793";"360810295001";11;3;85;7;2;108
"4794";"360810295002";18;7;114;45;25;209
"4795";"360810297001";6;9;120;20;14;169
"4796";"360810297002";61;5;137;39;37;279
"4797";"360810299001";0;0;5;3;2;10
"4798";"360810306001";23;15;47;15;15;115
"4799";"360810306002";26;13;20;18;21;98
"4800";"360810306003";67;12;60;43;21;203
"4801";"360810306004";19;18;41;15;7;100
"4802";"360810309021";19;1;61;8;9;98
"4803";"360810309022";67;4;94;14;47;226
"4804";"360810309023";62;2;65;33;28;190
"4805";"360810309024";17;0;37;6;16;76
"4806";"360810309025";33;1;43;12;23;112
"4807";"360810309031";84;27;120;92;62;385
"4808";"360810309032";51;5;56;7;29;148
"4809";"360810309033";95;6;55;11;65;232
"4810";"360810309041";44;2;78;16;44;184
"4811";"360810309042";39;2;61;11;58;171
"4812";"360810317001";21;8;81;7;28;145
"4813";"360810317002";7;3;49;6;12;77
"4814";"360810317003";41;0;79;3;5;128
"4815";"360810317004";52;2;72;6;41;173
"4816";"360810320001";42;7;32;18;28;127
"4817";"360810320002";4;11;38;28;21;102
"4818";"360810320003";61;20;29;27;21;158
"4819";"360810320004";20;8;11;11;14;64
"4820";"360810327001";51;11;130;9;64;265
"4821";"360810327002";83;43;45;2;35;208
"4822";"360810328001";42;7;16;7;20;92
"4823";"360810328002";23;0;31;29;14;97
"4824";"360810329001";27;3;37;25;31;123
"4825";"360810329002";19;0;42;28;25;114
"4826";"360810329003";50;9;59;19;40;177
"4827";"360810330001";36;26;18;29;38;147
"4828";"360810330002";4;5;11;16;26;62
"4829";"360810330003";24;1;6;16;16;63
"4830";"360810330004";15;6;22;14;20;77
"4831";"360810330005";9;0;21;19;16;65
"4832";"360810331001";0;3;5;2;1;11
"4833";"360810334011";32;7;24;19;20;102
"4834";"360810334012";37;5;52;42;33;169
"4835";"360810334021";8;0;0;1;1;10
"4836";"360810334022";8;1;0;0;0;9
"4837";"360810334023";4;33;0;0;0;37
"4838";"360810334024";11;7;3;1;2;24
"4839";"360810334025";14;14;4;1;2;35
"4840";"360810334026";23;2;40;16;10;91
"4841";"360810337001";57;5;93;11;40;206
"4842";"360810337002";36;49;137;46;86;354
"4843";"360810339001";32;23;25;8;28;116
"4844";"360810339002";3;6;30;4;3;46
"4845";"360810339003";20;62;37;1;16;136
"4846";"360810347001";52;63;103;25;38;281
"4847";"360810347002";36;13;119;17;33;218
"4848";"360810351001";59;4;26;8;13;110
"4849";"360810351002";48;7;67;21;8;151
"4850";"360810351003";17;20;47;1;23;108
"4851";"360810352001";14;7;33;38;30;122
"4852";"360810352002";38;5;59;12;15;129
"4853";"360810353001";24;14;33;12;37;120
"4854";"360810353002";88;41;26;4;24;183
"4855";"360810357001";102;4;138;21;41;306
"4856";"360810357002";47;9;104;17;28;205
"4857";"360810357003";38;13;98;10;25;184
"4858";"360810358001";5;4;19;13;10;51
"4859";"360810358002";22;5;31;9;16;83
"4860";"360810358003";29;3;21;33;24;110
"4861";"360810358004";4;0;4;11;3;22
"4862";"360810361001";82;28;49;11;41;211
"4863";"360810361002";33;8;29;5;21;96
"4864";"360810363001";90;5;48;14;25;182
"4865";"360810363002";27;17;61;8;21;134
"4866";"360810365001";37;1;64;8;36;146
"4867";"360810365002";34;6;88;6;33;167
"4868";"360810366001";31;9;55;40;17;152
"4869";"360810366002";16;106;34;20;11;187
"4870";"360810367001";13;3;18;10;16;60
"4871";"360810367002";53;6;79;40;62;240
"4872";"360810368001";25;11;9;6;19;70
"4873";"360810368002";19;5;16;11;17;68
"4874";"360810371001";24;5;118;26;18;191
"4875";"360810373001";39;9;107;9;13;177
"4876";"360810373002";358;146;211;24;19;758
"4877";"360810375001";57;3;117;9;18;204
"4878";"360810375002";132;23;68;7;45;275
"4879";"360810376001";17;4;19;8;16;64
"4880";"360810376002";37;15;15;13;18;98
"4881";"360810376003";5;2;6;7;6;26
"4882";"360810376004";37;7;28;28;19;119
"4883";"360810376005";26;19;23;8;15;91
"4884";"360810377001";71;7;137;11;30;256
"4885";"360810377002";45;2;56;7;26;136
"4886";"360810379001";58;8;147;16;31;260
"4887";"360810379002";59;12;86;16;31;204
"4888";"360810379003";100;20;48;12;25;205
"4889";"360810381001";45;18;96;6;36;201
"4890";"360810381002";117;17;91;7;47;279
"4891";"360810381003";40;27;95;12;24;198
"4892";"360810383011";14;91;43;47;2;197
"4893";"360810383021";31;210;70;26;26;363
"4894";"360810384001";10;5;29;10;39;93
"4895";"360810384002";39;8;21;22;32;122
"4896";"360810394001";30;39;35;14;24;142
"4897";"360810394002";18;3;12;7;15;55
"4898";"360810394003";57;6;3;12;8;86
"4899";"360810398001";6;3;9;7;14;39
"4900";"360810398002";5;1;5;14;8;33
"4901";"360810399001";22;8;49;12;25;116
"4902";"360810399002";26;9;34;3;12;84
"4903";"360810399003";28;4;41;16;7;96
"4904";"360810400001";8;2;7;10;19;46
"4905";"360810400002";12;3;14;14;9;52
"4906";"360810401001";127;11;92;16;29;275
"4907";"360810401002";46;17;101;4;65;233
"4908";"360810401003";41;6;49;1;28;125
"4909";"360810402001";10;6;15;10;9;50
"4910";"360810402002";9;5;9;4;5;32
"4911";"360810403001";185;34;189;9;39;456
"4912";"360810403002";49;23;56;2;29;159
"4913";"360810403003";49;3;60;2;23;137
"4914";"360810404001";37;5;18;9;10;79
"4915";"360810404002";54;4;18;9;2;87
"4916";"360810404003";34;6;4;14;10;68
"4917";"360810404004";72;10;26;12;21;141
"4918";"360810405001";24;33;24;2;28;111
"4919";"360810405002";19;28;37;11;34;129
"4920";"360810407001";28;3;55;4;16;106
"4921";"360810407002";40;8;37;2;24;111
"4922";"360810407003";9;1;31;6;15;62
"4923";"360810407004";23;5;56;0;4;88
"4924";"360810407005";5;7;9;4;11;36
"4925";"360810409001";83;5;45;9;15;157
"4926";"360810409002";43;5;35;2;15;100
"4927";"360810409003";20;10;40;4;35;109
"4928";"360810409004";15;27;27;4;14;87
"4929";"360810411001";29;24;58;9;41;161
"4930";"360810411002";65;3;80;9;12;169
"4931";"360810413001";108;18;91;16;43;276
"4932";"360810413002";77;12;87;2;25;203
"4933";"360810414001";99;16;55;51;46;267
"4934";"360810414002";89;5;8;11;4;117
"4935";"360810414003";45;4;23;34;16;122
"4936";"360810415001";84;9;75;11;49;228
"4937";"360810415002";49;3;64;9;21;146
"4938";"360810424001";15;6;39;41;35;136
"4939";"360810424002";12;8;6;9;13;48
"4940";"360810424003";3;1;2;5;3;14
"4941";"360810426001";10;3;0;0;3;16
"4942";"360810427001";72;10;70;31;42;225
"4943";"360810427002";65;8;197;4;30;304
"4944";"360810432001";37;8;19;13;12;89
"4945";"360810434001";25;6;38;33;30;132
"4946";"360810437011";36;7;106;25;19;193
"4947";"360810437012";23;1;28;12;14;78
"4948";"360810437021";84;9;22;3;6;124
"4949";"360810437022";88;1;112;3;26;230
"4950";"360810437023";57;16;130;15;33;251
"4951";"360810439001";63;8;127;6;23;227
"4952";"360810439002";68;15;118;8;47;256
"4953";"360810440001";46;3;82;48;35;214
"4954";"360810440002";29;3;27;23;17;99
"4955";"360810440003";50;12;65;20;34;181
"4956";"360810443011";51;7;85;0;28;171
"4957";"360810443012";51;16;98;2;24;191
"4958";"360810443021";35;2;94;9;6;146
"4959";"360810443022";17;2;88;3;13;123
"4960";"360810443023";70;21;141;7;17;256
"4961";"360810444001";22;8;41;2;54;127
"4962";"360810444002";17;55;72;7;64;215
"4963";"360810444003";32;8;62;30;79;211
"4964";"360810446011";20;9;7;1;23;60
"4965";"360810446012";58;232;11;0;86;387
"4966";"360810446021";77;11;43;0;55;186
"4967";"360810446022";62;6;13;1;29;111
"4968";"360810448001";39;13;53;3;30;138
"4969";"360810448002";8;1;14;1;17;41
"4970";"360810450001";47;2;40;2;29;120
"4971";"360810450002";19;24;13;1;25;82
"4972";"360810452001";15;14;31;3;12;75
"4973";"360810454001";24;6;35;3;64;132
"4974";"360810454002";51;10;89;0;28;178
"4975";"360810455001";36;6;1;0;5;48
"4976";"360810455002";22;4;1;0;0;27
"4977";"360810455003";39;7;2;0;1;49
"4978";"360810455004";27;0;1;0;0;28
"4979";"360810455005";16;1;0;1;0;18
"4980";"360810455006";1;0;4;0;1;6
"4981";"360810456001";30;10;26;8;14;88
"4982";"360810457001";46;1;80;0;17;144
"4983";"360810457002";77;6;56;5;20;164
"4984";"360810458001";120;31;108;7;63;329
"4985";"360810459001";44;3;62;5;33;147
"4986";"360810459002";29;1;31;2;8;71
"4987";"360810460001";67;6;24;5;59;161
"4988";"360810460002";31;17;8;4;22;82
"4989";"360810460003";70;14;13;9;32;138
"4990";"360810461001";44;67;80;3;49;243
"4991";"360810462001";35;23;50;4;50;162
"4992";"360810462002";121;33;62;2;48;266
"4993";"360810462003";173;12;82;9;95;371
"4994";"360810463001";266;27;75;2;18;388
"4995";"360810463002";50;17;78;6;30;181
"4996";"360810464001";27;1;25;4;19;76
"4997";"360810465001";75;5;21;4;16;121
"4998";"360810465002";51;5;26;1;34;117
"4999";"360810466001";125;30;34;0;21;210
"5000";"360810466002";9;5;28;3;13;58
"5001";"360810467001";52;2;9;0;14;77
"5002";"360810467002";134;2;72;3;31;242
"5003";"360810467003";76;34;41;4;10;165
"5004";"360810467004";52;8;26;0;19;105
"5005";"360810468001";44;6;49;2;39;140
"5006";"360810468002";61;19;86;12;70;248
"5007";"360810469001";80;12;50;31;24;197
"5008";"360810469002";45;0;14;0;3;62
"5009";"360810469003";15;2;19;0;17;53
"5010";"360810469004";52;4;9;1;9;75
"5011";"360810469005";50;2;11;1;3;67
"5012";"360810470001";37;3;41;3;30;114
"5013";"360810470002";122;59;68;12;62;323
"5014";"360810471001";245;28;15;0;42;330
"5015";"360810471002";25;1;34;6;26;92
"5016";"360810472001";28;4;41;3;11;87
"5017";"360810472002";29;3;17;15;24;88
"5018";"360810472003";28;2;14;1;5;50
"5019";"360810473001";51;3;71;0;27;152
"5020";"360810473002";13;14;31;1;33;92
"5021";"360810473003";2;3;10;0;4;19
"5022";"360810475001";23;4;47;1;14;89
"5023";"360810475002";44;5;194;11;41;295
"5024";"360810476001";3;0;2;7;7;19
"5025";"360810476002";10;1;2;9;11;33
"5026";"360810478001";19;7;20;5;27;78
"5027";"360810478002";28;2;22;25;35;112
"5028";"360810478003";71;18;53;19;43;204
"5029";"360810479001";157;21;99;12;27;316
"5030";"360810479002";10;19;32;11;27;99
"5031";"360810479003";27;4;49;2;23;105
"5032";"360810480001";84;5;44;15;48;196
"5033";"360810480002";46;2;34;28;36;146
"5034";"360810481001";9;0;47;0;19;75
"5035";"360810481002";51;4;22;1;10;88
"5036";"360810481003";136;5;26;0;7;174
"5037";"360810481004";8;1;4;0;7;20
"5038";"360810482001";60;7;56;38;68;229
"5039";"360810483001";28;3;59;1;19;110
"5040";"360810483002";64;13;82;18;29;206
"5041";"360810484001";17;2;34;12;49;114
"5042";"360810484002";41;19;55;15;37;167
"5043";"360810484003";10;1;54;18;13;96
"5044";"360810484004";16;5;19;26;18;84
"5045";"360810485001";16;18;27;6;16;83
"5046";"360810485002";39;0;33;5;26;103
"5047";"360810485003";51;5;60;4;23;143
"5048";"360810489001";20;5;92;47;71;235
"5049";"360810489002";149;0;40;7;6;202
"5050";"360810492001";143;8;35;23;8;217
"5051";"360810492002";8;1;13;7;23;52
"5052";"360810492003";29;5;37;21;31;123
"5053";"360810493011";33;1;122;39;46;241
"5054";"360810493012";20;4;59;21;22;126
"5055";"360810493021";28;64;88;15;26;221
"5056";"360810493022";45;6;59;31;29;170
"5057";"360810495001";11;1;112;19;13;156
"5058";"360810496001";19;3;18;13;32;85
"5059";"360810496002";27;7;18;9;39;100
"5060";"360810496003";12;9;24;7;32;84
"5061";"360810497001";39;7;63;12;43;164
"5062";"360810497002";14;3;48;22;15;102
"5063";"360810499001";20;20;29;27;33;129
"5064";"360810499002";21;4;62;12;25;124
"5065";"360810499003";30;3;69;31;60;193
"5066";"360810500001";48;16;28;34;36;162
"5067";"360810500002";80;26;62;14;49;231
"5068";"360810502011";27;9;31;31;16;114
"5069";"360810502021";30;4;14;25;13;86
"5070";"360810504001";56;1;10;16;13;96
"5071";"360810504002";16;1;22;17;17;73
"5072";"360810505001";18;3;88;13;19;141
"5073";"360810506001";11;1;11;18;30;71
"5074";"360810506002";1;0;5;11;22;39
"5075";"360810507001";51;2;144;37;23;257
"5076";"360810507002";25;3;23;14;20;85
"5077";"360810508001";38;7;12;21;29;107
"5078";"360810508002";7;5;14;15;16;57
"5079";"360810510001";32;2;14;22;6;76
"5080";"360810510002";15;0;17;5;8;45
"5081";"360810511001";5;2;54;68;15;144
"5082";"360810511002";14;3;48;10;15;90
"5083";"360810512001";9;8;6;12;19;54
"5084";"360810512002";13;2;12;14;19;60
"5085";"360810512003";16;8;17;14;12;67
"5086";"360810513001";14;0;130;26;44;214
"5087";"360810513002";8;1;85;20;23;137
"5088";"360810515001";11;7;45;12;16;91
"5089";"360810515002";23;1;69;19;7;119
"5090";"360810515003";11;0;34;16;9;70
"5091";"360810516001";14;6;19;5;8;52
"5092";"360810516002";21;1;11;16;20;69
"5093";"360810517001";19;4;35;23;22;103
"5094";"360810517002";18;6;108;21;16;169
"5095";"360810518001";14;2;7;8;6;37
"5096";"360810518002";6;5;19;15;18;63
"5097";"360810520001";24;7;25;9;34;99
"5098";"360810521001";56;1;27;11;21;116
"5099";"360810521002";19;7;73;20;36;155
"5100";"360810522001";29;9;9;6;17;70
"5101";"360810524001";15;5;11;10;16;57
"5102";"360810524002";15;1;10;6;18;50
"5103";"360810525001";9;0;57;22;22;110
"5104";"360810525002";40;14;87;49;17;207
"5105";"360810526001";18;10;60;6;43;137
"5106";"360810526002";13;26;13;22;19;93
"5107";"360810528001";31;4;19;19;32;105
"5108";"360810530001";9;5;4;6;7;31
"5109";"360810530002";46;9;19;16;14;104
"5110";"360810531001";18;8;82;75;36;219
"5111";"360810531002";4;1;58;13;23;99
"5112";"360810531003";4;19;61;18;16;118
"5113";"360810532001";11;0;13;11;7;42
"5114";"360810532002";5;0;12;4;18;39
"5115";"360810534011";12;1;17;10;16;56
"5116";"360810534012";16;2;18;6;9;51
"5117";"360810535001";15;5;82;19;15;136
"5118";"360810536011";8;4;7;14;15;48
"5119";"360810536012";7;5;12;18;24;66
"5120";"360810538001";54;3;10;13;12;92
"5121";"360810538002";11;1;6;5;11;34
"5122";"360810539001";78;18;59;16;15;186
"5123";"360810539002";25;12;29;2;14;82
"5124";"360810539003";114;15;70;6;35;240
"5125";"360810540001";37;2;20;30;31;120
"5126";"360810540002";21;2;44;59;37;163
"5127";"360810540003";55;2;31;8;15;111
"5128";"360810542001";33;2;11;5;36;87
"5129";"360810542002";37;4;24;7;61;133
"5130";"360810542003";30;4;34;13;45;126
"5131";"360810542004";27;5;16;14;27;89
"5132";"360810545001";41;26;30;4;13;114
"5133";"360810545002";19;1;41;2;11;74
"5134";"360810545003";25;7;26;1;20;79
"5135";"360810547001";30;33;38;1;12;114
"5136";"360810547002";66;30;53;1;6;156
"5137";"360810547003";87;5;23;2;5;122
"5138";"360810548001";62;5;18;12;42;139
"5139";"360810548002";22;0;16;4;15;57
"5140";"360810549001";5;11;41;1;13;71
"5141";"360810549002";12;19;29;1;24;85
"5142";"360810549003";54;32;17;2;8;113
"5143";"360810549004";58;14;15;4;15;106
"5144";"360810551001";14;5;25;2;17;63
"5145";"360810551002";51;28;13;1;5;98
"5146";"360810551003";32;23;8;1;17;81
"5147";"360810551004";40;11;8;4;16;79
"5148";"360810552001";35;0;16;15;20;86
"5149";"360810552002";39;1;50;9;28;127
"5150";"360810553001";29;16;49;5;17;116
"5151";"360810553002";46;13;8;1;3;71
"5152";"360810554001";7;3;25;10;11;56
"5153";"360810554002";29;0;32;10;20;91
"5154";"360810555001";37;11;16;9;17;90
"5155";"360810555002";32;32;53;15;20;152
"5156";"360810556001";33;2;15;8;50;108
"5157";"360810556002";14;1;7;2;4;28
"5158";"360810557001";52;12;68;3;12;147
"5159";"360810557002";16;3;48;7;30;104
"5160";"360810557003";39;10;3;0;11;63
"5161";"360810558001";5;2;5;3;14;29
"5162";"360810558002";52;4;8;21;28;113
"5163";"360810559001";56;34;45;10;35;180
"5164";"360810560001";32;0;14;5;12;63
"5165";"360810560002";43;1;2;12;19;77
"5166";"360810561001";3;51;18;4;3;79
"5167";"360810562001";34;4;13;12;27;90
"5168";"360810564001";42;3;37;7;11;100
"5169";"360810565001";54;19;131;46;48;298
"5170";"360810566001";38;0;5;4;11;58
"5171";"360810566002";14;3;9;9;13;48
"5172";"360810567001";7;1;112;47;3;170
"5173";"360810567002";23;6;171;71;15;286
"5174";"360810567003";33;19;115;12;31;210
"5175";"360810567004";27;4;86;18;25;160
"5176";"360810568001";19;7;23;20;26;95
"5177";"360810568002";5;4;19;10;6;44
"5178";"360810568003";13;7;15;10;20;65
"5179";"360810568004";43;18;13;12;25;111
"5180";"360810577001";18;0;6;2;4;30
"5181";"360810577002";21;22;47;8;13;111
"5182";"360810577003";10;1;65;2;17;95
"5183";"360810579001";31;5;11;2;3;52
"5184";"360810579002";10;0;22;4;9;45
"5185";"360810580001";20;1;8;13;12;54
"5186";"360810580002";10;5;13;20;5;53
"5187";"360810580003";10;2;24;17;22;75
"5188";"360810580004";4;2;2;6;14;28
"5189";"360810581001";56;7;66;18;14;161
"5190";"360810581002";29;7;58;3;9;106
"5191";"360810582001";37;10;44;27;12;130
"5192";"360810582002";40;4;34;16;29;123
"5193";"360810582003";7;7;9;21;7;51
"5194";"360810583001";32;11;33;4;14;94
"5195";"360810583002";9;4;20;6;20;59
"5196";"360810583003";12;4;20;7;6;49
"5197";"360810585001";3;8;11;0;18;40
"5198";"360810585002";15;3;70;3;14;105
"5199";"360810585003";17;30;47;4;28;126
"5200";"360810587001";5;3;161;5;14;188
"5201";"360810587002";26;9;28;1;12;76
"5202";"360810587003";15;22;26;0;21;84
"5203";"360810589001";48;14;90;0;31;183
"5204";"360810589002";25;16;23;2;17;83
"5205";"360810589003";12;46;21;2;17;98
"5206";"360810590001";7;28;9;13;7;64
"5207";"360810591001";10;2;42;5;10;69
"5208";"360810591002";23;42;84;0;7;156
"5209";"360810591003";24;9;62;1;12;108
"5210";"360810591004";18;3;46;0;16;83
"5211";"360810592001";15;4;7;20;13;59
"5212";"360810593001";19;33;84;10;12;158
"5213";"360810593002";29;14;116;14;32;205
"5214";"360810594001";9;1;12;16;9;47
"5215";"360810594002";6;2;23;11;8;50
"5216";"360810595001";15;6;28;16;17;82
"5217";"360810595002";16;2;77;3;5;103
"5218";"360810595003";16;2;35;1;14;68
"5219";"360810595004";31;7;59;8;26;131
"5220";"360810596001";4;4;3;5;6;22
"5221";"360810596002";28;1;13;4;10;56
"5222";"360810598001";2;3;10;4;23;42
"5223";"360810598002";11;9;27;27;9;83
"5224";"360810599001";21;3;34;11;13;82
"5225";"360810599002";12;1;62;12;12;99
"5226";"360810600001";9;8;19;35;13;84
"5227";"360810601001";17;8;91;26;21;163
"5228";"360810601002";13;14;50;19;7;103
"5229";"360810603001";16;1;189;31;35;272
"5230";"360810606001";23;4;17;6;1;51
"5231";"360810606002";25;1;7;12;9;54
"5232";"360810607011";2;4;30;9;6;51
"5233";"360810608001";33;501;25;29;21;609
"5234";"360810610001";15;3;22;9;14;63
"5235";"360810612001";5;1;2;7;8;23
"5236";"360810612002";7;0;18;13;5;43
"5237";"360810613011";42;6;76;11;19;154
"5238";"360810613012";19;13;97;12;24;165
"5239";"360810613013";20;8;38;3;7;76
"5240";"360810613014";28;6;14;1;3;52
"5241";"360810613021";0;0;4;0;0;4
"5242";"360810614001";4;1;8;17;13;43
"5243";"360810616011";4;1;4;18;6;33
"5244";"360810616012";2;1;3;7;5;18
"5245";"360810616013";21;2;5;2;1;31
"5246";"360810616021";2;3;15;10;6;36
"5247";"360810616022";0;1;4;13;11;29
"5248";"360810618001";1;0;3;10;1;15
"5249";"360810618002";14;6;12;12;14;58
"5250";"360810619001";17;7;159;34;37;254
"5251";"360810619002";35;6;48;5;43;137
"5252";"360810620001";17;2;16;36;15;86
"5253";"360810621001";52;11;41;14;14;132
"5254";"360810621002";4;4;50;19;6;83
"5255";"360810621003";12;1;25;13;17;68
"5256";"360810622001";8;5;4;6;6;29
"5257";"360810622002";15;2;23;10;5;55
"5258";"360810623001";8;1;43;19;6;77
"5259";"360810623002";21;1;80;23;11;136
"5260";"360810624001";0;0;2;0;1;3
"5261";"360810625001";38;4;37;9;14;102
"5262";"360810625002";81;7;100;26;36;250
"5263";"360810626001";6;1;25;13;14;59
"5264";"360810626002";30;30;17;13;18;108
"5265";"360810626003";12;4;11;13;6;46
"5266";"360810627001";23;1;69;3;14;110
"5267";"360810627002";5;2;54;2;19;82
"5268";"360810629001";19;11;68;17;18;133
"5269";"360810629002";28;5;19;8;12;72
"5270";"360810629003";17;21;76;8;11;133
"5271";"360810630001";21;13;18;14;13;79
"5272";"360810630002";17;5;15;4;11;52
"5273";"360810632001";5;0;8;8;2;23
"5274";"360810632002";49;11;27;23;24;134
"5275";"360810633011";14;6;87;21;16;144
"5276";"360810633021";5;0;29;7;15;56
"5277";"360810633022";11;1;68;20;15;115
"5278";"360810635001";5;2;32;14;8;61
"5279";"360810635002";25;3;66;17;17;128
"5280";"360810637001";21;1;39;24;20;105
"5281";"360810637002";6;10;37;10;16;79
"5282";"360810637003";28;0;38;17;17;100
"5283";"360810638001";6;4;33;11;10;64
"5284";"360810638002";11;6;19;5;10;51
"5285";"360810638003";7;2;4;16;4;33
"5286";"360810638004";13;1;10;21;4;49
"5287";"360810638005";12;12;8;10;6;48
"5288";"360810639001";12;3;83;30;12;140
"5289";"360810639002";5;11;194;27;17;254
"5290";"360810641011";28;2;49;7;50;136
"5291";"360810641021";18;5;59;13;21;116
"5292";"360810645001";3;74;29;6;3;115
"5293";"360810645002";4;1;65;8;21;99
"5294";"360810646001";8;3;19;22;13;65
"5295";"360810646002";15;2;10;12;14;53
"5296";"360810650001";8;6;6;18;20;58
"5297";"360810650002";16;3;4;28;19;70
"5298";"360810654001";46;7;26;12;30;121
"5299";"360810654002";29;2;22;9;13;75
"5300";"360810654003";20;4;22;16;10;72
"5301";"360810655011";1;7;10;5;2;25
"5302";"360810656001";25;7;55;37;17;141
"5303";"360810656002";17;2;4;9;12;44
"5304";"360810656003";41;6;64;41;16;168
"5305";"360810657021";32;8;84;26;19;169
"5306";"360810657031";4;4;61;12;20;101
"5307";"360810657032";4;4;35;14;15;72
"5308";"360810657033";7;0;41;9;17;74
"5309";"360810659001";11;0;22;18;9;60
"5310";"360810659002";11;5;61;15;7;99
"5311";"360810660001";24;3;13;11;16;67
"5312";"360810660002";32;6;18;18;32;106
"5313";"360810661001";6;3;44;19;13;85
"5314";"360810663001";3;2;59;10;12;86
"5315";"360810663002";0;1;32;17;26;76
"5316";"360810663003";6;0;10;10;14;40
"5317";"360810664001";2;1;6;1;2;12
"5318";"360810664002";12;2;17;34;10;75
"5319";"360810664003";11;2;14;11;8;46
"5320";"360810664004";12;1;15;17;5;50
"5321";"360810664005";45;1;12;13;15;86
"5322";"360810664006";67;3;28;20;20;138
"5323";"360810664007";39;0;36;10;16;101
"5324";"360810664008";28;5;32;6;8;79
"5325";"360810665011";23;2;27;12;5;69
"5326";"360810665012";4;11;30;17;6;68
"5327";"360810665013";1;0;29;13;8;51
"5328";"360810665014";3;0;17;14;20;54
"5329";"360810667011";29;3;53;23;22;130
"5330";"360810667012";4;2;62;24;9;101
"5331";"360810669001";9;1;14;5;21;50
"5332";"360810669002";12;0;121;7;14;154
"5333";"360810671001";6;1;18;17;9;51
"5334";"360810671002";7;2;41;32;8;90
"5335";"360810677001";29;1;16;13;8;67
"5336";"360810677002";11;8;21;14;9;63
"5337";"360810679001";5;2;40;5;2;54
"5338";"360810679002";66;2;13;5;10;96
"5339";"360810679003";35;7;82;25;20;169
"5340";"360810680001";2;0;7;12;17;38
"5341";"360810680002";29;3;31;28;11;102
"5342";"360810680003";18;3;15;27;17;80
"5343";"360810680004";14;1;24;14;16;69
"5344";"360810682001";11;5;16;12;5;49
"5345";"360810682002";2;0;6;10;13;31
"5346";"360810683001";27;3;23;0;3;56
"5347";"360810683002";45;2;26;5;1;79
"5348";"360810683003";7;0;24;6;2;39
"5349";"360810687001";25;2;4;0;1;32
"5350";"360810687002";29;4;103;1;16;153
"5351";"360810687003";22;0;144;13;11;190
"5352";"360810690001";42;7;33;26;28;136
"5353";"360810690002";37;0;34;31;52;154
"5354";"360810693001";108;37;57;0;26;228
"5355";"360810693002";94;4;62;0;8;168
"5356";"360810694001";35;3;35;24;21;118
"5357";"360810694002";16;2;44;47;34;143
"5358";"360810695001";27;9;55;3;14;108
"5359";"360810695002";10;8;50;4;31;103
"5360";"360810697011";40;9;30;1;3;83
"5361";"360810697012";30;5;87;1;10;133
"5362";"360810697013";24;2;18;1;6;51
"5363";"360810697021";12;5;21;8;11;57
"5364";"360810697022";1;2;19;9;15;46
"5365";"360810697023";10;3;31;14;8;66
"5366";"360810697024";48;6;20;9;11;94
"5367";"360810703001";4;1;17;12;6;40
"5368";"360810703002";16;11;42;23;13;105
"5369";"360810707001";2;1;12;0;7;22
"5370";"360810707002";17;0;24;1;7;49
"5371";"360810707003";4;1;17;2;3;27
"5372";"360810709001";10;1;27;2;12;52
"5373";"360810709002";13;4;15;5;12;49
"5374";"360810711001";9;7;16;3;13;48
"5375";"360810711002";76;12;63;4;24;179
"5376";"360810711003";10;2;6;0;11;29
"5377";"360810711004";6;12;28;1;13;60
"5378";"360810713031";24;2;37;1;6;70
"5379";"360810713032";37;56;8;0;25;126
"5380";"360810713033";43;7;38;0;3;91
"5381";"360810713041";20;1;21;0;1;43
"5382";"360810713042";53;5;11;0;0;69
"5383";"360810713043";9;0;0;0;1;10
"5384";"360810713044";93;3;31;1;2;130
"5385";"360810713051";6;6;6;0;2;20
"5386";"360810713052";3;3;15;0;1;22
"5387";"360810713053";46;16;65;0;4;131
"5388";"360810713061";57;2;53;1;2;115
"5389";"360810713062";41;2;63;0;6;112
"5390";"360810713063";16;1;24;4;11;56
"5391";"360810713064";23;19;30;2;26;100
"5392";"360810716001";0;0;11;5;5;21
"5393";"360810717011";23;13;3;0;3;42
"5394";"360810717012";28;9;63;1;6;107
"5395";"360810717013";4;16;8;0;0;28
"5396";"360810717014";7;7;14;1;3;32
"5397";"360810717021";10;26;48;2;0;86
"5398";"360810717022";15;2;44;1;4;66
"5399";"360810719001";51;1;89;1;10;152
"5400";"360810719002";23;4;108;2;24;161
"5401";"360810721001";5;0;12;0;6;23
"5402";"360810721002";19;1;5;0;0;25
"5403";"360810721003";174;7;20;0;8;209
"5404";"360810721004";3;3;11;0;3;20
"5405";"360810721005";13;6;58;0;15;92
"5406";"360810723001";0;7;3;0;0;10
"5407";"360810723002";5;5;16;1;6;33
"5408";"360810723003";6;1;28;1;5;41
"5409";"360810729001";8;2;24;0;10;44
"5410";"360810729002";3;1;21;7;5;37
"5411";"360810731001";6;2;13;11;9;41
"5412";"360810731002";2;12;21;2;8;45
"5413";"360810737001";11;29;31;3;19;93
"5414";"360810737002";3;10;5;0;2;20
"5415";"360810739001";10;0;3;0;0;13
"5416";"360810739002";43;2;27;1;0;73
"5417";"360810739003";17;6;19;0;3;45
"5418";"360810739004";6;0;11;0;5;22
"5419";"360810739005";5;3;5;0;2;15
"5420";"360810741001";4;0;17;0;6;27
"5421";"360810741002";6;4;42;0;1;53
"5422";"360810741003";1;0;11;0;0;12
"5423";"360810741004";5;5;7;3;0;20
"5424";"360810743001";4;2;18;3;21;48
"5425";"360810743002";46;2;4;1;29;82
"5426";"360810743003";78;4;12;2;14;110
"5427";"360810743004";5;0;11;1;5;22
"5428";"360810745001";43;5;13;0;2;63
"5429";"360810745002";12;3;19;3;7;44
"5430";"360810747001";21;16;59;10;13;119
"5431";"360810747002";25;2;21;2;11;61
"5432";"360810749001";4;0;0;1;4;9
"5433";"360810749002";6;1;2;2;1;12
"5434";"360810757011";30;8;89;2;4;133
"5435";"360810757012";16;5;31;2;5;59
"5436";"360810757013";5;4;32;2;20;63
"5437";"360810757021";67;3;19;0;9;98
"5438";"360810757022";7;5;104;9;6;131
"5439";"360810757023";17;7;9;1;2;36
"5440";"360810769011";18;3;6;2;8;37
"5441";"360810769012";58;6;51;1;42;158
"5442";"360810769021";30;22;91;5;35;183
"5443";"360810773001";18;9;56;2;5;90
"5444";"360810773002";59;2;57;2;8;128
"5445";"360810775001";9;14;54;2;6;85
"5446";"360810775002";24;4;70;3;3;104
"5447";"360810775003";5;354;40;2;12;413
"5448";"360810779021";2;0;7;0;3;12
"5449";"360810779022";1;1;27;1;4;34
"5450";"360810779023";11;5;8;13;9;46
"5451";"360810779024";83;2;7;0;4;96
"5452";"360810779025";7;2;16;1;15;41
"5453";"360810779031";7;1;4;5;1;18
"5454";"360810779032";9;4;6;1;1;21
"5455";"360810779033";10;2;8;2;5;27
"5456";"360810779041";7;0;8;3;14;32
"5457";"360810779042";17;10;33;7;8;75
"5458";"360810779043";51;5;31;7;12;106
"5459";"360810779044";22;2;23;4;4;55
"5460";"360810779051";9;31;15;11;12;78
"5461";"360810779052";5;0;2;2;0;9
"5462";"360810779061";17;11;24;6;5;63
"5463";"360810779062";21;3;58;5;20;107
"5464";"360810779071";7;2;44;4;8;65
"5465";"360810779072";20;6;15;5;21;67
"5466";"360810779081";42;7;13;0;8;70
"5467";"360810779082";72;4;5;8;2;91
"5468";"360810788001";46;10;20;23;35;134
"5469";"360810788002";4;5;12;5;8;34
"5470";"360810790001";51;5;20;23;23;122
"5471";"360810790002";32;10;22;30;38;132
"5472";"360810792001";46;3;41;43;6;139
"5473";"360810792002";28;2;16;25;25;96
"5474";"360810793001";0;1;2;2;6;11
"5475";"360810797011";13;5;0;0;2;20
"5476";"360810797012";18;2;1;0;1;22
"5477";"360810797013";2;2;1;1;1;7
"5478";"360810797014";1;4;6;1;20;32
"5479";"360810797021";21;5;98;3;22;149
"5480";"360810797022";39;2;69;0;15;125
"5481";"360810797023";9;1;13;0;11;34
"5482";"360810799001";2;3;107;1;20;133
"5483";"360810799002";22;3;110;5;32;172
"5484";"360810803011";6;3;59;15;37;120
"5485";"360810803012";6;0;78;4;46;134
"5486";"360810803013";38;1;61;6;57;163
"5487";"360810803021";11;3;13;35;21;83
"5488";"360810803022";16;11;23;30;43;123
"5489";"360810803023";13;1;53;12;32;111
"5490";"360810809001";5;2;30;3;0;40
"5491";"360810809002";16;3;4;0;6;29
"5492";"360810809003";3;0;15;0;9;27
"5493";"360810809004";7;4;36;4;22;73
"5494";"360810809005";9;0;12;1;5;27
"5495";"360810809006";18;3;10;8;0;39
"5496";"360810809007";11;9;28;3;7;58
"5497";"360810814001";48;5;60;46;31;190
"5498";"360810814002";71;9;27;16;28;151
"5499";"360810814003";43;6;17;31;21;118
"5500";"360810818001";33;7;33;27;33;133
"5501";"360810818002";20;4;34;38;34;130
"5502";"360810818003";31;4;52;11;39;137
"5503";"360810837001";15;19;46;26;21;127
"5504";"360810837002";8;1;47;23;31;110
"5505";"360810837003";5;1;29;9;26;70
"5506";"360810837004";23;2;49;15;27;116
"5507";"360810838001";46;10;50;36;82;224
"5508";"360810838002";46;1;20;16;28;111
"5509";"360810838003";34;3;34;10;48;129
"5510";"360810838004";34;8;26;15;21;104
"5511";"360810840001";109;13;43;46;89;300
"5512";"360810840002";78;31;62;22;39;232
"5513";"360810840003";39;10;56;13;34;152
"5514";"360810840004";29;4;31;10;23;97
"5515";"360810840005";97;4;39;5;27;172
"5516";"360810845001";7;1;1;0;4;13
"5517";"360810845002";74;9;3;2;9;97
"5518";"360810845003";12;6;88;0;29;135
"5519";"360810846011";27;3;60;30;44;164
"5520";"360810846012";29;0;106;84;31;250
"5521";"360810846021";40;6;67;31;27;171
"5522";"360810849001";13;0;52;0;60;125
"5523";"360810849002";24;4;30;1;21;80
"5524";"360810849003";35;3;37;3;64;142
"5525";"360810849004";3;18;66;13;39;139
"5526";"360810853001";10;26;17;2;65;120
"5527";"360810853002";20;5;14;1;15;55
"5528";"360810853003";4;4;49;0;18;75
"5529";"360810853004";9;3;24;0;19;55
"5530";"360810855001";16;5;9;0;16;46
"5531";"360810855002";67;4;15;0;23;109
"5532";"360810855003";22;2;12;0;3;39
"5533";"360810855004";52;65;6;0;9;132
"5534";"360810857001";24;51;17;0;14;106
"5535";"360810857002";43;9;46;1;19;118
"5536";"360810857003";48;6;35;0;55;144
"5537";"360810859001";31;2;15;0;57;105
"5538";"360810859002";30;3;85;1;45;164
"5539";"360810859003";14;2;47;1;7;71
"5540";"360810861001";26;4;25;0;15;70
"5541";"360810861002";7;10;41;4;36;98
"5542";"360810863001";11;1;16;0;5;33
"5543";"360810863002";3;0;23;1;5;32
"5544";"360810863003";39;0;1;1;13;54
"5545";"360810863004";137;1;74;0;33;245
"5546";"360810864001";54;18;79;20;62;233
"5547";"360810864002";24;2;33;9;25;93
"5548";"360810865001";35;7;32;1;23;98
"5549";"360810865002";13;10;36;0;22;81
"5550";"360810869001";8;17;61;3;62;151
"5551";"360810869002";1;2;62;24;47;136
"5552";"360810871001";54;31;32;0;36;153
"5553";"360810871002";5;26;48;3;69;151
"5554";"360810884001";9;2;24;31;36;102
"5555";"360810884002";0;2;29;34;10;75
"5556";"360810884003";6;1;10;13;29;59
"5557";"360810884004";3;0;4;8;25;40
"5558";"360810884005";2;2;14;9;9;36
"5559";"360810884006";11;4;34;19;31;99
"5560";"360810884007";6;1;10;6;1;24
"5561";"360810884008";2;2;38;22;3;67
"5562";"360810889011";12;4;38;21;22;97
"5563";"360810889012";31;4;48;3;1;87
"5564";"360810889013";25;1;16;2;4;48
"5565";"360810889014";23;2;22;0;13;60
"5566";"360810889015";3;0;14;2;3;22
"5567";"360810889016";259;11;26;0;7;303
"5568";"360810889017";13;5;44;0;12;74
"5569";"360810892001";1;3;13;4;12;33
"5570";"360810892002";6;76;9;10;13;114
"5571";"360810892003";19;2;32;19;27;99
"5572";"360810892004";3;1;5;12;10;31
"5573";"360810892005";6;6;15;26;56;109
"5574";"360810892006";0;0;4;8;9;21
"5575";"360810892007";8;4;11;27;8;58
"5576";"360810892008";0;26;5;4;7;42
"5577";"360810907001";15;6;99;59;32;211
"5578";"360810916012";0;0;0;0;1;1
"5579";"360810916013";0;1;0;0;2;3
"5580";"360810916014";2;1;5;0;8;16
"5581";"360810916021";0;0;8;0;2;10
"5582";"360810918001";0;0;2;0;2;4
"5583";"360810919001";15;1;44;11;36;107
"5584";"360810919002";73;4;64;31;50;222
"5585";"360810919003";28;2;85;33;26;174
"5586";"360810922001";3;0;2;4;6;15
"5587";"360810922002";3;3;4;1;14;25
"5588";"360810922003";4;0;22;5;7;38
"5589";"360810925001";30;11;76;16;112;245
"5590";"360810925002";26;12;100;22;65;225
"5591";"360810925003";25;7;74;36;32;174
"5592";"360810928001";1;4;15;1;11;32
"5593";"360810928002";9;0;9;6;9;33
"5594";"360810928003";1;1;8;8;6;24
"5595";"360810929001";46;4;84;44;36;214
"5596";"360810929002";49;7;75;28;62;221
"5597";"360810929003";9;1;22;18;12;62
"5598";"360810929004";2;3;13;4;7;29
"5599";"360810934011";1;0;38;6;15;60
"5600";"360810934012";5;12;34;4;25;80
"5601";"360810934013";3;0;22;2;11;38
"5602";"360810934021";36;0;50;6;16;108
"5603";"360810934022";24;6;66;5;12;113
"5604";"360810934023";7;2;29;2;13;53
"5605";"360810938001";3;8;5;0;20;36
"5606";"360810938002";11;18;17;0;8;54
"5607";"360810938003";138;66;51;3;35;293
"5608";"360810939001";39;2;49;39;32;161
"5609";"360810939002";24;0;48;13;14;99
"5610";"360810939003";43;8;39;55;37;182
"5611";"360810942011";149;88;56;10;56;359
"5612";"360810942021";81;67;12;5;8;173
"5613";"360810942022";43;10;28;13;18;112
"5614";"360810942031";66;13;38;10;22;149
"5615";"360810942032";50;30;16;0;3;99
"5616";"360810942033";13;75;10;4;2;104
"5617";"360810942034";1;0;0;2;3;6
"5618";"360810942035";6;13;1;0;1;21
"5619";"360810945001";19;5;105;53;45;227
"5620";"360810945002";46;4;50;34;42;176
"5621";"360810947001";27;175;75;24;40;341
"5622";"360810947002";40;8;53;18;33;152
"5623";"360810954001";37;5;4;7;24;77
"5624";"360810954002";31;3;13;1;8;56
"5625";"360810954003";30;21;20;9;16;96
"5626";"360810964001";96;16;30;16;12;170
"5627";"360810964002";31;14;23;13;14;95
"5628";"360810972021";54;2;1;4;4;65
"5629";"360810972031";14;1;4;12;10;41
"5630";"360810972032";25;1;0;1;0;27
"5631";"360810972033";47;5;2;0;0;54
"5632";"360810972034";73;0;0;0;1;74
"5633";"360810972041";39;6;0;2;0;47
"5634";"360810972042";44;9;13;13;30;109
"5635";"360810972043";4;2;1;4;1;12
"5636";"360810973001";7;7;22;13;17;66
"5637";"360810973002";2;1;4;9;8;24
"5638";"360810973003";2;2;3;6;6;19
"5639";"360810981001";21;12;66;10;35;144
"5640";"360810981002";25;20;36;9;27;117
"5641";"360810987001";14;8;74;33;43;172
"5642";"360810987002";2;9;40;20;34;105
"5643";"360810991001";9;5;13;11;2;40
"5644";"360810991002";6;3;14;6;3;32
"5645";"360810991003";1;1;27;14;4;47
"5646";"360810991004";2;0;13;9;21;45
"5647";"360810991005";7;1;23;20;10;61
"5648";"360810992001";55;2;16;8;5;86
"5649";"360810992002";35;3;18;9;8;73
"5650";"360810997011";2;5;10;2;9;28
"5651";"360810997012";2;0;4;3;6;15
"5652";"360810997013";4;0;31;9;11;55
"5653";"360810997031";12;3;39;15;13;82
"5654";"360810997032";1;2;5;3;6;17
"5655";"360810997033";7;5;23;4;10;49
"5656";"360810997041";7;0;12;13;2;34
"5657";"360810997042";92;6;42;6;5;151
"5658";"360810997043";13;1;10;5;2;31
"5659";"360810997044";12;4;14;3;4;37
"5660";"360810997051";14;4;49;17;19;103
"5661";"360810998011";32;5;25;5;23;90
"5662";"360810998012";35;1;5;1;7;49
"5663";"360810998013";29;4;12;4;7;56
"5664";"360810998014";11;0;2;0;2;15
"5665";"360810998015";24;4;19;9;15;71
"5666";"360810998021";44;19;11;14;14;102
"5667";"360810998022";45;2;1;2;7;57
"5668";"360810998023";5;1;2;0;3;11
"5669";"360810999001";0;0;2;0;0;2
"5670";"360811008011";9;1;12;16;11;49
"5671";"360811008012";27;3;6;11;21;68
"5672";"360811008021";125;18;43;6;22;214
"5673";"360811008022";94;2;21;8;28;153
"5674";"360811008023";24;5;13;13;15;70
"5675";"360811008024";23;2;12;9;24;70
"5676";"360811010011";65;15;28;11;16;135
"5677";"360811010012";80;2;16;8;13;119
"5678";"360811010013";63;22;21;11;7;124
"5679";"360811010014";62;6;13;8;14;103
"5680";"360811010021";1;19;16;23;5;64
"5681";"360811010022";60;4;7;6;7;84
"5682";"360811017001";35;2;15;10;5;67
"5683";"360811017002";33;3;6;12;4;58
"5684";"360811017003";13;2;9;4;12;40
"5685";"360811017004";2;1;19;3;3;28
"5686";"360811017005";4;1;6;4;17;32
"5687";"360811017006";1;0;37;6;14;58
"5688";"360811017007";1;1;6;6;2;16
"5689";"360811029001";14;14;44;22;24;118
"5690";"360811029002";14;38;46;18;14;130
"5691";"360811032011";57;3;28;19;5;112
"5692";"360811032012";56;3;10;9;9;87
"5693";"360811032013";39;1;5;5;16;66
"5694";"360811032021";18;3;16;2;9;48
"5695";"360811032022";5;0;4;7;0;16
"5696";"360811032023";64;1;30;3;12;110
"5697";"360811032024";100;5;13;3;15;136
"5698";"360811033001";14;2;31;18;18;83
"5699";"360811033002";4;1;27;9;25;66
"5700";"360811033003";14;1;16;3;6;40
"5701";"360811033004";4;0;7;6;20;37
"5702";"360811039001";21;1;47;22;14;105
"5703";"360811039002";15;4;39;25;31;114
"5704";"360811039003";5;8;41;7;28;89
"5705";"360811039004";7;5;33;21;13;79
"5706";"360811047001";2;5;31;9;15;62
"5707";"360811047002";8;2;51;17;26;104
"5708";"360811047003";19;2;43;33;23;120
"5709";"360811047004";11;7;22;4;8;52
"5710";"360811047005";7;3;45;20;38;113
"5711";"360811059001";5;0;8;4;9;26
"5712";"360811059002";8;1;9;5;6;29
"5713";"360811059003";0;1;1;4;6;12
"5714";"360811059004";3;0;4;3;10;20
"5715";"360811072011";13;4;49;20;32;118
"5716";"360811072020";0;1;0;0;0;1
"5717";"360811072021";0;0;2;0;0;2
"5718";"360811085001";2;5;12;16;10;45
"5719";"360811085002";2;5;21;9;10;47
"5720";"360811085003";4;1;46;14;3;68
"5721";"360811093001";3;2;15;13;10;43
"5722";"360811093002";6;0;27;6;11;50
"5723";"360811093003";6;1;8;10;7;32
"5724";"360811097001";5;0;7;0;5;17
"5725";"360811097002";3;1;13;4;8;29
"5726";"360811097003";3;5;21;8;23;60
"5727";"360811099001";5;2;36;18;23;84
"5728";"360811099002";10;1;34;13;12;70
"5729";"360811099003";5;30;30;11;17;93
"5730";"360811113001";6;1;10;2;7;26
"5731";"360811113002";2;0;5;1;7;15
"5732";"360811113003";7;4;13;6;22;52
"5733";"360811123001";18;4;25;5;7;59
"5734";"360811123002";5;9;95;4;33;146
"5735";"360811129001";3;0;21;11;6;41
"5736";"360811129002";0;2;2;2;12;18
"5737";"360811129003";9;0;32;8;1;50
"5738";"360811133001";10;0;12;2;9;33
"5739";"360811133002";10;2;8;8;13;41
"5740";"360811139001";5;2;27;7;13;54
"5741";"360811139002";17;2;68;6;11;104
"5742";"360811139003";4;0;30;14;7;55
"5743";"360811141001";6;2;10;9;9;36
"5744";"360811141002";13;0;7;4;3;27
"5745";"360811147001";15;5;17;4;18;59
"5746";"360811147002";14;1;11;7;15;48
"5747";"360811151001";7;7;16;13;26;69
"5748";"360811155001";24;2;33;1;11;71
"5749";"360811155002";23;3;11;6;10;53
"5750";"360811157001";4;5;41;2;17;69
"5751";"360811157002";13;3;53;2;18;89
"5752";"360811157003";51;2;25;0;16;94
"5753";"360811159001";3;1;44;1;11;60
"5754";"360811159002";5;7;90;4;17;123
"5755";"360811159003";57;4;49;0;19;129
"5756";"360811161001";54;4;108;2;15;183
"5757";"360811161002";41;12;62;0;14;129
"5758";"360811163001";38;2;4;0;7;51
"5759";"360811163002";17;0;34;0;19;70
"5760";"360811163003";24;13;33;0;8;78
"5761";"360811163004";39;2;17;0;10;68
"5762";"360811163005";35;2;85;0;18;140
"5763";"360811167001";37;2;114;4;54;211
"5764";"360811171001";3;11;64;6;26;110
"5765";"360811171002";21;5;48;2;26;102
"5766";"360811171003";21;4;34;2;49;110
"5767";"360811175001";10;3;45;3;14;75
"5768";"360811175002";24;3;84;2;44;157
"5769";"360811175003";6;3;54;13;17;93
"5770";"360811175004";10;36;42;26;22;136
"5771";"360811181001";8;2;46;4;24;84
"5772";"360811181002";12;2;35;9;20;78
"5773";"360811185001";7;2;48;4;28;89
"5774";"360811185002";26;1;105;5;32;169
"5775";"360811187001";20;2;20;10;13;65
"5776";"360811187002";24;0;57;8;26;115
"5777";"360811189001";27;1;95;23;26;172
"5778";"360811189002";4;2;25;10;14;55
"5779";"360811191001";23;6;74;13;35;151
"5780";"360811191002";29;5;80;20;26;160
"5781";"360811193001";10;4;58;12;16;100
"5782";"360811193002";16;3;57;6;19;101
"5783";"360811195001";10;4;75;16;37;142
"5784";"360811199001";39;1;46;15;32;133
"5785";"360811201001";18;4;106;7;33;168
"5786";"360811203001";3;1;6;15;18;43
"5787";"360811203002";3;0;22;7;18;50
"5788";"360811205001";17;5;122;8;47;199
"5789";"360811207001";15;5;10;8;27;65
"5790";"360811207002";9;3;35;18;28;93
"5791";"360811211001";2;2;100;2;2;108
"5792";"360811215001";16;2;100;9;36;163
"5793";"360811215002";9;3;49;16;37;114
"5794";"360811215003";17;0;105;14;32;168
"5795";"360811223001";20;1;61;22;17;121
"5796";"360811223002";9;2;17;13;15;56
"5797";"360811223003";40;2;19;34;28;123
"5798";"360811227011";21;7;93;5;37;163
"5799";"360811227012";8;1;31;16;11;67
"5800";"360811227013";41;6;113;8;6;174
"5801";"360811227014";15;3;23;0;1;42
"5802";"360811227015";119;2;132;5;1;259
"5803";"360811227016";0;1;3;0;1;5
"5804";"360811227017";88;2;3;0;6;99
"5805";"360811227021";65;4;2;2;0;73
"5806";"360811227022";15;9;11;0;7;42
"5807";"360811227023";254;14;5;5;8;286
"5808";"360811227024";12;1;66;4;11;94
"5809";"360811227025";134;5;35;2;5;181
"5810";"360811241001";12;4;15;18;17;66
"5811";"360811241002";18;3;19;5;6;51
"5812";"360811241003";103;4;37;20;10;174
"5813";"360811247001";12;2;9;19;8;50
"5814";"360811247002";16;1;8;12;30;67
"5815";"360811247003";17;2;21;9;20;69
"5816";"360811257001";29;17;74;11;17;148
"5817";"360811257002";10;3;25;2;14;54
"5818";"360811257003";11;5;15;4;10;45
"5819";"360811265001";25;9;35;6;7;82
"5820";"360811265002";15;2;34;9;18;78
"5821";"360811267001";7;11;35;4;14;71
"5822";"360811267002";5;5;55;2;3;70
"5823";"360811267003";13;1;16;11;13;54
"5824";"360811277001";11;12;14;7;10;54
"5825";"360811277002";10;7;18;10;23;68
"5826";"360811277003";6;3;0;7;3;19
"5827";"360811277004";4;0;8;2;10;24
"5828";"360811283001";0;7;70;15;3;95
"5829";"360811291021";6;2;61;3;46;118
"5830";"360811291022";5;1;10;7;10;33
"5831";"360811291023";5;1;0;6;3;15
"5832";"360811291024";8;0;8;5;3;24
"5833";"360811291031";4;3;11;3;6;27
"5834";"360811291032";10;3;11;3;1;28
"5835";"360811291033";5;1;5;7;1;19
"5836";"360811291041";0;0;0;0;5;5
"5837";"360811291042";14;2;7;5;9;37
"5838";"360811291043";3;4;6;5;2;20
"5839";"360811291044";2;1;5;3;7;18
"5840";"360811291045";4;0;2;8;0;14
"5841";"360811301001";0;1;8;5;4;18
"5842";"360811301002";6;0;5;3;3;17
"5843";"360811301003";12;3;10;13;23;61
"5844";"360811301004";42;0;13;6;10;71
"5845";"360811333001";11;0;13;8;18;50
"5846";"360811333002";1;1;44;15;8;69
"5847";"360811333003";3;14;25;6;20;68
"5848";"360811333004";19;6;33;9;8;75
"5849";"360811339001";18;2;26;7;20;73
"5850";"360811341001";5;7;20;27;25;84
"5851";"360811341002";21;4;21;26;20;92
"5852";"360811341003";6;0;7;11;10;34
"5853";"360811347001";12;1;23;19;9;64
"5854";"360811347002";3;0;16;3;4;26
"5855";"360811347003";16;3;12;13;7;51
"5856";"360811347004";14;5;11;14;4;48
"5857";"360811347005";40;1;10;14;9;74
"5858";"360811367001";8;29;58;6;33;134
"5859";"360811367002";1;1;4;3;3;12
"5860";"360811367003";1;0;2;8;0;11
"5861";"360811367004";5;1;5;7;4;22
"5862";"360811367005";1;3;2;6;2;14
"5863";"360811377001";9;1;5;5;0;20
"5864";"360811377002";10;2;11;7;7;37
"5865";"360811377003";2;0;18;1;13;34
"5866";"360811377004";7;0;23;6;12;48
"5867";"360811385011";3;1;38;6;8;56
"5868";"360811385012";9;2;47;2;6;66
"5869";"360811385013";5;1;29;5;6;46
"5870";"360811385014";8;0;31;14;8;61
"5871";"360811385021";1;1;9;4;8;23
"5872";"360811399001";1;1;4;10;10;26
"5873";"360811399002";8;2;15;4;14;43
"5874";"360811403001";0;0;10;4;23;37
"5875";"360811403002";1;4;6;11;14;36
"5876";"360811409011";8;3;23;12;20;66
"5877";"360811409021";5;1;5;14;9;34
"5878";"360811409022";3;2;25;12;18;60
"5879";"360811417001";1;0;4;11;25;41
"5880";"360811417002";12;1;16;12;10;51
"5881";"360811417003";5;1;7;1;6;20
"5882";"360811417004";5;1;13;11;13;43
"5883";"360811417005";1;2;15;1;12;31
"5884";"360811429001";1;1;13;7;16;38
"5885";"360811429002";17;3;28;5;26;79
"5886";"360811429003";4;1;12;7;29;53
"5887";"360811429004";3;0;4;3;7;17
"5888";"360811435001";2;0;16;3;16;37
"5889";"360811435002";2;0;12;5;25;44
"5890";"360811441001";2;0;15;4;19;40
"5891";"360811441002";0;0;4;0;2;6
"5892";"360811441003";1;1;8;7;1;18
"5893";"360811441004";0;1;4;2;11;18
"5894";"360811447001";7;3;39;17;32;98
"5895";"360811447002";15;8;43;13;50;129
"5896";"360811451011";3;1;33;8;21;66
"5897";"360811451021";11;3;12;6;16;48
"5898";"360811451022";13;1;27;6;20;67
"5899";"360811459001";2;5;24;4;19;54
"5900";"360811459002";5;1;17;23;15;61
"5901";"360811459003";16;0;12;14;31;73
"5902";"360811463001";30;4;27;25;23;109
"5903";"360811463002";7;2;61;15;56;141
"5904";"360811467001";20;14;45;11;30;120
"5905";"360811467002";19;1;13;2;2;37
"5906";"360811467003";4;1;30;8;12;55
"5907";"360811471001";12;14;55;20;20;121
"5908";"360811471002";11;7;53;12;25;108
"5909";"360811479001";2;2;62;23;11;100
"5910";"360811479002";22;18;37;7;16;100
"5911";"360811479003";3;4;27;12;29;75
"5912";"360811483001";4;4;33;6;14;61
"5913";"360811483002";5;6;15;4;4;34
"5914";"360811483003";7;0;22;3;16;48
"5915";"360811483004";2;1;16;4;3;26
"5916";"360811507011";4;4;12;14;19;53
"5917";"360811507012";3;2;7;10;5;27
"5918";"360811507013";0;0;11;1;10;22
"5919";"360811507021";3;1;17;1;9;31
"5920";"360811507022";0;0;4;7;2;13
"5921";"360811507023";4;0;9;12;2;27
"5922";"360811507024";14;25;26;12;19;96
"5923";"360811529011";11;4;13;11;5;44
"5924";"360811529012";21;3;118;12;28;182
"5925";"360811529013";3;2;23;11;9;48
"5926";"360811529021";2;0;14;9;5;30
"5927";"360811529022";7;4;9;7;2;29
"5928";"360811529023";20;0;50;19;11;100
"5929";"360811529024";0;1;11;7;6;25
"5930";"360811551011";1;0;0;0;0;1
"5931";"360811551021";11;1;18;2;0;32
"5932";"360811551022";4;2;2;2;1;11
"5933";"360811551023";2;3;100;10;26;141
"5934";"360811551024";1;4;37;4;3;49
"5935";"360811551025";36;5;18;8;3;70
"5936";"360811551026";1;1;9;6;0;17
"5937";"360811567001";4;4;7;3;4;22
"5938";"360811571011";9;1;27;6;4;47
"5939";"360811571012";2;5;9;4;23;43
"5940";"360811571013";1;0;3;1;1;6
"5941";"360811571014";7;0;9;3;11;30
"5942";"360811571015";8;1;5;13;19;46
"5943";"360811571016";13;2;26;2;41;84
"5944";"360811571017";4;14;57;2;36;113
"5945";"360811571018";2;1;6;2;7;18
"5946";"360811571021";3;1;9;11;12;36
"5947";"360811571022";10;1;19;9;20;59
"5948";"360811579011";2;4;8;4;14;32
"5949";"360811579012";6;1;18;8;33;66
"5950";"360811579013";4;1;1;2;12;20
"5951";"360811579014";6;1;0;4;4;15
"5952";"360811579015";3;1;25;11;10;50
"5953";"360811579016";5;2;7;3;23;40
"5954";"360811579021";2;1;6;2;7;18
"5955";"360811579022";2;2;2;4;8;18
"5956";"360811579023";5;71;6;5;11;98
"5957";"360811579024";16;1;5;2;17;41
"5958";"360811579025";4;34;31;2;17;88
"5959";"360811579031";6;0;11;2;14;33
"5960";"360811579032";16;7;15;7;39;84
"5961";"360811579033";13;0;10;13;24;60
"5962";"360811579034";5;1;13;30;9;58
"5963";"360811617001";17;2;46;9;20;94
"5964";"360811617002";1;0;8;4;6;19
"5965";"360811617003";9;1;4;6;5;25
"5966";"360811617004";28;0;61;30;16;135
"5967";"360811621001";13;8;6;5;10;42
"5968";"360811621002";20;4;33;18;19;94
"5969";"360811621003";20;11;21;5;10;67
"5970";"360811621004";1;4;18;5;9;37
"5971";"360811621005";17;4;27;13;48;109
"5972";"360850003001";102;4;7;0;9;122
"5973";"360850003002";13;18;18;4;21;74
"5974";"360850006001";6;67;24;9;11;117
"5975";"360850006002";9;5;75;14;13;116
"5976";"360850007001";24;3;6;3;11;47
"5977";"360850007002";20;7;92;3;5;127
"5978";"360850007003";26;4;48;6;5;89
"5979";"360850007004";135;13;19;2;6;175
"5980";"360850008001";38;5;33;29;45;150
"5981";"360850008002";15;4;40;17;16;92
"5982";"360850008003";8;2;24;15;13;62
"5983";"360850009001";39;2;68;21;19;149
"5984";"360850009002";62;6;20;27;18;133
"5985";"360850011001";73;12;36;20;26;167
"5986";"360850011002";124;3;6;5;19;157
"5987";"360850011003";60;17;22;12;16;127
"5988";"360850017001";13;4;8;9;8;42
"5989";"360850017002";84;2;11;10;17;124
"5990";"360850020011";48;1;15;16;2;82
"5991";"360850020012";11;0;72;13;6;102
"5992";"360850020021";16;4;43;15;19;97
"5993";"360850020022";2;0;30;9;8;49
"5994";"360850021001";58;27;45;25;38;193
"5995";"360850021002";36;34;56;18;57;201
"5996";"360850021003";127;37;50;19;45;278
"5997";"360850027001";46;27;25;21;24;143
"5998";"360850029001";48;14;17;19;22;120
"5999";"360850029002";296;13;1;5;3;318
"6000";"360850029003";59;9;21;19;18;126
"6001";"360850029004";35;5;9;10;28;87
"6002";"360850033001";17;2;18;21;9;67
"6003";"360850033002";76;95;70;15;40;296
"6004";"360850036001";29;1;22;45;12;109
"6005";"360850036002";27;7;62;5;22;123
"6006";"360850039001";2;0;8;3;0;13
"6007";"360850039002";16;3;21;6;9;55
"6008";"360850040001";18;5;38;33;27;121
"6009";"360850040002";196;19;12;11;33;271
"6010";"360850040003";324;13;13;1;12;363
"6011";"360850040004";14;2;14;4;10;44
"6012";"360850040005";16;13;9;1;7;46
"6013";"360850040006";62;10;18;9;14;113
"6014";"360850040007";27;7;31;10;22;97
"6015";"360850047001";32;10;31;37;31;141
"6016";"360850047002";13;7;11;8;22;61
"6017";"360850050001";8;6;34;10;16;74
"6018";"360850050002";3;4;14;7;16;44
"6019";"360850050003";15;7;11;12;11;56
"6020";"360850059001";54;23;28;18;11;134
"6021";"360850059002";7;6;49;3;14;79
"6022";"360850064001";7;1;20;8;14;50
"6023";"360850064002";7;11;10;3;7;38
"6024";"360850064003";87;5;60;8;41;201
"6025";"360850067001";8;7;6;13;10;44
"6026";"360850067002";10;5;50;14;11;90
"6027";"360850067003";19;5;14;8;8;54
"6028";"360850070001";27;14;53;36;53;183
"6029";"360850070002";18;3;49;11;15;96
"6030";"360850070003";22;39;29;20;45;155
"6031";"360850070004";35;10;18;11;11;85
"6032";"360850074001";29;4;36;15;19;103
"6033";"360850074002";23;9;77;23;41;173
"6034";"360850075001";76;11;34;11;27;159
"6035";"360850075002";4;5;20;26;13;68
"6036";"360850075003";29;4;54;24;10;121
"6037";"360850077001";46;11;8;8;25;98
"6038";"360850081001";19;11;30;22;22;104
"6039";"360850081002";31;10;21;5;11;78
"6040";"360850081003";263;29;20;35;20;367
"6041";"360850096011";17;6;25;16;38;102
"6042";"360850096012";18;5;34;11;19;87
"6043";"360850096021";11;7;23;9;10;60
"6044";"360850096022";2;1;17;9;20;49
"6045";"360850096023";7;0;20;10;7;44
"6046";"360850097001";48;6;22;17;20;113
"6047";"360850097002";17;3;29;7;13;69
"6048";"360850097003";9;7;6;17;8;47
"6049";"360850105001";10;2;24;15;9;60
"6050";"360850105002";5;24;17;12;12;70
"6051";"360850105003";27;6;25;12;12;82
"6052";"360850105004";30;10;28;12;30;110
"6053";"360850105005";90;40;22;12;38;202
"6054";"360850112011";10;6;49;8;25;98
"6055";"360850112012";21;15;47;32;74;189
"6056";"360850112021";19;3;22;29;11;84
"6057";"360850112022";9;16;26;13;35;99
"6058";"360850112023";21;58;28;7;21;135
"6059";"360850112024";0;1;0;1;0;2
"6060";"360850114011";11;4;13;10;3;41
"6061";"360850114012";189;37;37;13;20;296
"6062";"360850114021";4;1;13;20;8;46
"6063";"360850114022";25;1;15;17;14;72
"6064";"360850114023";5;2;9;9;12;37
"6065";"360850121001";8;0;17;30;3;58
"6066";"360850121002";4;0;13;34;12;63
"6067";"360850121003";2;9;26;16;12;65
"6068";"360850122001";7;3;13;10;10;43
"6069";"360850122002";13;2;17;10;21;63
"6070";"360850122003";18;7;10;9;14;58
"6071";"360850122004";4;9;7;10;10;40
"6072";"360850125001";98;23;57;14;31;223
"6073";"360850125002";13;5;7;9;4;38
"6074";"360850125003";4;2;9;4;2;21
"6075";"360850128041";31;19;52;37;64;203
"6076";"360850128042";17;4;79;38;67;205
"6077";"360850128051";14;4;53;28;47;146
"6078";"360850128061";9;0;5;11;27;52
"6079";"360850128062";7;2;3;10;1;23
"6080";"360850128063";31;58;6;2;5;102
"6081";"360850128064";14;3;27;14;23;81
"6082";"360850132011";4;4;9;0;5;22
"6083";"360850132012";4;0;13;1;6;24
"6084";"360850132031";6;4;12;8;9;39
"6085";"360850132032";9;4;40;5;20;78
"6086";"360850132033";31;5;26;14;22;98
"6087";"360850132041";2;1;16;11;14;44
"6088";"360850132042";7;1;32;18;33;91
"6089";"360850132043";15;3;16;4;14;52
"6090";"360850133011";140;5;5;2;1;153
"6091";"360850133021";21;4;19;20;27;91
"6092";"360850133022";55;7;25;10;28;125
"6093";"360850133023";139;63;22;14;46;284
"6094";"360850134001";10;8;30;9;25;82
"6095";"360850134002";1;3;33;10;5;52
"6096";"360850134003";26;13;24;9;19;91
"6097";"360850138001";44;0;6;2;11;63
"6098";"360850138002";29;2;24;15;14;84
"6099";"360850138003";15;1;11;9;7;43
"6100";"360850138004";23;7;16;8;18;72
"6101";"360850138005";7;3;59;12;12;93
"6102";"360850141001";12;8;20;15;20;75
"6103";"360850141002";11;2;11;8;20;52
"6104";"360850146041";15;4;62;14;16;111
"6105";"360850146042";6;3;20;12;26;67
"6106";"360850146043";13;7;52;22;18;112
"6107";"360850146044";8;1;22;10;15;56
"6108";"360850146051";4;16;18;7;16;61
"6109";"360850146052";4;4;24;16;13;61
"6110";"360850146061";11;3;41;45;13;113
"6111";"360850146062";11;21;75;12;24;143
"6112";"360850146063";18;5;47;12;22;104
"6113";"360850146064";23;3;41;12;15;94
"6114";"360850146071";34;2;29;16;29;110
"6115";"360850146072";11;4;20;5;8;48
"6116";"360850146081";21;1;36;13;22;93
"6117";"360850146082";8;4;34;3;18;67
"6118";"360850147001";4;1;5;4;4;18
"6119";"360850147002";10;6;16;7;3;42
"6120";"360850147003";8;2;25;17;7;59
"6121";"360850151001";25;26;15;20;20;106
"6122";"360850151002";12;4;25;14;5;60
"6123";"360850151003";13;1;4;2;1;21
"6124";"360850151004";8;2;9;7;5;31
"6125";"360850151005";3;17;16;11;15;62
"6126";"360850156011";15;11;34;7;19;86
"6127";"360850156012";4;1;19;13;9;46
"6128";"360850156013";8;20;16;5;18;67
"6129";"360850156014";8;0;13;9;4;34
"6130";"360850156015";2;1;0;1;7;11
"6131";"360850156016";11;0;16;5;9;41
"6132";"360850156021";7;1;12;0;6;26
"6133";"360850156022";2;1;11;3;14;31
"6134";"360850156023";9;0;10;4;3;26
"6135";"360850156024";2;1;72;16;6;97
"6136";"360850156031";2;9;19;8;14;52
"6137";"360850156032";10;6;24;16;43;99
"6138";"360850156033";10;31;55;27;22;145
"6139";"360850169011";1;2;21;19;16;59
"6140";"360850169012";15;15;38;23;29;120
"6141";"360850170051";4;29;19;7;42;101
"6142";"360850170052";7;6;27;15;31;86
"6143";"360850170071";6;1;94;12;12;125
"6144";"360850170072";45;3;42;2;22;114
"6145";"360850170081";6;5;103;13;26;153
"6146";"360850170082";24;20;116;11;28;199
"6147";"360850170083";26;3;76;17;35;157
"6148";"360850170091";9;2;5;11;14;41
"6149";"360850170092";3;12;8;16;8;47
"6150";"360850170093";6;2;8;15;20;51
"6151";"360850170101";6;7;56;20;22;111
"6152";"360850170102";12;7;118;25;8;170
"6153";"360850170103";45;12;71;38;13;179
"6154";"360850170104";8;1;64;17;38;128
"6155";"360850170111";6;4;55;15;12;92
"6156";"360850170112";15;6;33;20;28;102
"6157";"360850170121";10;5;61;13;70;159
"6158";"360850170122";9;1;22;13;16;61
"6159";"360850170123";4;5;87;13;19;128
"6160";"360850173001";16;2;18;11;14;61
"6161";"360850173002";54;3;3;0;4;64
"6162";"360850176001";11;1;16;6;9;43
"6163";"360850176002";7;0;3;7;11;28
"6164";"360850176003";8;2;13;11;15;49
"6165";"360850176004";3;0;6;7;23;39
"6166";"360850177001";1;0;6;14;6;27
"6167";"360850177002";12;1;16;15;8;52
"6168";"360850177003";24;3;7;9;35;78
"6169";"360850177004";6;2;25;4;16;53
"6170";"360850177005";5;1;19;4;13;42
"6171";"360850177006";2;0;0;1;2;5
"6172";"360850181001";2;6;17;2;2;29
"6173";"360850181002";11;8;26;11;23;79
"6174";"360850181003";8;5;7;2;4;26
"6175";"360850187011";4;12;61;15;29;121
"6176";"360850187012";11;1;17;12;16;57
"6177";"360850187021";8;1;9;10;15;43
"6178";"360850187022";14;0;33;10;14;71
"6179";"360850187023";11;7;34;11;11;74
"6180";"360850187024";22;11;32;9;17;91
"6181";"360850189011";71;34;21;49;27;202
"6182";"360850189012";23;4;90;37;30;184
"6183";"360850189021";12;1;32;5;10;60
"6184";"360850189022";12;2;25;12;19;70
"6185";"360850189023";29;2;19;6;11;67
"6186";"360850197001";6;9;11;7;4;37
"6187";"360850197002";25;1;15;7;1;49
"6188";"360850198001";0;2;2;2;4;10
"6189";"360850198002";25;2;55;19;26;127
"6190";"360850198003";5;2;11;7;9;34
"6191";"360850198004";13;5;37;4;21;80
"6192";"360850201001";26;4;11;11;26;78
"6193";"360850201002";3;11;16;9;5;44
"6194";"360850201003";0;13;77;6;10;106
"6195";"360850207001";62;23;22;16;47;170
"6196";"360850207002";36;54;12;9;33;144
"6197";"360850207003";32;4;17;10;27;90
"6198";"360850207004";129;11;21;27;41;229
"6199";"360850208011";5;6;88;15;25;139
"6200";"360850208012";19;1;42;11;9;82
"6201";"360850208013";11;2;46;18;33;110
"6202";"360850208014";21;5;57;27;23;133
"6203";"360850208031";9;4;88;9;29;139
"6204";"360850208032";49;4;38;29;40;160
"6205";"360850208033";20;0;34;10;16;80
"6206";"360850208041";8;2;20;5;23;58
"6207";"360850208042";6;0;12;9;14;41
"6208";"360850208043";5;3;22;9;19;58
"6209";"360850213001";124;17;24;27;28;220
"6210";"360850213002";28;9;8;6;10;61
"6211";"360850213003";59;3;48;26;56;192
"6212";"360850213004";23;6;9;9;12;59
"6213";"360850213005";18;5;13;6;13;55
"6214";"360850223001";57;9;23;34;35;158
"6215";"360850223002";32;14;66;52;51;215
"6216";"360850226001";38;40;53;10;36;177
"6217";"360850226002";19;1;22;16;17;75
"6218";"360850226003";18;1;45;10;28;102
"6219";"360850226004";34;42;38;13;28;155
"6220";"360850228001";7;9;38;11;14;79
"6221";"360850231001";43;10;63;36;33;185
"6222";"360850231002";5;2;16;3;14;40
"6223";"360850239001";33;18;39;28;35;153
"6224";"360850239002";26;3;28;16;40;113
"6225";"360850244011";22;3;20;6;25;76
"6226";"360850244012";23;10;36;3;22;94
"6227";"360850244013";27;9;89;8;48;181
"6228";"360850244021";13;5;10;8;17;53
"6229";"360850244022";27;25;15;11;50;128
"6230";"360850247001";63;5;38;12;5;123
"6231";"360850247002";16;5;19;22;45;107
"6232";"360850248001";23;6;27;13;25;94
"6233";"360850248002";4;16;16;9;17;62
"6234";"360850248003";11;127;38;4;47;227
"6235";"360850251001";27;8;35;8;20;98
"6236";"360850251002";4;3;7;7;5;26
"6237";"360850251003";14;1;10;12;19;56
"6238";"360850273011";6;0;26;9;5;46
"6239";"360850273012";17;6;64;28;52;167
"6240";"360850273021";14;3;62;17;24;120
"6241";"360850273022";0;1;135;17;29;182
"6242";"360850277021";5;1;28;5;18;57
"6243";"360850277022";13;1;35;11;3;63
"6244";"360850277023";42;4;55;21;12;134
"6245";"360850277041";16;1;61;3;21;102
"6246";"360850277042";15;5;39;10;47;116
"6247";"360850277051";13;3;103;20;47;186
"6248";"360850277052";26;1;30;21;13;91
"6249";"360850277053";9;4;44;10;32;99
"6250";"360850277061";8;2;23;0;7;40
"6251";"360850277062";8;1;12;3;19;43
"6252";"360850277063";4;1;14;5;11;35
"6253";"360850279001";30;0;19;9;7;65
"6254";"360850279002";8;1;19;7;19;54
"6255";"360850291021";23;5;59;22;25;134
"6256";"360850291022";19;19;84;26;49;197
"6257";"360850291031";31;7;35;19;60;152
"6258";"360850291032";0;0;6;1;4;11
"6259";"360850291033";23;3;24;26;17;93
"6260";"360850291034";16;3;6;5;8;38
"6261";"360850291035";17;3;19;15;15;69
"6262";"360850291041";4;2;57;19;31;113
"6263";"360850291042";8;1;16;17;23;65
"6264";"360850291043";19;4;80;6;18;127
"6265";"360850291044";30;18;41;23;63;175
"6266";"360850303011";125;6;156;28;37;352
"6267";"360850303012";12;5;16;6;21;60
"6268";"360850303021";24;5;57;22;20;128
"6269";"360850303022";27;2;86;21;54;190
"6270";"360850303023";17;3;23;25;8;76
"6271";"360850303024";23;11;18;11;14;77
"6272";"360850319011";63;24;13;4;13;117
"6273";"360850319012";12;31;3;9;19;74
"6274";"360850319021";33;4;6;17;2;62
"6275";"360850319022";32;12;14;19;27;104
"6276";"360850319023";33;8;40;25;28;134
"6277";"360850323001";22;51;22;18;22;135
"6278";"361190015031";0;0;10;3;4;17
"6279";"361190026001";0;0;1;0;0;1
"6280";"361190026002";0;0;1;0;0;1
"6281";"361190026003";6;1;5;5;1;18
"6282";"361190029002";1;0;2;0;0;3
