"";"Data";"0";"1";"3";"4";"5";"sum"
"1";"360050002001";38;9;40;23;35;145
"2";"360050002002";58;9;47;28;34;176
"3";"360050002003";26;5;16;29;31;107
"4";"360050004001";6;3;15;19;36;79
"5";"360050004002";59;25;40;40;52;216
"6";"360050004003";18;26;22;7;17;90
"7";"360050004004";18;4;8;10;3;43
"8";"360050016001";24;6;2;2;5;39
"9";"360050016002";9;5;22;23;14;73
"10";"360050016003";4;2;2;0;2;10
"11";"360050016004";24;10;64;38;26;162
"12";"360050019001";23;10;54;18;37;142
"13";"360050019002";0;0;2;6;8;16
"14";"360050019003";25;13;56;28;48;170
"15";"360050019004";1;2;4;6;10;23
"16";"360050020001";16;7;59;13;31;126
"17";"360050020002";47;21;36;23;18;145
"18";"360050020003";70;3;0;10;0;83
"19";"360050020004";18;3;1;1;2;25
"20";"360050020005";28;0;1;0;0;29
"21";"360050020006";17;12;18;8;10;65
"22";"360050023001";174;0;1;0;4;179
"23";"360050023002";10;1;4;0;2;17
"24";"360050023003";22;1;0;0;1;24
"25";"360050024001";9;11;4;1;1;26
"26";"360050025001";115;33;0;0;16;164
"27";"360050025002";47;5;2;0;1;55
"28";"360050025003";29;3;1;0;15;48
"29";"360050025004";28;1;4;0;4;37
"30";"360050025005";9;13;10;0;3;35
"31";"360050027011";29;1;3;1;5;39
"32";"360050027012";49;8;2;0;6;65
"33";"360050027021";50;6;11;9;11;87
"34";"360050027022";3;17;1;0;3;24
"35";"360050027023";17;11;10;0;7;45
"36";"360050027024";26;3;2;0;4;35
"37";"360050028001";10;4;25;6;14;59
"38";"360050028002";10;7;1;2;1;21
"39";"360050028003";10;0;3;1;1;15
"40";"360050028004";12;6;5;0;0;23
"41";"360050031001";46;39;20;5;52;162
"42";"360050033001";6;8;24;3;15;56
"43";"360050033002";36;2;3;0;6;47
"44";"360050033003";20;8;8;1;7;44
"45";"360050035001";55;5;32;6;23;121
"46";"360050035002";62;10;1;2;2;77
"47";"360050035003";34;11;10;2;23;80
"48";"360050037001";4;16;3;0;3;26
"49";"360050038001";87;3;20;32;10;152
"50";"360050039001";15;6;19;0;2;42
"51";"360050039002";25;5;10;2;41;83
"52";"360050039003";17;8;5;3;20;53
"53";"360050039004";29;4;24;0;15;72
"54";"360050039005";59;6;12;1;21;99
"55";"360050040011";12;12;36;9;34;103
"56";"360050041001";18;2;2;0;13;35
"57";"360050041002";51;17;8;3;34;113
"58";"360050041003";1;8;1;0;1;11
"59";"360050041004";37;17;5;0;5;64
"60";"360050042001";1;2;2;0;1;6
"61";"360050042002";115;10;1;0;2;128
"62";"360050042003";9;2;15;1;4;31
"63";"360050042004";1;0;1;1;0;3
"64";"360050042005";6;2;4;5;6;23
"65";"360050042006";0;2;3;3;4;12
"66";"360050042007";12;0;0;0;0;12
"67";"360050043001";31;19;15;4;41;110
"68";"360050043002";19;7;9;2;36;73
"69";"360050043003";36;6;9;0;7;58
"70";"360050043004";13;6;4;4;7;34
"71";"360050044001";35;8;3;3;1;50
"72";"360050044002";14;3;0;0;3;20
"73";"360050044003";52;3;24;3;17;99
"74";"360050044004";31;5;5;0;2;43
"75";"360050046001";75;13;6;5;26;125
"76";"360050048001";591;27;1;1;20;640
"77";"360050048002";48;36;72;1;34;191
"78";"360050050011";42;41;39;0;19;141
"79";"360050050012";105;3;17;0;12;137
"80";"360050050013";52;3;6;0;9;70
"81";"360050050014";38;2;12;0;12;64
"82";"360050050021";64;13;4;1;26;108
"83";"360050050022";20;15;13;1;18;67
"84";"360050050023";18;17;5;0;20;60
"85";"360050050024";29;7;8;0;20;64
"86";"360050051001";8;20;33;10;15;86
"87";"360050051002";327;8;34;4;30;403
"88";"360050051003";29;3;5;0;2;39
"89";"360050052001";21;6;20;7;38;92
"90";"360050052002";61;8;2;1;10;82
"91";"360050053001";97;1;4;0;9;111
"92";"360050054001";20;9;29;0;46;104
"93";"360050054002";104;17;25;2;50;198
"94";"360050054003";30;160;39;12;37;278
"95";"360050054004";38;7;7;0;27;79
"96";"360050056001";55;2;7;0;5;69
"97";"360050056002";8;1;8;2;25;44
"98";"360050056003";25;12;38;10;27;112
"99";"360050059021";53;79;7;0;10;149
"100";"360050059022";1;4;7;2;2;16
"101";"360050060001";56;20;25;8;28;137
"102";"360050061001";2;1;3;0;1;7
"103";"360050061002";54;4;8;1;6;73
"104";"360050061003";2;17;8;5;3;35
"105";"360050062001";24;5;29;0;27;85
"106";"360050062002";114;4;6;1;7;132
"107";"360050062003";130;5;23;2;3;163
"108";"360050062004";53;8;1;0;32;94
"109";"360050062005";4;1;9;0;6;20
"110";"360050063001";44;25;8;1;11;89
"111";"360050063002";23;31;40;10;44;148
"112";"360050063003";31;28;9;1;24;93
"113";"360050063004";5;7;0;0;22;34
"114";"360050063005";60;6;7;0;16;89
"115";"360050063006";252;79;11;5;54;401
"116";"360050064001";38;3;35;3;65;144
"117";"360050064002";25;2;1;1;9;38
"118";"360050064003";5;1;10;0;7;23
"119";"360050064004";31;7;17;2;20;77
"120";"360050065001";118;9;7;0;26;160
"121";"360050065002";71;13;13;1;10;108
"122";"360050065003";52;7;5;5;26;95
"123";"360050065004";23;6;10;3;23;65
"124";"360050067001";49;11;21;3;33;117
"125";"360050067002";166;38;12;1;4;221
"126";"360050067003";33;20;0;1;0;54
"127";"360050067004";57;4;1;0;2;64
"128";"360050067005";21;14;0;0;5;40
"129";"360050067006";14;7;11;1;14;47
"130";"360050068001";39;12;17;2;10;80
"131";"360050068002";41;8;8;1;38;96
"132";"360050068003";45;16;28;4;19;112
"133";"360050069001";69;31;20;2;33;155
"134";"360050069002";92;9;46;4;32;183
"135";"360050069003";36;0;2;0;0;38
"136";"360050069004";32;0;0;0;1;33
"137";"360050070001";102;11;62;5;52;232
"138";"360050070002";157;71;6;2;48;284
"139";"360050070003";55;29;37;0;50;171
"140";"360050071001";11;11;29;1;16;68
"141";"360050071002";219;11;12;2;47;291
"142";"360050072001";57;7;39;2;32;137
"143";"360050072002";59;9;35;1;45;149
"144";"360050072003";45;31;19;3;37;135
"145";"360050072004";25;0;33;0;10;68
"146";"360050073001";64;16;2;2;17;101
"147";"360050073002";89;4;5;1;19;118
"148";"360050073003";35;8;7;1;6;57
"149";"360050074001";12;2;22;22;5;63
"150";"360050074002";57;19;11;23;22;132
"151";"360050074003";126;3;2;2;2;135
"152";"360050075001";26;4;47;5;23;105
"153";"360050075002";38;16;22;10;17;103
"154";"360050075003";162;2;2;0;5;171
"155";"360050075004";9;0;1;1;5;16
"156";"360050076001";5;3;3;1;6;18
"157";"360050076002";72;8;13;4;33;130
"158";"360050076003";6;1;9;1;13;30
"159";"360050076004";46;6;30;2;57;141
"160";"360050076005";15;5;21;3;44;88
"161";"360050077001";48;11;59;7;56;181
"162";"360050078001";26;3;31;2;32;94
"163";"360050078002";41;22;71;14;64;212
"164";"360050078003";21;20;9;1;15;66
"165";"360050078004";42;1;3;1;16;63
"166";"360050079001";30;13;7;2;56;108
"167";"360050079002";9;4;2;0;12;27
"168";"360050079003";23;4;0;4;13;44
"169";"360050079004";47;6;4;1;6;64
"170";"360050079005";15;3;3;0;0;21
"171";"360050079006";21;0;0;0;3;24
"172";"360050083001";24;3;7;0;52;86
"173";"360050083002";10;4;4;1;6;25
"174";"360050083003";45;8;5;0;3;61
"175";"360050083004";30;10;21;0;23;84
"176";"360050083005";17;22;5;4;13;61
"177";"360050083006";22;3;7;2;9;43
"178";"360050084001";21;2;16;7;6;52
"179";"360050084002";30;5;47;27;10;119
"180";"360050085001";22;5;14;2;18;61
"181";"360050085002";56;7;38;2;23;126
"182";"360050085003";9;3;8;2;15;37
"183";"360050085004";14;2;3;1;5;25
"184";"360050085005";56;8;1;0;5;70
"185";"360050086001";8;2;4;7;6;27
"186";"360050086002";22;5;2;4;0;33
"187";"360050086003";161;2;3;1;3;170
"188";"360050087001";19;13;4;3;17;56
"189";"360050087002";63;6;7;0;12;88
"190";"360050087003";20;8;18;1;7;54
"191";"360050087004";17;6;5;0;5;33
"192";"360050087005";52;3;6;0;9;70
"193";"360050089001";25;15;7;0;16;63
"194";"360050089002";53;5;7;1;4;70
"195";"360050090001";3;0;5;1;7;16
"196";"360050090002";4;4;16;9;3;36
"197";"360050090003";142;0;1;4;5;152
"198";"360050090004";11;2;42;22;27;104
"199";"360050090005";28;0;2;1;1;32
"200";"360050092001";28;4;20;0;32;84
"201";"360050092002";79;7;42;4;11;143
"202";"360050092003";46;15;53;7;63;184
"203";"360050092004";5;15;24;3;29;76
"204";"360050092005";69;3;39;5;6;122
"205";"360050093001";7;1;37;5;30;80
"206";"360050093002";62;14;17;1;32;126
"207";"360050093003";69;26;9;1;27;132
"208";"360050093004";165;38;11;3;24;241
"209";"360050093005";21;14;32;6;28;101
"210";"360050093006";4;11;28;27;34;104
"211";"360050096001";60;36;64;3;41;204
"212";"360050096002";13;27;43;29;55;167
"213";"360050098001";19;28;22;2;19;90
"214";"360050098002";5;7;24;4;10;50
"215";"360050098003";16;5;13;4;30;68
"216";"360050098004";11;3;17;3;12;46
"217";"360050098005";28;7;3;2;4;44
"218";"360050110001";18;4;8;6;13;49
"219";"360050115021";49;7;20;11;75;162
"220";"360050115022";133;14;34;0;34;215
"221";"360050115023";31;3;13;1;25;73
"222";"360050117001";59;12;8;1;31;111
"223";"360050117002";0;0;3;1;11;15
"224";"360050118001";1;1;16;9;32;59
"225";"360050118002";5;7;17;9;19;57
"226";"360050118003";40;13;29;20;20;122
"227";"360050119001";31;14;6;0;52;103
"228";"360050119002";24;5;8;0;10;47
"229";"360050119003";20;1;6;0;11;38
"230";"360050119004";24;7;1;3;4;39
"231";"360050119005";134;4;3;6;18;165
"232";"360050121011";61;18;13;7;16;115
"233";"360050121012";56;34;38;4;31;163
"234";"360050121021";50;23;15;4;57;149
"235";"360050123001";275;6;14;1;56;352
"236";"360050123002";18;1;31;2;21;73
"237";"360050123003";24;17;12;29;5;87
"238";"360050125001";111;14;48;3;87;263
"239";"360050125002";31;22;25;4;19;101
"240";"360050127011";37;2;4;0;31;74
"241";"360050127012";15;3;10;6;22;56
"242";"360050129011";14;21;18;10;75;138
"243";"360050129012";224;16;11;3;45;299
"244";"360050130001";1;2;55;6;16;80
"245";"360050131001";25;6;6;1;16;54
"246";"360050131002";35;14;30;7;50;136
"247";"360050131003";55;19;33;3;28;138
"248";"360050132001";44;5;26;4;16;95
"249";"360050132002";103;4;6;12;6;131
"250";"360050132003";23;2;21;19;31;96
"251";"360050132004";50;61;35;38;34;218
"252";"360050132005";15;11;25;7;18;76
"253";"360050133001";53;6;2;1;1;63
"254";"360050133002";21;7;13;0;24;65
"255";"360050133003";12;2;1;0;0;15
"256";"360050133004";82;3;2;0;2;89
"257";"360050135001";58;9;11;0;25;103
"258";"360050135002";50;3;1;0;0;54
"259";"360050135003";71;12;60;1;36;180
"260";"360050138001";6;1;27;18;17;69
"261";"360050138002";85;8;26;14;19;152
"262";"360050141001";31;14;6;3;21;75
"263";"360050141002";32;9;3;0;17;61
"264";"360050141003";63;19;13;2;21;118
"265";"360050143001";140;5;27;5;26;203
"266";"360050144001";10;1;1;0;3;15
"267";"360050144002";11;0;1;0;1;13
"268";"360050144003";56;5;1;1;2;65
"269";"360050144004";25;1;1;0;0;27
"270";"360050144005";120;10;34;7;15;186
"271";"360050144006";59;7;47;11;13;137
"272";"360050145001";118;5;6;1;11;141
"273";"360050145002";23;8;0;0;1;32
"274";"360050145003";19;12;10;6;11;58
"275";"360050145004";41;3;14;18;44;120
"276";"360050147011";112;1;3;0;2;118
"277";"360050147012";25;0;10;2;3;40
"278";"360050147013";190;2;4;0;1;197
"279";"360050147021";45;0;0;1;0;46
"280";"360050147022";60;7;6;2;9;84
"281";"360050147023";242;0;1;0;1;244
"282";"360050147024";50;1;0;0;3;54
"283";"360050149001";34;3;36;4;20;97
"284";"360050149002";26;9;30;1;19;85
"285";"360050149003";147;3;7;0;22;179
"286";"360050151001";31;18;7;0;23;79
"287";"360050151002";16;155;5;3;11;190
"288";"360050151003";36;7;37;0;23;103
"289";"360050151004";49;8;14;5;54;130
"290";"360050152001";7;5;35;21;31;99
"291";"360050152002";10;28;26;29;53;146
"292";"360050153001";61;292;30;15;21;419
"293";"360050153002";34;265;4;0;8;311
"294";"360050153003";25;12;44;2;17;100
"295";"360050155001";23;7;6;1;14;51
"296";"360050155002";18;4;12;3;23;60
"297";"360050157001";53;7;45;7;26;138
"298";"360050157002";50;9;11;5;28;103
"299";"360050157003";51;5;30;4;25;115
"300";"360050158001";20;84;52;30;25;211
"301";"360050159001";40;5;1;0;30;76
"302";"360050159002";139;5;6;1;20;171
"303";"360050160001";14;2;29;15;42;102
"304";"360050160002";0;0;25;9;6;40
"305";"360050160003";0;1;16;14;7;38
"306";"360050160004";1;2;22;6;12;43
"307";"360050161001";33;16;8;6;17;80
"308";"360050161002";78;13;24;1;17;133
"309";"360050161003";43;3;4;1;3;54
"310";"360050161004";48;14;3;0;10;75
"311";"360050162001";8;5;16;1;8;38
"312";"360050162002";0;2;50;13;8;73
"313";"360050163001";3;0;3;4;4;14
"314";"360050164001";5;8;22;5;17;57
"315";"360050165001";19;13;10;16;21;79
"316";"360050166001";34;18;61;29;25;167
"317";"360050166002";19;1;24;10;16;70
"318";"360050167001";3;5;10;3;3;24
"319";"360050167002";27;8;24;42;30;131
"320";"360050169001";16;7;20;5;12;60
"321";"360050171001";107;4;15;3;12;141
"322";"360050173001";71;14;16;2;9;112
"323";"360050173002";13;3;13;0;14;43
"324";"360050173003";53;8;11;9;20;101
"325";"360050173004";32;8;11;5;3;59
"326";"360050175001";29;5;6;1;13;54
"327";"360050175002";34;6;0;1;8;49
"328";"360050175003";28;8;0;0;3;39
"329";"360050175004";229;13;9;0;14;265
"330";"360050175005";12;3;1;0;2;18
"331";"360050175006";18;1;4;0;1;24
"332";"360050177011";59;14;33;4;26;136
"333";"360050177012";56;5;2;0;33;96
"334";"360050177013";62;2;11;3;16;94
"335";"360050177021";28;3;19;5;7;62
"336";"360050177022";30;9;41;3;47;130
"337";"360050177023";62;7;56;6;25;156
"338";"360050177024";54;5;1;1;4;65
"339";"360050179011";220;137;7;3;27;394
"340";"360050179012";51;4;0;0;1;56
"341";"360050179013";49;8;0;0;15;72
"342";"360050179021";43;6;11;0;10;70
"343";"360050179022";74;20;4;0;1;99
"344";"360050179023";28;23;3;0;9;63
"345";"360050181011";84;20;39;0;26;169
"346";"360050181012";21;0;0;0;1;22
"347";"360050181013";15;4;9;0;11;39
"348";"360050181021";62;6;5;0;9;82
"349";"360050181022";65;11;1;0;9;86
"350";"360050181023";44;19;6;1;15;85
"351";"360050181024";283;19;2;1;11;316
"352";"360050183011";57;21;15;1;12;106
"353";"360050183012";50;10;15;0;15;90
"354";"360050183013";144;22;9;0;12;187
"355";"360050183021";87;12;14;2;13;128
"356";"360050183022";38;5;5;1;8;57
"357";"360050183023";40;12;3;1;15;71
"358";"360050184001";0;0;21;7;10;38
"359";"360050184002";18;41;34;19;51;163
"360";"360050184003";13;10;45;17;21;106
"361";"360050184004";4;18;30;3;24;79
"362";"360050185001";92;19;47;40;73;271
"363";"360050185002";24;3;20;10;11;68
"364";"360050185003";164;10;41;26;38;279
"365";"360050185004";48;4;6;1;3;62
"366";"360050185005";43;0;20;3;26;92
"367";"360050189001";71;8;26;6;17;128
"368";"360050189002";22;19;8;0;6;55
"369";"360050189003";115;10;16;2;15;158
"370";"360050189004";179;14;49;7;44;293
"371";"360050193001";127;9;11;0;19;166
"372";"360050193002";47;5;4;0;3;59
"373";"360050193003";97;1;1;1;3;103
"374";"360050193004";97;14;55;2;10;178
"375";"360050194001";33;17;74;36;71;231
"376";"360050195001";157;14;8;2;16;197
"377";"360050195002";222;49;25;2;46;344
"378";"360050195003";44;4;9;0;13;70
"379";"360050195004";31;4;2;1;2;40
"380";"360050197001";183;4;3;4;11;205
"381";"360050197002";224;8;7;2;23;264
"382";"360050197003";48;16;15;2;25;106
"383";"360050197004";30;3;1;0;11;45
"384";"360050197005";50;1;2;0;6;59
"385";"360050199001";30;8;3;2;16;59
"386";"360050199002";74;36;3;0;8;121
"387";"360050199003";6;2;12;0;8;28
"388";"360050199004";175;16;15;2;22;230
"389";"360050199005";48;10;8;0;14;80
"390";"360050199006";32;11;56;0;24;123
"391";"360050200001";43;15;13;2;64;137
"392";"360050200002";12;6;17;1;21;57
"393";"360050200003";41;4;7;3;20;75
"394";"360050200004";63;5;4;0;26;98
"395";"360050201001";162;19;21;1;6;209
"396";"360050201002";11;19;5;0;12;47
"397";"360050201003";59;9;7;0;10;85
"398";"360050202001";50;4;7;1;28;90
"399";"360050202002";61;10;16;4;76;167
"400";"360050204001";42;5;30;2;34;113
"401";"360050204002";8;1;14;3;28;54
"402";"360050204003";27;10;39;1;57;134
"403";"360050205011";96;8;6;8;13;131
"404";"360050205012";92;32;22;0;14;160
"405";"360050205013";1060;45;14;0;12;1131
"406";"360050205014";35;9;40;2;10;96
"407";"360050205021";14;2;6;1;12;35
"408";"360050205022";19;5;46;2;4;76
"409";"360050205023";26;11;33;1;21;92
"410";"360050206011";44;0;38;4;79;165
"411";"360050206012";25;4;64;3;46;142
"412";"360050209001";15;33;12;6;7;73
"413";"360050209002";21;11;4;1;11;48
"414";"360050209003";28;10;5;2;5;50
"415";"360050209004";113;22;21;2;15;173
"416";"360050210011";2;2;7;0;0;11
"417";"360050210012";8;2;1;0;0;11
"418";"360050210013";10;1;0;0;0;11
"419";"360050210014";3;0;5;0;7;15
"420";"360050210015";16;2;6;0;1;25
"421";"360050210016";3;0;4;1;2;10
"422";"360050210021";5;1;0;3;0;9
"423";"360050210022";48;1;8;2;0;59
"424";"360050210025";7;1;4;0;0;12
"425";"360050210026";1;2;1;0;0;4
"426";"360050210027";2;0;1;0;0;3
"427";"360050210028";1;0;0;0;0;1
"428";"360050211001";55;5;30;2;5;97
"429";"360050211002";22;17;15;1;20;75
"430";"360050211003";34;8;21;2;15;80
"431";"360050211004";25;1;0;0;5;31
"432";"360050212001";1;0;1;0;0;2
"433";"360050212002";11;1;1;0;1;14
"434";"360050212004";9;6;4;0;0;19
"435";"360050212005";2;1;0;0;0;3
"436";"360050213011";5;1;3;0;1;10
"437";"360050213012";7;0;10;0;10;27
"438";"360050213021";104;17;61;6;27;215
"439";"360050213022";43;1;24;2;8;78
"440";"360050213023";12;0;7;1;2;22
"441";"360050213024";26;4;23;0;8;61
"442";"360050215011";13;7;3;0;18;41
"443";"360050215012";27;8;12;1;5;53
"444";"360050215013";56;1;22;0;5;84
"445";"360050215021";88;8;11;0;8;115
"446";"360050215022";110;6;10;2;18;146
"447";"360050215023";42;12;42;0;18;114
"448";"360050215024";10;12;10;0;19;51
"449";"360050215025";18;1;8;1;6;34
"450";"360050216011";63;17;34;2;27;143
"451";"360050216012";36;12;53;3;33;137
"452";"360050216013";11;3;0;0;19;33
"453";"360050216014";32;2;28;2;6;70
"454";"360050216021";17;3;12;0;25;57
"455";"360050216022";2;3;5;0;0;10
"456";"360050216023";183;2;6;0;1;192
"457";"360050216024";27;5;4;1;5;42
"458";"360050216025";678;16;21;1;7;723
"459";"360050217001";97;29;28;2;25;181
"460";"360050217002";205;9;1;0;12;227
"461";"360050217003";2;13;10;5;8;38
"462";"360050217004";249;39;23;0;7;318
"463";"360050218001";138;17;3;7;6;171
"464";"360050218002";1252;12;25;2;8;1299
"465";"360050218003";53;28;60;3;37;181
"466";"360050218004";56;4;12;20;11;103
"467";"360050218005";11;4;9;8;15;47
"468";"360050219001";88;172;59;21;43;383
"469";"360050220001";78;13;24;5;45;165
"470";"360050221011";190;12;3;3;4;212
"471";"360050221012";67;18;2;2;13;102
"472";"360050221013";66;13;12;3;9;103
"473";"360050221021";80;15;3;1;36;135
"474";"360050221022";43;8;1;0;7;59
"475";"360050221023";308;6;5;1;7;327
"476";"360050222001";38;5;40;4;38;125
"477";"360050222002";12;10;14;1;19;56
"478";"360050222003";47;17;36;3;36;139
"479";"360050222004";13;3;14;1;23;54
"480";"360050223001";48;53;5;0;16;122
"481";"360050223002";21;12;3;0;12;48
"482";"360050223003";47;48;1;3;12;111
"483";"360050223004";173;29;1;0;13;216
"484";"360050224011";36;2;2;0;5;45
"485";"360050224012";103;5;9;4;38;159
"486";"360050224031";631;22;2;2;29;686
"487";"360050224032";85;9;8;1;52;155
"488";"360050224041";16;6;3;0;25;50
"489";"360050224042";110;20;11;0;31;172
"490";"360050224043";83;6;15;0;10;114
"491";"360050225001";111;18;5;1;29;164
"492";"360050225002";29;4;12;2;9;56
"493";"360050225003";54;10;1;3;16;84
"494";"360050225004";19;9;4;1;5;38
"495";"360050225005";76;3;0;0;10;89
"496";"360050225006";63;12;1;2;3;81
"497";"360050227011";43;28;3;2;15;91
"498";"360050227012";26;12;8;1;10;57
"499";"360050227013";145;24;27;8;16;220
"500";"360050227021";71;39;25;1;19;155
"501";"360050227031";36;15;18;0;6;75
"502";"360050228001";32;7;69;5;32;145
"503";"360050228002";73;6;16;1;13;109
"504";"360050228003";117;14;7;0;26;164
"505";"360050228004";119;17;1;0;5;142
"506";"360050229011";470;32;8;1;12;523
"507";"360050229012";79;24;8;0;25;136
"508";"360050229013";72;26;3;2;8;111
"509";"360050229014";30;6;31;0;5;72
"510";"360050229015";109;55;15;0;18;197
"511";"360050229021";103;20;9;2;10;144
"512";"360050229022";13;6;21;1;21;62
"513";"360050229023";85;9;9;0;10;113
"514";"360050230001";93;21;45;2;54;215
"515";"360050230002";60;12;70;1;35;178
"516";"360050231001";44;22;43;4;43;156
"517";"360050232001";36;6;52;4;64;162
"518";"360050232002";140;46;48;4;49;287
"519";"360050233011";20;4;7;2;23;56
"520";"360050233012";168;83;7;0;28;286
"521";"360050233013";28;7;13;1;21;70
"522";"360050233014";39;4;5;1;5;54
"523";"360050233021";58;28;3;2;24;115
"524";"360050233022";142;42;10;2;18;214
"525";"360050235011";107;17;7;0;23;154
"526";"360050235012";42;38;1;0;12;93
"527";"360050235013";55;26;0;0;3;84
"528";"360050235021";30;27;33;2;13;105
"529";"360050235022";39;2;10;1;11;63
"530";"360050235023";70;1;20;5;20;116
"531";"360050235024";110;5;12;0;28;155
"532";"360050236001";5;1;30;4;36;76
"533";"360050236002";17;2;24;0;51;94
"534";"360050237021";126;13;2;4;18;163
"535";"360050237031";98;8;7;1;67;181
"536";"360050237032";57;9;2;1;33;102
"537";"360050237033";45;4;18;0;14;81
"538";"360050237041";32;6;1;2;12;53
"539";"360050237042";133;9;12;4;26;184
"540";"360050237043";72;38;6;0;7;123
"541";"360050238001";1;5;22;0;17;45
"542";"360050238002";35;17;52;1;73;178
"543";"360050238003";67;26;66;5;60;224
"544";"360050239001";113;10;15;4;31;173
"545";"360050239002";94;21;8;0;20;143
"546";"360050239003";48;4;6;3;22;83
"547";"360050239004";106;15;10;4;53;188
"548";"360050239005";43;17;3;0;16;79
"549";"360050239006";136;5;4;1;13;159
"550";"360050240001";42;20;127;15;85;289
"551";"360050240002";20;3;21;4;24;72
"552";"360050240003";561;9;24;8;36;638
"553";"360050241001";37;18;7;2;15;79
"554";"360050241002";42;6;2;0;19;69
"555";"360050241003";95;15;8;0;23;141
"556";"360050241004";42;11;9;0;15;77
"557";"360050241005";26;3;2;0;12;43
"558";"360050243001";27;37;8;0;29;101
"559";"360050243002";78;24;58;2;26;188
"560";"360050243003";173;1;6;0;3;183
"561";"360050243004";83;13;49;3;27;175
"562";"360050244001";21;8;26;5;31;91
"563";"360050244002";10;4;58;31;26;129
"564";"360050245011";40;8;14;4;22;88
"565";"360050245012";23;4;13;2;22;64
"566";"360050245013";25;5;12;2;5;49
"567";"360050245014";27;4;10;5;5;51
"568";"360050245021";34;10;43;3;11;101
"569";"360050245022";8;0;0;0;17;25
"570";"360050245023";83;28;35;2;19;167
"571";"360050246001";10;11;29;9;21;80
"572";"360050246002";14;3;40;10;8;75
"573";"360050247002";27;1;12;4;2;46
"574";"360050248001";4;3;22;6;11;46
"575";"360050248002";29;3;31;16;20;99
"576";"360050248003";13;2;33;6;7;61
"577";"360050249001";43;15;20;0;5;83
"578";"360050250001";44;4;37;18;32;135
"579";"360050250002";7;1;48;34;23;113
"580";"360050251001";67;9;5;0;24;105
"581";"360050251002";25;38;14;1;15;93
"582";"360050251003";26;13;13;2;19;73
"583";"360050251004";30;6;14;3;11;64
"584";"360050251005";75;10;40;4;32;161
"585";"360050251006";110;14;19;4;15;162
"586";"360050251007";10;4;11;2;7;34
"587";"360050252001";14;2;41;7;26;90
"588";"360050252002";11;2;48;16;19;96
"589";"360050253001";613;2;1;1;25;642
"590";"360050253002";60;31;4;1;28;124
"591";"360050253003";49;5;5;0;14;73
"592";"360050253004";18;6;5;1;18;48
"593";"360050254001";7;5;27;13;34;86
"594";"360050254002";11;5;41;12;9;78
"595";"360050255001";92;19;21;0;15;147
"596";"360050255002";153;57;54;1;23;288
"597";"360050255003";41;4;23;1;11;80
"598";"360050256001";35;5;23;15;20;98
"599";"360050256002";37;11;44;28;48;168
"600";"360050257001";72;45;16;7;6;146
"601";"360050261001";36;32;14;5;6;93
"602";"360050263001";59;77;9;3;24;172
"603";"360050263002";63;19;2;0;6;90
"604";"360050263003";62;15;26;4;11;118
"605";"360050263004";3;10;5;2;1;21
"606";"360050263005";43;2;4;0;5;54
"607";"360050264001";46;5;58;10;24;143
"608";"360050264002";19;1;46;13;27;106
"609";"360050264003";13;8;45;10;32;108
"610";"360050264004";13;2;36;10;35;96
"611";"360050265001";98;10;21;1;26;156
"612";"360050265002";109;33;16;0;22;180
"613";"360050265003";170;12;3;0;25;210
"614";"360050265004";161;4;15;0;21;201
"615";"360050266011";63;3;15;21;13;115
"616";"360050266012";6;3;13;1;12;35
"617";"360050266013";1;2;10;5;9;27
"618";"360050266021";14;6;30;4;17;71
"619";"360050266022";30;17;47;8;28;130
"620";"360050266023";17;2;25;12;30;86
"621";"360050266024";12;0;8;0;7;27
"622";"360050266025";33;1;35;2;18;89
"623";"360050267011";36;4;14;2;9;65
"624";"360050267012";71;14;0;0;4;89
"625";"360050267013";132;7;10;0;19;168
"626";"360050267021";127;68;33;2;18;248
"627";"360050267022";139;1;0;0;1;141
"628";"360050267023";130;8;4;0;14;156
"629";"360050267024";4;2;26;2;12;46
"630";"360050267025";74;4;28;0;9;115
"631";"360050267026";126;10;10;0;15;161
"632";"360050269001";171;47;82;4;17;321
"633";"360050269002";38;3;17;1;22;81
"634";"360050269003";35;1;19;0;5;60
"635";"360050273001";47;8;8;0;12;75
"636";"360050273002";73;14;18;2;10;117
"637";"360050273003";72;5;49;3;23;152
"638";"360050273004";97;18;34;8;19;176
"639";"360050274011";1;2;4;2;5;14
"640";"360050274012";2;2;34;9;26;73
"641";"360050274013";13;0;20;35;23;91
"642";"360050274014";8;17;32;20;19;96
"643";"360050274021";8;2;8;18;11;47
"644";"360050274022";1;4;8;1;6;20
"645";"360050274023";21;2;32;11;19;85
"646";"360050276001";8;4;26;10;4;52
"647";"360050277001";22;8;43;2;23;98
"648";"360050277002";29;20;8;0;12;69
"649";"360050277003";10;4;31;3;7;55
"650";"360050277004";67;7;14;0;3;91
"651";"360050279001";35;0;20;2;27;84
"652";"360050279002";23;5;57;2;9;96
"653";"360050279003";43;10;22;1;16;92
"654";"360050279004";16;4;34;1;6;61
"655";"360050279005";1;0;38;1;0;40
"656";"360050279006";271;3;34;0;8;316
"657";"360050281001";64;3;10;1;2;80
"658";"360050281002";17;1;2;1;1;22
"659";"360050281003";2;1;14;3;2;22
"660";"360050283001";85;13;16;1;17;132
"661";"360050283002";33;4;11;10;4;62
"662";"360050284001";1;4;30;11;22;68
"663";"360050285001";75;13;32;0;12;132
"664";"360050285002";14;3;13;0;4;34
"665";"360050285003";38;28;4;1;5;76
"666";"360050285004";150;14;20;4;10;198
"667";"360050286001";4;6;35;21;10;76
"668";"360050286002";7;12;40;7;13;79
"669";"360050287001";22;3;57;0;16;98
"670";"360050287002";45;0;1;2;6;54
"671";"360050287003";41;10;3;0;9;63
"672";"360050288001";99;1;16;7;8;131
"673";"360050288002";5;1;32;7;19;64
"674";"360050288003";63;5;9;0;1;78
"675";"360050288004";2;1;23;11;28;65
"676";"360050289001";120;30;12;1;15;178
"677";"360050289002";43;2;0;0;4;49
"678";"360050289003";8;6;10;0;12;36
"679";"360050289004";58;10;1;0;3;72
"680";"360050293011";4;0;3;2;1;10
"681";"360050293012";18;10;3;2;3;36
"682";"360050293021";1;6;5;0;5;17
"683";"360050293022";2;1;10;1;2;16
"684";"360050293023";21;9;15;0;3;48
"685";"360050293024";41;6;44;30;11;132
"686";"360050295001";26;19;32;1;12;90
"687";"360050295002";41;38;34;1;7;121
"688";"360050295003";12;1;14;2;11;40
"689";"360050295004";16;10;16;2;14;58
"690";"360050296001";38;15;39;28;38;158
"691";"360050296002";1;2;13;5;7;28
"692";"360050297001";24;8;8;2;6;48
"693";"360050297002";30;7;44;3;5;89
"694";"360050297003";65;5;17;0;2;89
"695";"360050300001";10;4;52;6;12;84
"696";"360050300002";10;3;44;10;24;91
"697";"360050300003";9;9;11;7;2;38
"698";"360050300004";8;0;15;6;12;41
"699";"360050300005";2;2;20;11;7;42
"700";"360050300006";19;2;25;10;6;62
"701";"360050301001";4;5;6;2;9;26
"702";"360050301002";0;0;13;1;0;14
"703";"360050302001";0;3;5;1;2;11
"704";"360050302002";0;0;6;0;3;9
"705";"360050302003";0;0;46;8;6;60
"706";"360050302004";2;0;0;0;0;2
"707";"360050302005";14;1;8;5;23;51
"708";"360050302006";2;0;1;0;0;3
"709";"360050307011";6;0;22;3;6;37
"710";"360050307012";19;2;12;2;1;36
"711";"360050307013";7;4;11;0;2;24
"712";"360050307014";0;4;9;2;1;16
"713";"360050309001";0;0;5;0;0;5
"714";"360050309002";1;1;7;4;3;16
"715";"360050309003";19;0;2;0;0;21
"716";"360050309004";3;15;6;2;7;33
"717";"360050310001";11;2;7;6;18;44
"718";"360050310002";7;8;10;9;5;39
"719";"360050310003";11;2;20;9;24;66
"720";"360050312001";3;2;21;7;20;53
"721";"360050312002";6;10;20;11;21;68
"722";"360050314001";23;6;27;8;19;83
"723";"360050314002";5;1;19;5;4;34
"724";"360050316001";30;3;35;16;17;101
"725";"360050316002";3;0;9;7;7;26
"726";"360050318001";14;2;21;12;4;53
"727";"360050318002";9;1;15;13;6;44
"728";"360050323001";0;1;5;14;0;20
"729";"360050323002";79;0;23;2;0;104
"730";"360050323003";18;0;5;5;16;44
"731";"360050323004";21;8;18;7;9;63
"732";"360050324001";700;7;7;2;7;723
"733";"360050324002";35;15;24;8;6;88
"734";"360050326001";129;9;35;4;18;195
"735";"360050326002";4;0;15;16;18;53
"736";"360050326003";5;1;19;1;11;37
"737";"360050328001";33;6;14;4;29;86
"738";"360050328002";114;7;0;0;4;125
"739";"360050328003";15;2;17;3;9;46
"740";"360050328004";29;4;21;5;7;66
"741";"360050330001";45;10;27;1;43;126
"742";"360050330002";73;5;17;0;19;114
"743";"360050330003";121;35;17;0;39;212
"744";"360050330004";65;3;20;0;15;103
"745";"360050332011";91;3;7;1;15;117
"746";"360050332012";177;3;10;3;9;202
"747";"360050332013";28;2;25;0;16;71
"748";"360050332021";46;3;11;0;8;68
"749";"360050332022";36;24;8;0;15;83
"750";"360050332023";26;4;27;0;4;61
"751";"360050332024";12;0;1;1;6;20
"752";"360050334001";42;12;8;4;13;79
"753";"360050335001";3;0;1;1;1;6
"754";"360050335002";2;7;19;11;5;44
"755";"360050335003";20;19;13;1;4;57
"756";"360050336001";33;9;22;3;3;70
"757";"360050336002";61;8;1;0;18;88
"758";"360050336003";72;3;3;1;10;89
"759";"360050336004";42;10;0;0;1;53
"760";"360050336005";61;2;0;2;3;68
"761";"360050336006";72;7;5;4;20;108
"762";"360050337001";3;4;7;2;4;20
"763";"360050337002";2;4;21;32;18;77
"764";"360050337003";3;14;21;20;16;74
"765";"360050338001";38;7;29;0;25;99
"766";"360050338002";37;4;23;0;8;72
"767";"360050338003";31;11;5;0;12;59
"768";"360050338004";32;4;42;6;29;113
"769";"360050340001";14;2;42;3;19;80
"770";"360050340002";49;3;33;3;6;94
"771";"360050340003";26;9;5;1;17;58
"772";"360050340004";24;14;20;0;7;65
"773";"360050342001";17;0;20;2;9;48
"774";"360050342002";35;11;27;23;14;110
"775";"360050343001";14;9;8;5;8;44
"776";"360050343002";22;10;11;18;5;66
"777";"360050344001";6;3;20;3;6;38
"778";"360050344002";8;12;24;23;12;79
"779";"360050345001";52;4;65;15;12;148
"780";"360050345002";7;5;36;20;6;74
"781";"360050345003";3;1;11;5;0;20
"782";"360050348001";15;11;46;97;32;201
"783";"360050348002";228;27;7;7;3;272
"784";"360050348003";10;7;68;53;19;157
"785";"360050348004";7;3;58;36;15;119
"786";"360050350001";10;5;50;11;14;90
"787";"360050350002";16;7;15;7;12;57
"788";"360050351001";6;9;6;4;0;25
"789";"360050351002";27;4;27;15;7;80
"790";"360050351003";2;5;13;13;6;39
"791";"360050356001";7;0;13;12;14;46
"792";"360050356002";11;3;48;40;24;126
"793";"360050358001";41;11;40;28;27;147
"794";"360050358002";15;3;49;33;13;113
"795";"360050358003";22;3;49;20;5;99
"796";"360050358004";21;3;31;9;14;78
"797";"360050358005";14;5;26;38;8;91
"798";"360050358006";22;2;23;14;20;81
"799";"360050358007";39;6;37;3;14;99
"800";"360050359001";110;11;23;1;57;202
"801";"360050360001";11;8;17;4;6;46
"802";"360050360002";34;2;29;16;10;91
"803";"360050360003";7;1;10;11;3;32
"804";"360050361001";25;4;3;1;6;39
"805";"360050361002";40;6;26;0;8;80
"806";"360050361003";10;0;3;0;6;19
"807";"360050361004";6;4;0;0;1;11
"808";"360050361005";20;3;5;0;6;34
"809";"360050363001";49;7;6;0;2;64
"810";"360050363002";1;1;0;0;5;7
"811";"360050363003";51;18;17;3;15;104
"812";"360050363004";32;8;27;1;25;93
"813";"360050363005";49;7;4;3;12;75
"814";"360050363006";108;20;6;2;22;158
"815";"360050364001";18;8;51;9;13;99
"816";"360050364002";22;4;13;3;21;63
"817";"360050364003";19;8;38;2;13;80
"818";"360050365011";21;2;5;4;10;42
"819";"360050365012";33;4;16;0;17;70
"820";"360050365013";13;5;10;2;20;50
"821";"360050365021";22;5;16;0;12;55
"822";"360050365022";54;14;16;1;28;113
"823";"360050367001";40;4;21;5;25;95
"824";"360050367002";32;10;8;2;10;62
"825";"360050368001";24;7;52;8;19;110
"826";"360050368002";7;6;28;6;17;64
"827";"360050369011";50;11;2;3;27;93
"828";"360050369012";8;7;0;1;12;28
"829";"360050369021";43;6;3;0;4;56
"830";"360050369022";26;5;6;3;10;50
"831";"360050370001";43;3;21;6;22;95
"832";"360050370002";13;3;20;15;17;68
"833";"360050370003";3;0;26;11;20;60
"834";"360050371001";13;8;41;7;15;84
"835";"360050371002";86;6;7;5;26;130
"836";"360050371003";14;8;9;3;31;65
"837";"360050371004";42;8;9;3;14;76
"838";"360050372001";31;4;17;2;19;73
"839";"360050372002";27;16;29;3;14;89
"840";"360050373001";129;5;6;2;28;170
"841";"360050373002";78;57;10;2;40;187
"842";"360050373003";51;12;10;2;35;110
"843";"360050373004";114;13;11;0;25;163
"844";"360050374001";1019;506;9;0;22;1556
"845";"360050374002";97;15;28;14;30;184
"846";"360050374003";17;3;0;1;0;21
"847";"360050374004";5;0;0;0;0;5
"848";"360050375041";44;7;5;3;25;84
"849";"360050375042";36;7;3;2;9;57
"850";"360050375043";49;13;21;4;23;110
"851";"360050376001";431;5;10;5;9;460
"852";"360050376002";26;3;13;10;6;58
"853";"360050378001";48;5;37;8;52;150
"854";"360050378002";14;0;6;1;0;21
"855";"360050378003";49;4;15;6;26;100
"856";"360050379001";13;6;23;4;38;84
"857";"360050379002";16;2;0;1;6;25
"858";"360050379003";37;26;12;1;6;82
"859";"360050379004";16;6;9;0;25;56
"860";"360050379005";148;5;14;3;15;185
"861";"360050380001";14;6;6;4;11;41
"862";"360050380002";19;8;38;4;18;87
"863";"360050380003";66;24;24;6;14;134
"864";"360050380004";46;26;55;11;33;171
"865";"360050381001";101;7;0;1;1;110
"866";"360050381002";100;17;5;0;11;133
"867";"360050381003";82;25;3;1;19;130
"868";"360050381004";35;3;13;0;14;65
"869";"360050381005";22;6;42;0;16;86
"870";"360050381006";81;15;3;3;34;136
"871";"360050382001";64;10;52;4;29;159
"872";"360050382002";99;4;33;4;33;173
"873";"360050383011";80;16;2;0;16;114
"874";"360050383012";84;13;16;2;20;135
"875";"360050383013";96;11;8;4;19;138
"876";"360050383021";154;22;7;5;46;234
"877";"360050383022";133;20;12;0;11;176
"878";"360050383023";193;16;9;2;14;234
"879";"360050385001";22;10;9;4;21;66
"880";"360050385002";221;3;7;2;8;241
"881";"360050385003";31;40;12;4;29;116
"882";"360050385004";96;14;18;33;54;215
"883";"360050386001";15;13;59;13;39;139
"884";"360050386002";10;22;46;23;37;138
"885";"360050386003";24;8;0;2;8;42
"886";"360050386004";40;10;60;7;15;132
"887";"360050386005";24;7;10;6;9;56
"888";"360050386006";24;5;14;3;13;59
"889";"360050386007";9;0;0;0;12;21
"890";"360050386008";31;6;3;0;8;48
"891";"360050387001";82;25;14;1;38;160
"892";"360050387002";108;6;18;7;42;181
"893";"360050387003";32;12;11;3;14;72
"894";"360050388001";49;2;34;2;11;98
"895";"360050388002";35;3;69;9;18;134
"896";"360050389001";104;13;27;0;29;173
"897";"360050389002";92;18;8;0;16;134
"898";"360050389003";42;15;27;4;42;130
"899";"360050389004";29;14;7;0;7;57
"900";"360050389005";29;11;8;1;17;66
"901";"360050390001";35;6;65;3;24;133
"902";"360050390002";31;5;42;1;13;92
"903";"360050391001";130;10;15;1;28;184
"904";"360050391002";69;25;11;1;23;129
"905";"360050391003";38;4;8;1;21;72
"906";"360050391004";21;146;14;0;45;226
"907";"360050391005";9;14;1;3;10;37
"908";"360050391006";24;17;3;0;27;71
"909";"360050392001";6;1;18;4;13;42
"910";"360050392002";17;1;23;5;27;73
"911";"360050393001";128;75;5;0;10;218
"912";"360050393002";41;5;5;1;32;84
"913";"360050393003";17;7;0;1;5;30
"914";"360050393004";49;27;4;2;16;98
"915";"360050393005";62;5;1;0;16;84
"916";"360050393006";27;9;6;8;14;64
"917";"360050394001";32;1;13;0;4;50
"918";"360050394002";108;10;36;10;22;186
"919";"360050394003";1;2;8;1;1;13
"920";"360050394004";32;5;35;1;10;83
"921";"360050395001";17;1;23;18;45;104
"922";"360050395002";12;2;32;14;48;108
"923";"360050395003";37;13;25;30;40;145
"924";"360050395004";25;11;38;12;40;126
"925";"360050396001";45;5;48;4;10;112
"926";"360050396002";37;2;57;10;23;129
"927";"360050396003";37;5;51;7;33;133
"928";"360050396004";20;3;40;1;14;78
"929";"360050397001";48;36;16;9;22;131
"930";"360050397002";28;16;9;0;27;80
"931";"360050398001";32;1;39;14;9;95
"932";"360050398002";31;2;23;6;9;71
"933";"360050398003";21;7;19;5;21;73
"934";"360050399011";79;4;2;1;8;94
"935";"360050399012";50;21;5;0;18;94
"936";"360050399013";27;9;7;0;13;56
"937";"360050399014";76;7;1;1;6;91
"938";"360050399015";29;10;25;3;24;91
"939";"360050399021";32;17;13;0;16;78
"940";"360050399022";44;17;3;0;12;76
"941";"360050399023";59;12;3;0;17;91
"942";"360050399024";39;2;1;0;8;50
"943";"360050399025";17;0;17;2;15;51
"944";"360050401001";79;1;1;0;33;114
"945";"360050401002";87;17;4;1;23;132
"946";"360050401003";29;13;0;2;2;46
"947";"360050401004";16;6;0;0;15;37
"948";"360050401005";30;4;2;0;4;40
"949";"360050403021";216;21;2;6;18;263
"950";"360050403022";31;6;7;2;6;52
"951";"360050403023";30;13;1;0;4;48
"952";"360050403031";85;20;6;1;11;123
"953";"360050403032";122;23;60;3;25;233
"954";"360050403033";163;5;3;13;15;199
"955";"360050403041";29;53;1;0;13;96
"956";"360050403042";57;15;13;0;14;99
"957";"360050403043";67;3;5;0;18;93
"958";"360050404001";39;5;58;3;19;124
"959";"360050404002";30;11;42;2;7;92
"960";"360050404003";93;3;25;3;3;127
"961";"360050405011";152;7;13;0;43;215
"962";"360050405012";40;1;8;0;8;57
"963";"360050405013";50;17;6;0;13;86
"964";"360050405021";33;100;6;1;12;152
"965";"360050405022";28;15;7;2;14;66
"966";"360050405023";77;9;17;0;33;136
"967";"360050405024";43;2;6;2;7;60
"968";"360050405025";26;6;13;0;10;55
"969";"360050405026";31;4;54;3;34;126
"970";"360050406001";109;59;49;5;16;238
"971";"360050406002";25;2;21;1;14;63
"972";"360050406003";22;14;27;9;24;96
"973";"360050407011";64;7;3;2;14;90
"974";"360050407012";27;3;1;0;17;48
"975";"360050407013";49;12;5;0;11;77
"976";"360050407021";19;9;1;1;17;47
"977";"360050407022";71;26;28;0;39;164
"978";"360050407023";153;3;7;0;20;183
"979";"360050407024";36;6;11;4;26;83
"980";"360050407025";24;9;11;2;11;57
"981";"360050408001";102;7;10;0;5;124
"982";"360050408002";50;4;29;2;18;103
"983";"360050408003";28;3;8;8;0;47
"984";"360050408004";106;5;60;7;26;204
"985";"360050409001";20;4;22;8;12;66
"986";"360050409002";62;13;7;3;3;88
"987";"360050411001";57;9;5;1;8;80
"988";"360050411002";11;7;7;0;32;57
"989";"360050411003";30;3;13;0;23;69
"990";"360050413001";58;15;45;1;39;158
"991";"360050413002";31;10;2;1;6;50
"992";"360050413003";145;3;17;1;12;178
"993";"360050413004";22;2;4;2;3;33
"994";"360050413005";16;3;6;0;14;39
"995";"360050413006";34;8;12;1;15;70
"996";"360050413007";55;2;13;1;8;79
"997";"360050414001";29;4;53;30;17;133
"998";"360050414002";25;10;24;9;27;95
"999";"360050414003";46;1;40;21;13;121
"1000";"360050414004";47;8;16;36;24;131
"1001";"360050415001";143;1;15;1;9;169
"1002";"360050415002";68;5;17;0;5;95
"1003";"360050415003";24;1;17;1;8;51
"1004";"360050415004";23;0;3;0;5;31
"1005";"360050415005";28;5;5;0;14;52
"1006";"360050415006";78;1;6;0;11;96
"1007";"360050418001";12;5;25;7;18;67
"1008";"360050418002";13;7;42;10;23;95
"1009";"360050418003";77;4;21;1;8;111
"1010";"360050418004";37;2;18;6;20;83
"1011";"360050419001";38;7;29;0;4;78
"1012";"360050419002";22;4;27;0;0;53
"1013";"360050419003";116;2;23;0;10;151
"1014";"360050419004";217;10;10;2;13;252
"1015";"360050419005";21;5;10;0;4;40
"1016";"360050419006";50;2;3;0;3;58
"1017";"360050419007";53;9;20;0;5;87
"1018";"360050420001";31;8;26;5;9;79
"1019";"360050420002";75;7;27;1;16;126
"1020";"360050420003";30;12;45;1;15;103
"1021";"360050421001";3;7;6;0;0;16
"1022";"360050421002";74;18;2;0;8;102
"1023";"360050421003";30;11;3;0;19;63
"1024";"360050421004";187;193;21;0;8;409
"1025";"360050421005";92;96;0;1;18;207
"1026";"360050422001";253;14;71;6;47;391
"1027";"360050422002";30;5;44;9;31;119
"1028";"360050423001";104;24;6;1;4;139
"1029";"360050423002";59;17;40;3;23;142
"1030";"360050423003";86;12;25;1;19;143
"1031";"360050424001";38;3;56;3;7;107
"1032";"360050424002";32;23;48;5;14;122
"1033";"360050425001";41;9;5;0;8;63
"1034";"360050425002";68;13;6;1;11;99
"1035";"360050425003";59;8;20;2;6;95
"1036";"360050425004";42;1;5;1;5;54
"1037";"360050425005";22;12;24;109;33;200
"1038";"360050425006";10;3;2;0;6;21
"1039";"360050425007";61;7;12;2;14;96
"1040";"360050426001";16;13;74;25;18;146
"1041";"360050426002";28;15;50;18;16;127
"1042";"360050426003";8;0;64;5;12;89
"1043";"360050426004";7;5;29;6;5;52
"1044";"360050426005";8;1;12;7;3;31
"1045";"360050426006";16;1;61;10;11;99
"1046";"360050428001";20;7;39;28;38;132
"1047";"360050428002";21;4;48;14;6;93
"1048";"360050429011";65;7;29;2;26;129
"1049";"360050429012";47;3;20;3;12;85
"1050";"360050429013";39;2;13;0;8;62
"1051";"360050429021";141;23;64;5;32;265
"1052";"360050429022";14;14;60;1;8;97
"1053";"360050429023";96;5;21;0;12;134
"1054";"360050430001";19;4;55;34;10;122
"1055";"360050430002";19;1;30;21;12;83
"1056";"360050430003";26;1;25;8;11;71
"1057";"360050431001";34;8;3;0;2;47
"1058";"360050431002";79;5;2;1;4;91
"1059";"360050431003";53;2;1;0;6;62
"1060";"360050431004";65;12;32;1;5;115
"1061";"360050431005";110;20;19;4;18;171
"1062";"360050431006";142;9;1;1;4;157
"1063";"360050431007";35;11;16;1;7;70
"1064";"360050431008";23;58;8;0;10;99
"1065";"360050434001";24;12;40;41;33;150
"1066";"360050434002";24;8;21;7;16;76
"1067";"360050434003";26;3;22;4;15;70
"1068";"360050434004";79;3;38;12;17;149
"1069";"360050435001";116;62;59;19;19;275
"1070";"360050436001";49;5;34;19;19;126
"1071";"360050436002";18;5;31;10;27;91
"1072";"360050442001";44;4;2;0;4;54
"1073";"360050442002";13;1;50;2;8;74
"1074";"360050442003";9;8;27;14;6;64
"1075";"360050442004";23;8;32;43;14;120
"1076";"360050442005";2;11;18;7;6;44
"1077";"360050444001";18;6;33;33;10;100
"1078";"360050444002";91;26;15;9;11;152
"1079";"360050444003";23;3;56;7;11;100
"1080";"360050444004";11;7;60;25;11;114
"1081";"360050448001";12;9;30;14;6;71
"1082";"360050448002";5;0;9;13;3;30
"1083";"360050449011";6;0;18;11;6;41
"1084";"360050449012";8;0;37;19;4;68
"1085";"360050449021";7;15;32;12;18;84
"1086";"360050449022";11;14;58;17;16;116
"1087";"360050451011";13;11;73;16;17;130
"1088";"360050451012";14;1;32;22;7;76
"1089";"360050451021";5;7;53;16;20;101
"1090";"360050451022";14;3;57;14;16;104
"1091";"360050456001";27;3;41;37;15;123
"1092";"360050456002";13;10;40;17;10;90
"1093";"360050456003";5;0;18;17;8;48
"1094";"360050458001";31;4;2;4;4;45
"1095";"360050458002";405;1;4;1;2;413
"1096";"360050458003";9;0;0;0;0;9
"1097";"360050458004";66;11;9;3;2;91
"1098";"360050460001";36;22;49;15;16;138
"1099";"360050460002";12;20;27;4;8;71
"1100";"360050462011";3;11;24;12;13;63
"1101";"360050462012";2;1;2;0;1;6
"1102";"360050462013";6;8;10;8;3;35
"1103";"360050462014";3;0;8;0;3;14
"1104";"360050462015";1;0;0;0;27;28
"1105";"360050462016";25;0;1;1;1;28
"1106";"360050462017";2;2;2;0;0;6
"1107";"360050462018";1;0;12;4;2;19
"1108";"360050462019";0;2;1;0;5;8
"1109";"360050462021";47;8;49;35;23;162
"1110";"360050462022";26;13;105;25;27;196
"1111";"360050462023";58;16;44;30;39;187
"1112";"360050462024";9;7;11;10;5;42
"1113";"360050462025";18;10;49;54;25;156
"1114";"360050462026";27;6;3;7;2;45
"1115";"360050484001";10;1;11;11;7;40
"1116";"360050484002";15;15;106;71;39;246
"1117";"360050484003";4;0;5;21;8;38
"1118";"360050484004";33;13;28;26;5;105
"1119";"360050504001";0;0;0;1;0;1
"1120";"360050516001";3;61;32;17;31;144
"1121";"360050516002";2;22;33;20;14;91
"1122";"360050516003";6;37;36;19;29;127
"1123";"360050516004";6;6;21;9;27;69
"1124";"360470001001";9;10;23;2;12;56
"1125";"360470001002";8;13;21;2;1;45
"1126";"360470001003";4;14;14;1;6;39
"1127";"360470001004";1;15;6;0;16;38
"1128";"360470002001";20;44;105;93;31;293
"1129";"360470003011";10;5;13;1;4;33
"1130";"360470003012";5;4;19;0;1;29
"1131";"360470003013";4;17;9;1;3;34
"1132";"360470003014";7;3;1;0;1;12
"1133";"360470003015";19;22;6;2;3;52
"1134";"360470005011";23;27;28;1;13;92
"1135";"360470005012";4;11;7;3;2;27
"1136";"360470005013";7;10;12;1;2;32
"1137";"360470005021";3;6;17;1;6;33
"1138";"360470005022";14;24;8;0;13;59
"1139";"360470007001";17;14;37;2;21;91
"1140";"360470007002";3;4;17;0;4;28
"1141";"360470007003";13;13;10;3;11;50
"1142";"360470009001";33;54;25;1;23;136
"1143";"360470009002";24;13;8;0;8;53
"1144";"360470011001";5;11;14;1;23;54
"1145";"360470013001";8;40;45;4;16;113
"1146";"360470013002";0;0;2;0;0;2
"1147";"360470015001";29;24;45;9;9;116
"1148";"360470015002";236;4;5;0;10;255
"1149";"360470015003";25;29;64;5;11;134
"1150";"360470018001";14;13;99;42;35;203
"1151";"360470020001";6;43;37;18;29;133
"1152";"360470020002";15;0;40;27;23;105
"1153";"360470021001";9;84;79;3;37;212
"1154";"360470021002";16;22;78;3;13;132
"1155";"360470021003";29;26;54;2;37;148
"1156";"360470022001";21;6;94;5;20;146
"1157";"360470022002";12;12;50;3;9;86
"1158";"360470022003";24;25;32;4;23;108
"1159";"360470023001";224;31;3;3;8;269
"1160";"360470023002";47;6;2;0;0;55
"1161";"360470023003";288;11;2;10;0;311
"1162";"360470029011";170;8;6;3;3;190
"1163";"360470029012";60;4;8;2;3;77
"1164";"360470030001";13;1;40;7;11;72
"1165";"360470030002";8;2;28;5;6;49
"1166";"360470031001";4;12;9;2;3;30
"1167";"360470031002";1;1;3;0;0;5
"1168";"360470031003";0;2;3;2;2;9
"1169";"360470033001";4;12;14;5;18;53
"1170";"360470033002";43;48;48;5;27;171
"1171";"360470034001";29;16;26;2;30;103
"1172";"360470034002";7;4;27;3;18;59
"1173";"360470034003";15;2;60;2;7;86
"1174";"360470035001";22;31;21;13;8;95
"1175";"360470035002";16;48;33;2;7;106
"1176";"360470036001";17;7;20;1;17;62
"1177";"360470036002";55;4;23;2;5;89
"1178";"360470036003";26;1;29;3;3;62
"1179";"360470037001";19;44;36;2;30;131
"1180";"360470038001";2;5;37;14;18;76
"1181";"360470039001";18;67;12;3;22;122
"1182";"360470039002";14;12;32;5;10;73
"1183";"360470039003";5;15;22;3;33;78
"1184";"360470041001";27;64;60;14;27;192
"1185";"360470041002";11;2;16;1;22;52
"1186";"360470041003";8;5;41;6;11;71
"1187";"360470043001";0;0;0;0;1;1
"1188";"360470043002";2;12;12;6;3;35
"1189";"360470043003";3;25;10;4;11;53
"1190";"360470043004";11;62;48;9;30;160
"1191";"360470044001";2;5;20;19;10;56
"1192";"360470044002";23;5;37;11;15;91
"1193";"360470045001";6;20;16;9;12;63
"1194";"360470045002";0;6;16;0;5;27
"1195";"360470045003";3;3;4;0;1;11
"1196";"360470045004";2;6;14;1;7;30
"1197";"360470046001";7;9;31;18;23;88
"1198";"360470047001";21;33;36;4;18;112
"1199";"360470049001";6;4;90;3;5;108
"1200";"360470049002";4;2;3;3;3;15
"1201";"360470049003";6;1;6;0;7;20
"1202";"360470050001";26;0;7;1;0;34
"1203";"360470050002";17;5;42;12;2;78
"1204";"360470050003";76;9;49;4;12;150
"1205";"360470051001";5;26;76;4;24;135
"1206";"360470051002";3;3;11;3;5;25
"1207";"360470051003";9;44;32;2;26;113
"1208";"360470052011";18;2;40;9;9;78
"1209";"360470052021";3;1;9;1;1;15
"1210";"360470052022";28;4;29;6;7;74
"1211";"360470053001";31;31;76;14;50;202
"1212";"360470053002";15;16;26;13;11;81
"1213";"360470053003";7;23;26;5;13;74
"1214";"360470053004";10;12;18;3;30;73
"1215";"360470054001";31;3;25;4;5;68
"1216";"360470054002";21;3;29;4;12;69
"1217";"360470054003";58;9;26;9;19;121
"1218";"360470056011";8;9;25;19;13;74
"1219";"360470056012";43;24;100;1;7;175
"1220";"360470056021";24;26;30;10;8;98
"1221";"360470058001";27;11;29;0;9;76
"1222";"360470058002";17;44;62;7;24;154
"1223";"360470058003";10;2;13;3;4;32
"1224";"360470059001";34;38;32;14;19;137
"1225";"360470059002";20;37;43;46;38;184
"1226";"360470060001";11;14;31;4;15;75
"1227";"360470060002";20;12;35;5;10;82
"1228";"360470060003";12;76;26;1;8;123
"1229";"360470062001";2;34;38;6;5;85
"1230";"360470062002";31;7;17;4;10;69
"1231";"360470062003";2;14;23;0;12;51
"1232";"360470063001";10;5;9;5;5;34
"1233";"360470063002";3;12;10;6;10;41
"1234";"360470064001";38;23;87;4;16;168
"1235";"360470064002";11;60;40;1;15;127
"1236";"360470064003";24;32;24;2;6;88
"1237";"360470065001";15;4;10;2;5;36
"1238";"360470065002";3;0;2;1;6;12
"1239";"360470065003";4;0;2;2;8;16
"1240";"360470065004";5;7;4;3;3;22
"1241";"360470065005";0;2;2;4;10;18
"1242";"360470065006";8;20;21;7;14;70
"1243";"360470065007";2;2;13;0;4;21
"1244";"360470066001";8;20;47;5;22;102
"1245";"360470066002";10;4;16;0;5;35
"1246";"360470066003";34;5;32;3;12;86
"1247";"360470067001";4;16;9;1;1;31
"1248";"360470067002";6;8;13;5;5;37
"1249";"360470067003";2;6;18;2;1;29
"1250";"360470067004";5;2;6;7;10;30
"1251";"360470067005";11;5;12;4;0;32
"1252";"360470068001";8;5;15;3;10;41
"1253";"360470068002";51;11;16;0;34;112
"1254";"360470068003";1;34;14;6;6;61
"1255";"360470068004";11;30;32;1;21;95
"1256";"360470069001";3;12;6;5;6;32
"1257";"360470069002";7;45;23;6;19;100
"1258";"360470069003";8;33;30;3;3;77
"1259";"360470069004";11;30;26;10;13;90
"1260";"360470070001";11;5;16;5;9;46
"1261";"360470070002";8;4;56;5;10;83
"1262";"360470071001";7;10;13;9;9;48
"1263";"360470071002";7;19;32;4;19;81
"1264";"360470071003";28;12;24;0;0;64
"1265";"360470071004";30;35;3;1;9;78
"1266";"360470072001";19;10;5;6;19;59
"1267";"360470074001";40;19;7;2;13;81
"1268";"360470074002";8;75;7;4;18;112
"1269";"360470074003";44;15;22;1;19;101
"1270";"360470074004";21;4;1;2;11;39
"1271";"360470075001";6;16;28;1;13;64
"1272";"360470075002";16;30;8;2;6;62
"1273";"360470075003";11;23;31;5;24;94
"1274";"360470075004";8;9;10;3;16;46
"1275";"360470075005";3;9;6;0;11;29
"1276";"360470076001";28;16;13;2;20;79
"1277";"360470076002";12;8;4;2;20;46
"1278";"360470076003";22;5;20;2;30;79
"1279";"360470077001";4;3;10;6;7;30
"1280";"360470077002";21;6;22;8;27;84
"1281";"360470077003";20;30;39;14;39;142
"1282";"360470077004";11;12;12;4;20;59
"1283";"360470078001";28;10;16;2;14;70
"1284";"360470078002";38;13;16;5;12;84
"1285";"360470078003";33;6;7;1;28;75
"1286";"360470078004";14;4;3;2;15;38
"1287";"360470080001";39;26;11;1;23;100
"1288";"360470080002";20;7;8;1;22;58
"1289";"360470080003";4;6;4;1;19;34
"1290";"360470082001";25;15;11;3;11;65
"1291";"360470082002";35;19;19;2;24;99
"1292";"360470082003";56;29;10;0;13;108
"1293";"360470084001";5;27;20;0;11;63
"1294";"360470084002";17;18;7;3;12;57
"1295";"360470084003";6;10;14;5;19;54
"1296";"360470085001";188;11;5;6;10;220
"1297";"360470085002";81;3;2;0;10;96
"1298";"360470085003";140;7;2;0;0;149
"1299";"360470086001";5;154;9;2;12;182
"1300";"360470088001";12;14;7;0;11;44
"1301";"360470088002";35;17;27;2;16;97
"1302";"360470090001";19;26;49;3;33;130
"1303";"360470090002";30;12;39;2;33;116
"1304";"360470092001";37;15;28;2;22;104
"1305";"360470092002";46;15;30;4;31;126
"1306";"360470092003";22;8;14;6;26;76
"1307";"360470094001";13;4;33;7;45;102
"1308";"360470094002";29;6;92;8;45;180
"1309";"360470094003";11;11;24;2;28;76
"1310";"360470096001";34;10;15;0;14;73
"1311";"360470096002";29;14;22;1;21;87
"1312";"360470096003";28;13;10;3;18;72
"1313";"360470096004";26;16;15;2;17;76
"1314";"360470098001";27;7;14;0;36;84
"1315";"360470098002";29;18;34;2;22;105
"1316";"360470098003";16;5;16;4;24;65
"1317";"360470098004";16;13;15;1;10;55
"1318";"360470100001";23;3;6;3;27;62
"1319";"360470100002";13;2;7;2;20;44
"1320";"360470100003";19;17;5;0;42;83
"1321";"360470100004";27;15;9;0;24;75
"1322";"360470101001";27;14;30;13;34;118
"1323";"360470101002";15;20;32;4;20;91
"1324";"360470101003";16;9;26;14;19;84
"1325";"360470102001";7;20;26;3;21;77
"1326";"360470102002";11;15;10;5;21;62
"1327";"360470102003";7;23;27;4;39;100
"1328";"360470104001";39;7;58;0;21;125
"1329";"360470104002";13;13;41;2;36;105
"1330";"360470104003";11;3;38;3;58;113
"1331";"360470106001";10;7;72;2;49;140
"1332";"360470106002";12;21;34;3;42;112
"1333";"360470106003";14;8;32;1;40;95
"1334";"360470108001";15;6;40;5;44;110
"1335";"360470108002";10;3;22;0;11;46
"1336";"360470108003";11;2;73;1;41;128
"1337";"360470110001";23;5;64;19;47;158
"1338";"360470110002";44;7;56;10;21;138
"1339";"360470112001";33;10;32;8;30;113
"1340";"360470112002";12;1;8;3;7;31
"1341";"360470112003";6;2;17;0;9;34
"1342";"360470112004";40;10;19;2;24;95
"1343";"360470114001";4;4;15;0;12;35
"1344";"360470114002";6;3;48;7;18;82
"1345";"360470114003";4;3;33;2;19;61
"1346";"360470116001";23;4;52;1;38;118
"1347";"360470116002";4;1;31;1;31;68
"1348";"360470116003";3;3;25;0;11;42
"1349";"360470117001";8;19;31;8;20;86
"1350";"360470117002";7;32;36;3;18;96
"1351";"360470117003";15;6;51;10;20;102
"1352";"360470118001";15;30;62;4;33;144
"1353";"360470118002";2;12;55;5;48;122
"1354";"360470119001";9;96;103;21;45;274
"1355";"360470119002";21;503;81;17;51;673
"1356";"360470119003";15;41;51;6;28;141
"1357";"360470120001";6;24;62;5;51;148
"1358";"360470121001";9;24;69;5;32;139
"1359";"360470121002";6;9;38;6;31;90
"1360";"360470122001";26;30;18;0;17;91
"1361";"360470122002";13;9;15;0;23;60
"1362";"360470122003";15;16;32;7;35;105
"1363";"360470126001";16;13;21;8;12;70
"1364";"360470126002";11;7;25;4;13;60
"1365";"360470126003";0;0;26;0;9;35
"1366";"360470127001";22;30;30;9;25;116
"1367";"360470127002";54;43;63;12;20;192
"1368";"360470127003";70;15;10;2;1;98
"1369";"360470128011";14;10;76;15;39;154
"1370";"360470129011";6;3;18;1;10;38
"1371";"360470129012";39;22;10;2;13;86
"1372";"360470129013";14;1;12;4;8;39
"1373";"360470129021";1;7;22;1;8;39
"1374";"360470129022";13;11;19;4;13;60
"1375";"360470129023";15;8;8;4;0;35
"1376";"360470130001";178;20;29;4;17;248
"1377";"360470130002";13;2;19;3;8;45
"1378";"360470130003";9;3;22;0;14;48
"1379";"360470130004";37;15;11;9;10;82
"1380";"360470131001";11;22;23;3;16;75
"1381";"360470131002";20;31;14;3;5;73
"1382";"360470131003";5;51;7;3;14;80
"1383";"360470131004";34;37;15;2;10;98
"1384";"360470132001";5;0;30;1;35;71
"1385";"360470132002";5;9;55;10;19;98
"1386";"360470133001";8;21;15;3;23;70
"1387";"360470133002";12;27;38;3;11;91
"1388";"360470133003";3;14;17;2;8;44
"1389";"360470133004";5;10;18;5;10;48
"1390";"360470134001";18;3;67;11;16;115
"1391";"360470134002";19;6;8;4;11;48
"1392";"360470134003";3;10;30;2;19;64
"1393";"360470135001";5;10;13;4;4;36
"1394";"360470135002";23;32;49;1;12;117
"1395";"360470135003";22;24;39;4;13;102
"1396";"360470136001";15;1;49;6;17;88
"1397";"360470136002";11;6;13;0;6;36
"1398";"360470136003";10;21;41;4;3;79
"1399";"360470136004";47;3;30;3;10;93
"1400";"360470137001";8;27;6;4;12;57
"1401";"360470137002";12;12;8;9;7;48
"1402";"360470137003";34;25;36;12;15;122
"1403";"360470138001";46;21;34;9;12;122
"1404";"360470138002";5;5;30;3;19;62
"1405";"360470138003";11;9;26;2;6;54
"1406";"360470139001";50;18;17;2;8;95
"1407";"360470139002";12;56;16;1;17;102
"1408";"360470139003";9;3;4;3;11;30
"1409";"360470139004";12;5;12;4;7;40
"1410";"360470140001";5;0;35;7;25;72
"1411";"360470140002";4;8;33;6;9;60
"1412";"360470141001";28;10;24;2;11;75
"1413";"360470141002";0;7;18;3;7;35
"1414";"360470141003";16;25;16;11;9;77
"1415";"360470142001";18;1;44;6;28;97
"1416";"360470142002";81;11;8;0;24;124
"1417";"360470142003";15;11;20;4;10;60
"1418";"360470143001";30;27;20;5;37;119
"1419";"360470143002";21;12;29;4;24;90
"1420";"360470143003";25;9;21;1;6;62
"1421";"360470145001";40;35;50;6;28;159
"1422";"360470145002";44;25;11;8;33;121
"1423";"360470145003";52;6;19;2;29;108
"1424";"360470145004";39;8;27;1;16;91
"1425";"360470147001";35;10;9;3;10;67
"1426";"360470147002";37;9;22;5;16;89
"1427";"360470148001";0;2;16;2;3;23
"1428";"360470148002";8;5;20;2;8;43
"1429";"360470149001";8;2;20;2;4;36
"1430";"360470149002";40;23;19;7;31;120
"1431";"360470149003";4;5;14;6;5;34
"1432";"360470149004";24;5;31;4;11;75
"1433";"360470149005";13;13;35;2;17;80
"1434";"360470150001";3;2;21;3;12;41
"1435";"360470150002";17;4;18;8;17;64
"1436";"360470151001";2;4;2;0;1;9
"1437";"360470151002";3;13;19;2;7;44
"1438";"360470151003";11;32;23;4;10;80
"1439";"360470151004";16;4;14;1;8;43
"1440";"360470152001";0;4;24;12;5;45
"1441";"360470152002";0;0;18;8;3;29
"1442";"360470152003";12;1;34;13;5;65
"1443";"360470153001";2;2;14;0;0;18
"1444";"360470153002";4;9;44;6;14;77
"1445";"360470153003";14;22;13;1;7;57
"1446";"360470153004";7;5;15;3;5;35
"1447";"360470154001";1;0;17;2;0;20
"1448";"360470155001";3;14;14;1;5;37
"1449";"360470155002";6;8;11;5;2;32
"1450";"360470155003";1;5;7;6;3;22
"1451";"360470155004";6;9;10;1;6;32
"1452";"360470157001";10;10;11;7;6;44
"1453";"360470157002";27;11;13;6;5;62
"1454";"360470157003";11;11;16;4;7;49
"1455";"360470157004";3;7;14;1;11;36
"1456";"360470159001";8;20;16;1;10;55
"1457";"360470159002";8;11;8;1;6;34
"1458";"360470159003";5;9;12;12;12;50
"1459";"360470159004";15;7;20;14;3;59
"1460";"360470159005";12;3;13;3;14;45
"1461";"360470160001";15;1;13;7;9;45
"1462";"360470160002";26;4;28;1;8;67
"1463";"360470160003";15;5;21;2;29;72
"1464";"360470160004";8;60;46;2;29;145
"1465";"360470161001";19;27;55;2;6;109
"1466";"360470161002";14;25;13;3;8;63
"1467";"360470161003";26;35;26;2;40;129
"1468";"360470162001";25;2;21;12;2;62
"1469";"360470162002";9;2;56;13;11;91
"1470";"360470163001";13;17;16;1;12;59
"1471";"360470163002";34;14;15;7;16;86
"1472";"360470163003";118;33;22;0;17;190
"1473";"360470164001";0;0;0;2;0;2
"1474";"360470165001";22;6;12;2;4;46
"1475";"360470165002";6;12;14;4;21;57
"1476";"360470165003";16;11;19;2;3;51
"1477";"360470165004";1;3;10;9;3;26
"1478";"360470166001";4;2;25;10;4;45
"1479";"360470166002";3;4;10;6;5;28
"1480";"360470167001";9;1;18;8;3;39
"1481";"360470167002";4;3;18;7;5;37
"1482";"360470167003";3;8;14;2;7;34
"1483";"360470167004";28;6;10;14;7;65
"1484";"360470168001";9;1;38;13;7;68
"1485";"360470169001";2;21;12;13;7;55
"1486";"360470169002";12;44;2;1;9;68
"1487";"360470169003";5;11;9;1;11;37
"1488";"360470169004";6;20;8;1;3;38
"1489";"360470169005";37;3;38;9;9;96
"1490";"360470170001";1;2;13;3;23;42
"1491";"360470170002";2;1;37;11;22;73
"1492";"360470170003";8;1;17;4;4;34
"1493";"360470171001";5;7;30;2;8;52
"1494";"360470171002";13;2;2;2;7;26
"1495";"360470171003";3;5;21;6;9;44
"1496";"360470171004";48;6;8;3;2;67
"1497";"360470172001";9;4;41;15;74;143
"1498";"360470172002";4;1;85;16;45;151
"1499";"360470174001";3;8;53;19;14;97
"1500";"360470174002";10;12;79;4;6;111
"1501";"360470175001";3;15;10;10;5;43
"1502";"360470176001";10;9;5;13;28;65
"1503";"360470176002";18;3;28;22;46;117
"1504";"360470177001";66;98;98;15;39;316
"1505";"360470178001";7;4;14;7;13;45
"1506";"360470178002";20;24;58;5;71;178
"1507";"360470179001";73;3;0;2;2;80
"1508";"360470179002";165;88;36;1;11;301
"1509";"360470179003";10;12;21;4;8;55
"1510";"360470180001";6;2;65;11;20;104
"1511";"360470180002";16;27;43;5;39;130
"1512";"360470181001";9;53;21;1;6;90
"1513";"360470181002";7;4;1;1;6;19
"1514";"360470181003";1008;28;23;5;40;1104
"1515";"360470181004";12;9;15;1;4;41
"1516";"360470182001";9;9;17;1;30;66
"1517";"360470182002";8;1;33;12;47;101
"1518";"360470183001";12;43;21;1;18;95
"1519";"360470183002";17;35;5;1;5;63
"1520";"360470183003";19;32;14;9;6;80
"1521";"360470184001";6;0;21;5;7;39
"1522";"360470184002";0;4;36;1;20;61
"1523";"360470185011";68;18;6;2;6;100
"1524";"360470185012";38;11;0;1;1;51
"1525";"360470185013";103;6;0;0;0;109
"1526";"360470185014";29;2;0;0;0;31
"1527";"360470186001";6;1;12;6;14;39
"1528";"360470186002";3;2;18;9;3;35
"1529";"360470187001";27;21;37;8;21;114
"1530";"360470188001";7;3;49;7;16;82
"1531";"360470188002";18;3;57;9;20;107
"1532";"360470190001";19;6;78;8;29;140
"1533";"360470190002";21;3;37;12;39;112
"1534";"360470190003";14;4;55;3;29;105
"1535";"360470191001";20;24;24;8;48;124
"1536";"360470191002";7;18;14;1;13;53
"1537";"360470191003";11;26;8;4;12;61
"1538";"360470192001";2;1;57;12;5;77
"1539";"360470192002";8;2;54;33;24;121
"1540";"360470193001";67;39;4;8;10;128
"1541";"360470193002";13;13;8;1;3;38
"1542";"360470193003";3;3;6;1;4;17
"1543";"360470193004";8;13;7;2;1;31
"1544";"360470194001";8;7;59;18;17;109
"1545";"360470194002";22;2;16;12;17;69
"1546";"360470194003";15;0;28;4;5;52
"1547";"360470195001";20;39;28;4;15;106
"1548";"360470195002";45;12;33;2;6;98
"1549";"360470195003";28;19;6;0;9;62
"1550";"360470195004";12;4;21;0;3;40
"1551";"360470196001";33;4;36;8;35;116
"1552";"360470196002";28;2;39;10;10;89
"1553";"360470196003";39;3;38;2;23;105
"1554";"360470197001";5;3;47;3;3;61
"1555";"360470197002";54;55;15;0;10;134
"1556";"360470197003";18;28;18;2;9;75
"1557";"360470197004";12;27;19;9;18;85
"1558";"360470198001";1;3;23;14;9;50
"1559";"360470198002";5;2;25;12;21;65
"1560";"360470199001";35;25;14;1;2;77
"1561";"360470199002";19;10;2;0;14;45
"1562";"360470199003";14;40;19;2;45;120
"1563";"360470199004";20;8;20;3;4;55
"1564";"360470200001";11;3;32;7;13;66
"1565";"360470200002";4;18;37;4;18;81
"1566";"360470201001";10;23;11;11;16;71
"1567";"360470201002";16;54;25;8;37;140
"1568";"360470201003";24;14;22;3;24;87
"1569";"360470201004";17;5;13;3;4;42
"1570";"360470202001";1;2;30;6;8;47
"1571";"360470202002";2;2;20;1;4;29
"1572";"360470203001";37;65;45;52;65;264
"1573";"360470203002";13;25;15;4;12;69
"1574";"360470204001";3;0;41;5;11;60
"1575";"360470204002";7;0;17;2;6;32
"1576";"360470205001";19;34;37;8;10;108
"1577";"360470205002";21;83;27;2;18;151
"1578";"360470205003";24;32;14;4;5;79
"1579";"360470206001";8;0;26;6;10;50
"1580";"360470206002";5;6;37;14;13;75
"1581";"360470207001";104;25;18;2;10;159
"1582";"360470207002";71;64;8;4;18;165
"1583";"360470207003";23;10;20;3;4;60
"1584";"360470208001";6;1;48;1;17;73
"1585";"360470208002";13;0;29;5;20;67
"1586";"360470208003";14;1;36;3;16;70
"1587";"360470210001";9;5;32;8;14;68
"1588";"360470210002";1;2;41;11;33;88
"1589";"360470210003";7;7;19;4;12;49
"1590";"360470211001";3;3;1;1;3;11
"1591";"360470211002";14;15;29;6;22;86
"1592";"360470212001";11;3;39;2;26;81
"1593";"360470212002";12;1;21;1;25;60
"1594";"360470212003";6;1;38;4;18;67
"1595";"360470213001";66;6;14;1;14;101
"1596";"360470213002";184;18;4;1;6;213
"1597";"360470213003";80;9;9;2;13;113
"1598";"360470214001";21;1;35;8;17;82
"1599";"360470214002";8;4;16;8;19;55
"1600";"360470215001";38;75;19;1;8;141
"1601";"360470215002";58;50;22;3;10;143
"1602";"360470215003";70;53;13;1;19;156
"1603";"360470215004";57;50;6;2;18;133
"1604";"360470216001";6;6;27;6;3;48
"1605";"360470216002";5;5;23;5;2;40
"1606";"360470216003";8;7;51;2;33;101
"1607";"360470217001";84;20;27;4;34;169
"1608";"360470217002";120;44;18;5;26;213
"1609";"360470218001";16;5;9;6;7;43
"1610";"360470218002";4;0;10;3;4;21
"1611";"360470218003";3;4;23;2;7;39
"1612";"360470219001";66;20;1;1;16;104
"1613";"360470219002";26;10;8;2;11;57
"1614";"360470219003";54;44;19;7;37;161
"1615";"360470220001";1;4;34;1;12;52
"1616";"360470220002";4;1;25;8;27;65
"1617";"360470220003";5;1;12;0;6;24
"1618";"360470220004";2;4;25;5;12;48
"1619";"360470221001";29;45;13;3;19;109
"1620";"360470221002";77;48;31;2;42;200
"1621";"360470221003";25;15;7;1;23;71
"1622";"360470222001";10;2;33;12;13;70
"1623";"360470222002";7;20;9;13;12;61
"1624";"360470222003";21;4;37;1;17;80
"1625";"360470224001";1;9;30;6;6;52
"1626";"360470224002";2;0;19;4;13;38
"1627";"360470224003";23;2;42;3;7;77
"1628";"360470224004";16;35;85;10;16;162
"1629";"360470226001";14;8;75;37;27;161
"1630";"360470226002";28;9;45;31;31;144
"1631";"360470227001";44;22;35;8;17;126
"1632";"360470227002";19;72;28;8;49;176
"1633";"360470227003";33;28;29;6;39;135
"1634";"360470227004";196;56;27;9;69;357
"1635";"360470228001";7;16;33;0;29;85
"1636";"360470228002";2;19;53;19;23;116
"1637";"360470228003";1;3;24;11;8;47
"1638";"360470229001";63;17;12;2;16;110
"1639";"360470229002";29;11;16;1;19;76
"1640";"360470229003";44;21;13;10;10;98
"1641";"360470229004";33;17;13;7;19;89
"1642";"360470230001";30;2;5;4;10;51
"1643";"360470230002";3;1;11;3;5;23
"1644";"360470230003";12;2;30;17;16;77
"1645";"360470231001";38;41;22;3;14;118
"1646";"360470231002";45;62;26;7;38;178
"1647";"360470231003";29;33;10;3;15;90
"1648";"360470232001";1;1;43;1;10;56
"1649";"360470232002";6;3;28;1;6;44
"1650";"360470232003";2;1;3;1;8;15
"1651";"360470232004";6;1;6;7;8;28
"1652";"360470232005";5;5;15;0;8;33
"1653";"360470233001";22;240;11;2;25;300
"1654";"360470233002";49;13;3;0;4;69
"1655";"360470233003";50;101;53;13;60;277
"1656";"360470234001";0;6;18;3;9;36
"1657";"360470234002";27;3;18;8;11;67
"1658";"360470234003";2;3;47;5;6;63
"1659";"360470235001";107;69;58;13;48;295
"1660";"360470235002";27;23;18;5;35;108
"1661";"360470236001";1;2;28;3;7;41
"1662";"360470236002";11;4;9;4;9;37
"1663";"360470236003";0;4;21;0;8;33
"1664";"360470236004";2;10;15;0;1;28
"1665";"360470238001";2;3;28;7;3;43
"1666";"360470238002";13;3;14;1;6;37
"1667";"360470238003";2;8;20;2;19;51
"1668";"360470240001";8;4;19;2;2;35
"1669";"360470240002";5;2;30;10;6;53
"1670";"360470240003";7;1;14;0;0;22
"1671";"360470241001";50;63;30;13;85;241
"1672";"360470241002";46;11;22;3;34;116
"1673";"360470242001";1;2;26;7;10;46
"1674";"360470242002";4;2;32;6;14;58
"1675";"360470243001";89;17;22;3;32;163
"1676";"360470243002";220;13;50;9;59;351
"1677";"360470243003";45;43;36;5;17;146
"1678";"360470244001";2;1;57;5;16;81
"1679";"360470244002";4;5;35;3;15;62
"1680";"360470244003";6;5;270;7;41;329
"1681";"360470245001";58;21;25;4;31;139
"1682";"360470245002";50;24;56;3;34;167
"1683";"360470245003";19;16;5;3;10;53
"1684";"360470245004";29;24;6;1;13;73
"1685";"360470246001";0;1;20;3;6;30
"1686";"360470246002";3;2;13;5;23;46
"1687";"360470246003";3;1;48;12;11;75
"1688";"360470247001";28;30;13;3;14;88
"1689";"360470247002";87;27;20;23;32;189
"1690";"360470248001";1;4;51;6;20;82
"1691";"360470248002";10;26;105;32;35;208
"1692";"360470249001";18;12;4;7;22;63
"1693";"360470249002";42;15;8;3;25;93
"1694";"360470249003";66;77;12;5;27;187
"1695";"360470249004";27;4;1;3;9;44
"1696";"360470250001";6;8;49;81;42;186
"1697";"360470250002";1;8;20;4;7;40
"1698";"360470251001";61;6;6;3;38;114
"1699";"360470251002";88;20;5;5;22;140
"1700";"360470251003";59;7;13;0;31;110
"1701";"360470252001";8;2;16;0;10;36
"1702";"360470252002";73;20;15;0;10;118
"1703";"360470252003";15;3;24;2;12;56
"1704";"360470252004";21;7;71;2;13;114
"1705";"360470253001";27;13;35;7;32;114
"1706";"360470253002";24;17;8;8;16;73
"1707";"360470253003";14;14;17;3;21;69
"1708";"360470254001";24;1;13;2;21;61
"1709";"360470254002";13;2;22;3;21;61
"1710";"360470254003";9;5;18;3;16;51
"1711";"360470255001";77;12;4;1;3;97
"1712";"360470255002";28;2;6;1;3;40
"1713";"360470256001";3;4;51;2;37;97
"1714";"360470256002";7;1;36;3;21;68
"1715";"360470257001";54;7;24;9;42;136
"1716";"360470257002";15;3;55;1;14;88
"1717";"360470257003";26;18;61;5;20;130
"1718";"360470258001";14;1;25;0;17;57
"1719";"360470258002";9;3;30;0;30;72
"1720";"360470258003";54;3;34;3;19;113
"1721";"360470259011";86;19;18;8;38;169
"1722";"360470259021";143;8;4;0;12;167
"1723";"360470260001";3;1;16;4;18;42
"1724";"360470260002";5;2;19;4;9;39
"1725";"360470260003";4;2;42;5;24;77
"1726";"360470261001";38;12;36;2;10;98
"1727";"360470261002";30;11;5;1;18;65
"1728";"360470261003";43;7;15;1;18;84
"1729";"360470261004";21;12;21;0;23;77
"1730";"360470261005";29;6;36;1;51;123
"1731";"360470262001";5;4;31;5;28;73
"1732";"360470262002";4;6;16;4;16;46
"1733";"360470263001";77;21;49;11;27;185
"1734";"360470264001";5;5;11;6;6;33
"1735";"360470264002";434;6;14;1;21;476
"1736";"360470264003";32;8;57;12;27;136
"1737";"360470264004";3;1;4;5;13;26
"1738";"360470265001";31;6;9;5;14;65
"1739";"360470265002";116;22;5;1;18;162
"1740";"360470265003";32;8;7;0;26;73
"1741";"360470265004";96;11;5;3;10;125
"1742";"360470266001";15;2;22;6;11;56
"1743";"360470266002";25;8;30;3;12;78
"1744";"360470266003";4;1;46;4;16;71
"1745";"360470267001";19;3;0;0;16;38
"1746";"360470267002";5;8;15;2;16;46
"1747";"360470267003";16;8;41;0;18;83
"1748";"360470267004";15;7;28;1;11;62
"1749";"360470268001";16;0;26;1;4;47
"1750";"360470268002";5;3;27;2;8;45
"1751";"360470268003";8;12;40;1;29;90
"1752";"360470268004";9;6;26;9;9;59
"1753";"360470269001";20;14;4;0;17;55
"1754";"360470269002";12;24;9;0;32;77
"1755";"360470269003";35;39;11;2;49;136
"1756";"360470270001";8;5;39;5;12;69
"1757";"360470270002";9;18;47;2;7;83
"1758";"360470271001";96;21;35;10;50;212
"1759";"360470271002";14;12;49;4;8;87
"1760";"360470272001";0;1;45;0;9;55
"1761";"360470272002";15;10;8;1;15;49
"1762";"360470272003";11;22;23;4;19;79
"1763";"360470273001";7;10;10;3;3;33
"1764";"360470273002";24;7;9;5;3;48
"1765";"360470273003";17;11;5;5;16;54
"1766";"360470274001";3;15;25;8;11;62
"1767";"360470274002";14;5;52;14;19;104
"1768";"360470275001";35;10;25;1;9;80
"1769";"360470275002";52;19;7;7;25;110
"1770";"360470275003";25;9;5;3;19;61
"1771";"360470275004";27;8;2;1;22;60
"1772";"360470276001";3;5;15;3;28;54
"1773";"360470276002";11;2;24;3;20;60
"1774";"360470276003";52;2;36;16;30;136
"1775";"360470277001";29;9;2;2;5;47
"1776";"360470277002";19;20;8;2;8;57
"1777";"360470277003";26;8;3;0;9;46
"1778";"360470277004";27;3;5;7;14;56
"1779";"360470278001";31;4;43;2;16;96
"1780";"360470278002";35;28;42;15;43;163
"1781";"360470279001";47;24;12;1;19;103
"1782";"360470279002";55;16;7;4;15;97
"1783";"360470279003";42;11;24;17;23;117
"1784";"360470279004";23;4;11;5;19;62
"1785";"360470280001";3;2;28;4;3;40
"1786";"360470280002";8;20;34;4;20;86
"1787";"360470281001";62;11;60;0;8;141
"1788";"360470281002";23;7;36;1;20;87
"1789";"360470281003";24;14;11;0;23;72
"1790";"360470282001";40;0;22;4;2;68
"1791";"360470282002";24;1;24;5;12;66
"1792";"360470282003";2;1;22;2;3;30
"1793";"360470283001";47;5;8;2;13;75
"1794";"360470283002";20;2;6;2;8;38
"1795";"360470283003";33;6;16;6;18;79
"1796";"360470284001";31;2;44;4;13;94
"1797";"360470284002";39;0;52;3;18;112
"1798";"360470284003";14;3;44;0;13;74
"1799";"360470285011";14;10;34;3;18;79
"1800";"360470285021";133;11;7;2;4;157
"1801";"360470286001";28;0;1;0;2;31
"1802";"360470286002";18;2;33;0;7;60
"1803";"360470286003";14;1;3;0;1;19
"1804";"360470286004";0;14;42;7;4;67
"1805";"360470286005";6;4;46;9;19;84
"1806";"360470287001";19;69;8;4;44;144
"1807";"360470287002";24;9;10;8;21;72
"1808";"360470287003";62;17;6;1;13;99
"1809";"360470288001";3;1;19;3;13;39
"1810";"360470288002";23;1;24;4;29;81
"1811";"360470288003";14;1;36;2;15;68
"1812";"360470289001";15;14;7;1;31;68
"1813";"360470289002";19;7;21;6;18;71
"1814";"360470289003";40;22;13;1;19;95
"1815";"360470289004";114;7;2;2;16;141
"1816";"360470290001";32;3;23;4;2;64
"1817";"360470290002";40;2;43;3;5;93
"1818";"360470290003";34;9;80;7;22;152
"1819";"360470291001";35;11;25;2;10;83
"1820";"360470291002";20;10;23;3;32;88
"1821";"360470291003";14;4;3;2;9;32
"1822";"360470292001";14;5;49;6;21;95
"1823";"360470292002";28;3;58;4;13;106
"1824";"360470293001";28;15;16;2;11;72
"1825";"360470293002";18;6;8;2;4;38
"1826";"360470293003";8;6;12;3;8;37
"1827";"360470293004";41;12;13;1;13;80
"1828";"360470294001";23;22;54;11;6;116
"1829";"360470295001";19;11;13;1;20;64
"1830";"360470295002";36;11;2;3;33;85
"1831";"360470295003";45;11;7;0;24;87
"1832";"360470295004";25;1;14;7;7;54
"1833";"360470296001";57;1;73;1;12;144
"1834";"360470296002";8;5;63;2;16;94
"1835";"360470296003";25;1;93;1;7;127
"1836";"360470296004";6;3;31;4;5;49
"1837";"360470297001";44;14;6;8;14;86
"1838";"360470297002";57;16;4;5;8;90
"1839";"360470297003";16;7;7;2;13;45
"1840";"360470298001";13;2;41;15;12;83
"1841";"360470298002";5;3;47;4;20;79
"1842";"360470298003";14;4;48;3;33;102
"1843";"360470299001";27;4;28;5;34;98
"1844";"360470299002";32;3;1;2;28;66
"1845";"360470300001";11;59;57;4;34;165
"1846";"360470300002";5;8;50;6;25;94
"1847";"360470301001";15;4;23;31;18;91
"1848";"360470301002";9;5;6;7;6;33
"1849";"360470301003";64;9;15;5;19;112
"1850";"360470302001";5;2;47;8;18;80
"1851";"360470302002";9;0;16;1;15;41
"1852";"360470302003";4;2;23;2;12;43
"1853";"360470303001";73;43;14;4;14;148
"1854";"360470303002";12;5;18;4;9;48
"1855";"360470303003";69;16;12;11;16;124
"1856";"360470304001";1;4;61;14;10;90
"1857";"360470304002";19;2;52;12;11;96
"1858";"360470304003";11;1;23;6;6;47
"1859";"360470305001";35;72;71;39;51;268
"1860";"360470305002";42;32;26;11;16;127
"1861";"360470305003";66;31;13;14;13;137
"1862";"360470305004";58;57;13;3;25;156
"1863";"360470306001";9;13;55;15;19;111
"1864";"360470307001";65;5;3;0;0;73
"1865";"360470307002";43;13;5;6;1;68
"1866";"360470307003";73;21;78;14;49;235
"1867";"360470308001";58;7;71;24;16;176
"1868";"360470309001";251;11;22;5;31;320
"1869";"360470309002";1;4;28;3;14;50
"1870";"360470311001";33;2;31;4;39;109
"1871";"360470311002";67;16;13;4;34;134
"1872";"360470311003";37;8;10;2;36;93
"1873";"360470313001";33;6;12;1;9;61
"1874";"360470313002";32;4;9;2;22;69
"1875";"360470313003";42;14;16;3;9;84
"1876";"360470313004";42;4;65;1;14;126
"1877";"360470314001";9;8;31;1;11;60
"1878";"360470314002";16;2;14;3;3;38
"1879";"360470314003";16;0;11;4;0;31
"1880";"360470314004";11;1;31;2;15;60
"1881";"360470315001";64;21;68;4;30;187
"1882";"360470315002";53;16;18;0;6;93
"1883";"360470315003";75;21;13;1;20;130
"1884";"360470315004";51;18;11;6;25;111
"1885";"360470317011";153;14;9;1;20;197
"1886";"360470317012";33;24;13;3;19;92
"1887";"360470317013";96;35;14;1;11;157
"1888";"360470317021";41;25;7;1;21;95
"1889";"360470317022";80;11;4;2;13;110
"1890";"360470317023";60;13;32;1;20;126
"1891";"360470319001";42;75;7;3;22;149
"1892";"360470319002";28;13;24;1;5;71
"1893";"360470319003";77;4;17;19;12;129
"1894";"360470321001";29;16;6;0;10;61
"1895";"360470321002";28;25;10;0;7;70
"1896";"360470321003";110;19;2;1;8;140
"1897";"360470321004";139;27;28;1;14;209
"1898";"360470323001";43;9;20;5;15;92
"1899";"360470323002";13;9;16;7;12;57
"1900";"360470323003";53;15;35;8;10;121
"1901";"360470325001";57;17;10;1;11;96
"1902";"360470325002";64;10;19;1;11;105
"1903";"360470325003";69;22;5;3;4;103
"1904";"360470326001";47;37;20;4;7;115
"1905";"360470326002";40;6;8;2;12;68
"1906";"360470326003";93;13;1;0;2;109
"1907";"360470326004";10;7;3;1;1;22
"1908";"360470326005";6;2;16;14;15;53
"1909";"360470327001";56;25;9;0;10;100
"1910";"360470327002";56;8;24;8;10;106
"1911";"360470327003";50;11;12;1;8;82
"1912";"360470328001";13;18;7;4;3;45
"1913";"360470328002";2;3;6;3;1;15
"1914";"360470328003";27;4;8;1;2;42
"1915";"360470328004";11;3;13;14;17;58
"1916";"360470329001";67;19;26;3;19;134
"1917";"360470329002";62;8;18;2;11;101
"1918";"360470329003";31;23;5;0;4;63
"1919";"360470329004";76;7;1;5;7;96
"1920";"360470330001";156;7;2;2;5;172
"1921";"360470330002";7;1;1;3;1;13
"1922";"360470330003";84;17;4;5;0;110
"1923";"360470331001";43;11;13;1;5;73
"1924";"360470331002";107;5;14;14;12;152
"1925";"360470331003";3;2;8;0;11;24
"1926";"360470333001";93;5;9;1;6;114
"1927";"360470333002";10;5;24;4;4;47
"1928";"360470333003";27;1;10;4;24;66
"1929";"360470335001";26;4;16;5;7;58
"1930";"360470335002";5;5;5;3;7;25
"1931";"360470335003";36;10;14;4;7;71
"1932";"360470336001";2;1;8;2;22;35
"1933";"360470336002";3;7;7;4;13;34
"1934";"360470336003";0;0;0;0;8;8
"1935";"360470336004";0;1;1;0;10;12
"1936";"360470336005";9;2;2;0;17;30
"1937";"360470337001";39;11;17;0;13;80
"1938";"360470337002";15;21;17;1;24;78
"1939";"360470337003";43;9;39;2;22;115
"1940";"360470339001";39;8;54;9;16;126
"1941";"360470339002";43;28;12;4;28;115
"1942";"360470339003";38;31;21;3;25;118
"1943";"360470339004";18;10;15;6;10;59
"1944";"360470340001";34;3;5;3;4;49
"1945";"360470340002";3;7;2;2;1;15
"1946";"360470341001";58;8;10;1;6;83
"1947";"360470341002";26;2;9;1;3;41
"1948";"360470341003";69;7;8;7;20;111
"1949";"360470342001";39;16;7;1;2;65
"1950";"360470342002";84;0;5;1;5;95
"1951";"360470342003";59;4;5;0;2;70
"1952";"360470342004";19;1;1;2;1;24
"1953";"360470343001";234;2;1;7;0;244
"1954";"360470343002";113;21;31;1;28;194
"1955";"360470343003";265;14;25;0;17;321
"1956";"360470345001";74;13;11;10;22;130
"1957";"360470345002";96;13;21;22;25;177
"1958";"360470347001";42;13;17;4;3;79
"1959";"360470347002";35;7;22;1;18;83
"1960";"360470347003";36;12;27;1;11;87
"1961";"360470348001";14;9;91;33;28;175
"1962";"360470348002";17;3;32;3;11;66
"1963";"360470349001";43;21;10;2;18;94
"1964";"360470349002";56;6;15;1;15;93
"1965";"360470349003";72;18;29;3;28;150
"1966";"360470349004";30;6;7;2;4;49
"1967";"360470350001";0;2;0;0;1;3
"1968";"360470350002";1;15;15;3;9;43
"1969";"360470351001";78;18;14;3;25;138
"1970";"360470351002";20;9;32;2;13;76
"1971";"360470351003";110;15;59;5;20;209
"1972";"360470352001";116;61;8;0;20;205
"1973";"360470353001";59;13;7;4;11;94
"1974";"360470353002";56;13;10;11;23;113
"1975";"360470353003";103;12;21;7;24;167
"1976";"360470354001";24;3;9;1;0;37
"1977";"360470354002";56;4;7;3;24;94
"1978";"360470354003";0;14;5;1;1;21
"1979";"360470355001";123;12;9;4;27;175
"1980";"360470355002";63;5;10;5;18;101
"1981";"360470355003";36;16;18;6;21;97
"1982";"360470356011";5;6;4;4;1;20
"1983";"360470356021";5;15;3;1;0;24
"1984";"360470356022";9;25;19;1;0;54
"1985";"360470356023";4;29;32;2;3;70
"1986";"360470357001";122;36;27;2;37;224
"1987";"360470359001";60;18;15;4;18;115
"1988";"360470359002";42;23;19;1;7;92
"1989";"360470359003";40;10;41;7;20;118
"1990";"360470359004";105;5;4;0;12;126
"1991";"360470360011";10;43;10;0;9;72
"1992";"360470360012";5;6;10;0;5;26
"1993";"360470360013";22;20;9;0;4;55
"1994";"360470360021";20;30;5;4;8;67
"1995";"360470360022";29;17;10;0;12;68
"1996";"360470361001";12;4;7;6;13;42
"1997";"360470361002";36;4;27;11;19;97
"1998";"360470361003";66;8;5;3;19;101
"1999";"360470362001";54;8;73;2;57;194
"2000";"360470362002";20;10;29;4;37;100
"2001";"360470362003";22;0;34;8;9;73
"2002";"360470363001";11;1;11;15;8;46
"2003";"360470363002";35;15;16;4;19;89
"2004";"360470363003";56;20;26;12;26;140
"2005";"360470363004";9;1;11;2;0;23
"2006";"360470364001";62;27;93;9;59;250
"2007";"360470364002";22;7;59;3;30;121
"2008";"360470365011";24;8;14;8;4;58
"2009";"360470365012";22;11;29;12;12;86
"2010";"360470365021";27;33;50;29;49;188
"2011";"360470366001";12;15;26;8;18;79
"2012";"360470366002";8;14;35;8;28;93
"2013";"360470366003";20;4;26;7;21;78
"2014";"360470367001";28;6;40;21;31;126
"2015";"360470367002";7;4;4;2;5;22
"2016";"360470369001";38;55;20;19;19;151
"2017";"360470369002";29;6;10;6;28;79
"2018";"360470369003";58;16;14;10;29;127
"2019";"360470369004";27;6;19;4;29;85
"2020";"360470370001";44;5;57;5;12;123
"2021";"360470370002";10;5;44;5;11;75
"2022";"360470370003";0;4;86;2;8;100
"2023";"360470370004";6;5;26;13;7;57
"2024";"360470371001";29;15;5;3;19;71
"2025";"360470371002";24;11;12;1;13;61
"2026";"360470371003";21;7;20;3;10;61
"2027";"360470371004";14;16;15;2;16;63
"2028";"360470371005";15;15;9;13;21;73
"2029";"360470373001";69;12;4;2;12;99
"2030";"360470373002";21;4;9;2;19;55
"2031";"360470373003";38;13;3;2;8;64
"2032";"360470373004";20;10;10;4;24;68
"2033";"360470374011";42;1;57;6;8;114
"2034";"360470374012";28;7;58;10;15;118
"2035";"360470374013";46;5;19;4;6;80
"2036";"360470374021";7;13;27;8;17;72
"2037";"360470374022";75;3;18;1;2;99
"2038";"360470374023";1;3;0;5;2;11
"2039";"360470374024";7;6;33;8;21;75
"2040";"360470375001";54;26;3;12;16;111
"2041";"360470375002";73;9;15;3;23;123
"2042";"360470375003";86;10;20;1;17;134
"2043";"360470377001";42;29;3;1;12;87
"2044";"360470377002";81;67;11;1;11;171
"2045";"360470377003";59;27;2;2;19;109
"2046";"360470377004";45;16;9;7;20;97
"2047";"360470379001";31;30;2;1;8;72
"2048";"360470379002";46;11;52;4;14;127
"2049";"360470379003";20;15;10;9;12;66
"2050";"360470381001";52;11;7;4;20;94
"2051";"360470381002";51;7;5;8;1;72
"2052";"360470381003";15;8;12;0;19;54
"2053";"360470381004";21;9;1;1;11;43
"2054";"360470382001";6;2;41;7;6;62
"2055";"360470382002";239;14;5;4;5;267
"2056";"360470382003";14;1;0;0;1;16
"2057";"360470383001";51;38;13;2;3;107
"2058";"360470383002";30;9;10;1;16;66
"2059";"360470383003";34;28;8;6;16;92
"2060";"360470383004";32;8;15;3;9;67
"2061";"360470385001";48;13;10;1;18;90
"2062";"360470385002";16;5;6;7;3;37
"2063";"360470385003";45;22;7;4;25;103
"2064";"360470385004";9;7;16;1;4;37
"2065";"360470386001";18;3;135;48;43;247
"2066";"360470386002";8;14;36;13;14;85
"2067";"360470387001";30;23;20;8;28;109
"2068";"360470387002";14;3;35;4;17;73
"2069";"360470387003";57;18;23;3;21;122
"2070";"360470387004";65;9;18;4;22;118
"2071";"360470388001";21;0;20;3;2;46
"2072";"360470388002";7;4;39;1;12;63
"2073";"360470388003";5;3;19;3;11;41
"2074";"360470388004";1;1;11;2;1;16
"2075";"360470389001";61;25;11;19;25;141
"2076";"360470389002";22;68;22;19;40;171
"2077";"360470389003";16;7;44;17;53;137
"2078";"360470390001";6;1;48;16;10;81
"2079";"360470390002";2;5;37;14;4;62
"2080";"360470391001";39;8;13;17;6;83
"2081";"360470391002";24;44;33;12;39;152
"2082";"360470392001";9;156;34;0;7;206
"2083";"360470392002";24;12;39;5;10;90
"2084";"360470393001";19;6;43;11;15;94
"2085";"360470393002";31;10;29;13;32;115
"2086";"360470393003";33;49;17;1;52;152
"2087";"360470394001";7;7;18;4;10;46
"2088";"360470394002";4;0;25;2;2;33
"2089";"360470394003";2;4;21;7;9;43
"2090";"360470395001";81;65;31;2;13;192
"2091";"360470395002";70;3;32;4;30;139
"2092";"360470395003";48;9;14;1;27;99
"2093";"360470396001";5;4;21;2;7;39
"2094";"360470396002";11;5;30;5;14;65
"2095";"360470397001";22;4;46;2;23;97
"2096";"360470397002";22;4;25;0;17;68
"2097";"360470397003";39;11;19;8;30;107
"2098";"360470398001";12;16;59;32;22;141
"2099";"360470398002";6;4;14;37;54;115
"2100";"360470399001";68;13;26;3;36;146
"2101";"360470399002";19;12;28;7;17;83
"2102";"360470399003";35;15;16;0;7;73
"2103";"360470400001";7;2;22;7;15;53
"2104";"360470400002";10;0;21;6;9;46
"2105";"360470400003";6;77;29;5;38;155
"2106";"360470401001";33;6;10;1;9;59
"2107";"360470401002";30;18;19;2;35;104
"2108";"360470401003";60;8;27;4;49;148
"2109";"360470402001";23;2;58;8;28;119
"2110";"360470402002";4;11;33;6;20;74
"2111";"360470403001";38;18;13;13;32;114
"2112";"360470403002";172;21;15;1;16;225
"2113";"360470403003";16;14;20;4;26;80
"2114";"360470404001";10;2;19;4;10;45
"2115";"360470404002";9;14;26;4;15;68
"2116";"360470405001";6;28;107;28;36;205
"2117";"360470405002";10;1;13;10;11;45
"2118";"360470406001";15;5;40;4;18;82
"2119";"360470406002";1;1;40;1;7;50
"2120";"360470406003";8;3;123;0;24;158
"2121";"360470407001";1;0;2;0;0;3
"2122";"360470408001";6;0;14;6;10;36
"2123";"360470408002";5;5;17;3;22;52
"2124";"360470408003";14;4;39;4;29;90
"2125";"360470409001";43;3;46;15;32;139
"2126";"360470409002";83;30;30;2;18;163
"2127";"360470409003";16;9;30;1;24;80
"2128";"360470410001";11;7;38;10;13;79
"2129";"360470410002";13;4;16;7;9;49
"2130";"360470411001";29;6;35;1;14;85
"2131";"360470411002";16;6;26;3;12;63
"2132";"360470411003";11;0;15;3;18;47
"2133";"360470412001";8;12;53;5;30;108
"2134";"360470412002";18;6;105;4;25;158
"2135";"360470413001";34;9;26;6;29;104
"2136";"360470413002";41;21;35;0;20;117
"2137";"360470413003";18;2;19;7;23;69
"2138";"360470414011";55;4;15;2;10;86
"2139";"360470414012";4;0;41;6;7;58
"2140";"360470414021";33;1;5;2;4;45
"2141";"360470414022";20;3;13;4;4;44
"2142";"360470415001";30;11;41;7;12;101
"2143";"360470415002";54;13;26;10;42;145
"2144";"360470415003";7;2;22;3;6;40
"2145";"360470416001";12;4;51;5;9;81
"2146";"360470416002";19;1;28;4;2;54
"2147";"360470417001";23;3;3;0;2;31
"2148";"360470417002";24;6;4;1;3;38
"2149";"360470417003";61;20;12;4;13;110
"2150";"360470417004";21;11;18;1;19;70
"2151";"360470418001";10;30;17;4;11;72
"2152";"360470418002";11;9;20;3;4;47
"2153";"360470419001";32;9;32;4;9;86
"2154";"360470419002";16;9;9;1;14;49
"2155";"360470419003";9;5;14;2;4;34
"2156";"360470420001";7;18;25;7;10;67
"2157";"360470420002";9;3;60;10;14;96
"2158";"360470421001";37;13;21;2;11;84
"2159";"360470421002";27;7;16;6;28;84
"2160";"360470421003";40;19;15;1;17;92
"2161";"360470421004";38;11;45;8;33;135
"2162";"360470422001";36;0;24;0;15;75
"2163";"360470422002";7;21;51;12;23;114
"2164";"360470422003";14;3;35;12;6;70
"2165";"360470423001";20;36;46;10;38;150
"2166";"360470423002";35;28;46;5;38;152
"2167";"360470423003";33;2;16;3;15;69
"2168";"360470424001";9;6;49;8;16;88
"2169";"360470424002";31;15;46;21;13;126
"2170";"360470424003";31;1;85;3;17;137
"2171";"360470425001";81;34;43;1;32;191
"2172";"360470425002";21;46;28;7;20;122
"2173";"360470425003";33;137;110;5;14;299
"2174";"360470426001";23;7;50;10;12;102
"2175";"360470426002";12;3;41;5;10;71
"2176";"360470426003";8;11;18;3;19;59
"2177";"360470427001";69;58;26;1;21;175
"2178";"360470427002";92;72;40;2;35;241
"2179";"360470427003";223;101;20;4;34;382
"2180";"360470427004";21;46;38;1;20;126
"2181";"360470428001";31;4;22;4;6;67
"2182";"360470428002";39;2;36;4;6;87
"2183";"360470428003";10;2;27;2;14;55
"2184";"360470429001";44;92;20;1;26;183
"2185";"360470429002";34;20;34;3;28;119
"2186";"360470429003";28;29;5;3;19;84
"2187";"360470429004";79;28;5;0;29;141
"2188";"360470430001";29;2;25;2;5;63
"2189";"360470430002";12;14;9;0;4;39
"2190";"360470430003";12;6;37;4;7;66
"2191";"360470431001";58;13;11;1;36;119
"2192";"360470431002";68;27;1;3;27;126
"2193";"360470431003";41;5;11;2;28;87
"2194";"360470431004";86;42;19;3;39;189
"2195";"360470432001";20;2;56;7;7;92
"2196";"360470432002";25;8;41;7;17;98
"2197";"360470432003";28;24;32;12;22;118
"2198";"360470433001";13;7;5;2;7;34
"2199";"360470433002";19;24;13;2;14;72
"2200";"360470433003";39;21;23;4;46;133
"2201";"360470434001";10;1;31;3;19;64
"2202";"360470434002";13;3;43;2;11;72
"2203";"360470434003";57;103;27;7;13;207
"2204";"360470435001";37;18;7;2;20;84
"2205";"360470435002";42;22;18;5;25;112
"2206";"360470435003";12;9;18;3;33;75
"2207";"360470436001";13;4;18;4;10;49
"2208";"360470436002";27;7;16;2;12;64
"2209";"360470436003";33;2;29;4;9;77
"2210";"360470437001";51;8;29;1;22;111
"2211";"360470437002";42;29;19;1;22;113
"2212";"360470437003";52;45;13;5;18;133
"2213";"360470437004";25;15;12;3;13;68
"2214";"360470438001";16;14;36;0;7;73
"2215";"360470438002";43;6;82;14;22;167
"2216";"360470439001";25;18;45;14;23;125
"2217";"360470439002";19;10;26;5;31;91
"2218";"360470439003";24;7;12;4;27;74
"2219";"360470440001";6;1;11;9;4;31
"2220";"360470440002";6;0;200;12;8;226
"2221";"360470440003";2;0;44;28;23;97
"2222";"360470441001";67;45;41;10;41;204
"2223";"360470441002";52;19;25;2;43;141
"2224";"360470441003";44;11;21;3;25;104
"2225";"360470442001";6;37;43;22;16;124
"2226";"360470442002";23;2;29;3;5;62
"2227";"360470443001";9;3;10;5;6;33
"2228";"360470443002";76;19;45;16;38;194
"2229";"360470443003";49;25;33;5;15;127
"2230";"360470443004";17;11;26;0;20;74
"2231";"360470444001";2;0;26;7;11;46
"2232";"360470444002";6;4;10;7;9;36
"2233";"360470444003";24;11;42;2;21;100
"2234";"360470445001";31;14;27;3;12;87
"2235";"360470445002";30;20;73;12;33;168
"2236";"360470445003";68;46;24;4;20;162
"2237";"360470446001";8;9;30;2;10;59
"2238";"360470446002";1;1;32;4;22;60
"2239";"360470447001";54;48;25;6;56;189
"2240";"360470447002";13;27;38;6;56;140
"2241";"360470448001";20;7;39;8;19;93
"2242";"360470448002";21;5;38;21;5;90
"2243";"360470449001";6;11;9;4;11;41
"2244";"360470449002";108;13;5;1;4;131
"2245";"360470449003";13;31;38;17;30;129
"2246";"360470449004";4;2;74;51;63;194
"2247";"360470450001";6;10;55;22;3;96
"2248";"360470452001";1;4;47;3;4;59
"2249";"360470452002";82;8;24;7;4;125
"2250";"360470453001";22;28;53;18;72;193
"2251";"360470453002";65;82;50;37;56;290
"2252";"360470454001";4;6;24;4;20;58
"2253";"360470454002";2;3;20;7;4;36
"2254";"360470456001";24;12;28;28;36;128
"2255";"360470456002";75;11;46;9;6;147
"2256";"360470458001";20;2;73;2;6;103
"2257";"360470458002";4;1;18;6;1;30
"2258";"360470460001";17;6;80;3;10;116
"2259";"360470460002";32;14;54;5;25;130
"2260";"360470460003";7;1;37;16;24;85
"2261";"360470462011";17;4;51;5;22;99
"2262";"360470462012";14;15;270;7;23;329
"2263";"360470462021";12;2;23;6;5;48
"2264";"360470462022";21;6;48;15;19;109
"2265";"360470464001";3;11;20;12;7;53
"2266";"360470464002";23;2;12;2;16;55
"2267";"360470468001";9;47;71;2;27;156
"2268";"360470470001";0;8;23;4;6;41
"2269";"360470470002";1;3;10;4;3;21
"2270";"360470472001";0;0;17;14;5;36
"2271";"360470472002";6;15;50;3;27;101
"2272";"360470472003";0;1;27;3;3;34
"2273";"360470474001";3;2;10;13;8;36
"2274";"360470474002";0;1;22;19;3;45
"2275";"360470476001";10;24;20;13;21;88
"2276";"360470476002";0;1;15;5;7;28
"2277";"360470476003";2;1;33;5;16;57
"2278";"360470477001";36;36;25;18;25;140
"2279";"360470477002";60;24;54;4;56;198
"2280";"360470478001";18;5;45;9;55;132
"2281";"360470478002";5;5;7;3;12;32
"2282";"360470478003";6;6;57;5;20;94
"2283";"360470480001";16;6;33;1;23;79
"2284";"360470480002";9;2;55;11;38;115
"2285";"360470481001";29;8;14;4;14;69
"2286";"360470481002";31;4;18;2;16;71
"2287";"360470481003";59;41;37;7;41;185
"2288";"360470482001";38;3;68;20;13;142
"2289";"360470482002";9;11;36;34;17;107
"2290";"360470482003";32;1;51;3;8;95
"2291";"360470482004";125;24;29;11;10;199
"2292";"360470484001";28;16;39;7;24;114
"2293";"360470484002";22;11;53;10;73;169
"2294";"360470484003";23;5;29;9;16;82
"2295";"360470485001";92;100;87;39;155;473
"2296";"360470485002";138;129;63;12;54;396
"2297";"360470486001";8;18;53;3;41;123
"2298";"360470486002";29;14;47;5;58;153
"2299";"360470486003";23;15;37;19;31;125
"2300";"360470488001";20;7;55;3;41;126
"2301";"360470488002";11;6;28;7;16;68
"2302";"360470488003";11;6;31;2;17;67
"2303";"360470489001";252;11;4;1;1;269
"2304";"360470489002";22;1;7;0;6;36
"2305";"360470489003";49;1;0;0;2;52
"2306";"360470490001";56;6;38;9;18;127
"2307";"360470490002";49;3;36;2;19;109
"2308";"360470490003";16;14;73;2;37;142
"2309";"360470491001";8;4;0;0;4;16
"2310";"360470491002";47;113;4;1;23;188
"2311";"360470491003";83;72;27;10;7;199
"2312";"360470491004";31;7;5;1;4;48
"2313";"360470492001";20;18;23;16;24;101
"2314";"360470492002";34;20;67;26;47;194
"2315";"360470492003";17;69;62;22;34;204
"2316";"360470493001";188;26;1;0;20;235
"2317";"360470493002";77;94;9;2;22;204
"2318";"360470493003";20;9;12;2;12;55
"2319";"360470493004";18;18;2;4;2;44
"2320";"360470493005";41;72;2;4;13;132
"2321";"360470494001";70;12;20;10;6;118
"2322";"360470494002";54;12;22;4;22;114
"2323";"360470494003";48;3;26;0;6;83
"2324";"360470494004";0;1;17;0;5;23
"2325";"360470495001";19;23;10;2;13;67
"2326";"360470495002";26;39;8;8;57;138
"2327";"360470495003";11;58;11;8;21;109
"2328";"360470496001";23;19;49;4;43;138
"2329";"360470496002";8;6;48;6;55;123
"2330";"360470496003";8;7;72;8;63;158
"2331";"360470497001";9;17;13;1;24;64
"2332";"360470497002";36;44;24;1;23;128
"2333";"360470497003";41;35;40;11;22;149
"2334";"360470498001";37;9;26;6;19;97
"2335";"360470498002";8;2;14;2;20;46
"2336";"360470498003";18;17;32;18;15;100
"2337";"360470499001";14;11;3;0;9;37
"2338";"360470499002";47;13;16;7;41;124
"2339";"360470500001";21;2;15;6;6;50
"2340";"360470500002";13;6;21;5;8;53
"2341";"360470500003";36;8;25;2;16;87
"2342";"360470501001";8;5;14;6;17;50
"2343";"360470501002";20;6;6;3;13;48
"2344";"360470501003";8;25;28;7;38;106
"2345";"360470502021";12;16;46;0;26;100
"2346";"360470502022";8;1;38;6;12;65
"2347";"360470503001";32;73;33;6;18;162
"2348";"360470503002";55;31;6;2;12;106
"2349";"360470503003";6;76;30;5;42;159
"2350";"360470504001";3;4;13;2;5;27
"2351";"360470504002";49;20;18;5;12;104
"2352";"360470504003";29;17;29;22;18;115
"2353";"360470505001";30;12;1;2;2;47
"2354";"360470505002";39;116;15;9;45;224
"2355";"360470505003";29;81;8;0;34;152
"2356";"360470506001";50;9;20;3;12;94
"2357";"360470506002";44;4;22;2;7;79
"2358";"360470506003";49;13;13;2;13;90
"2359";"360470506004";29;15;4;5;29;82
"2360";"360470507001";13;33;25;15;56;142
"2361";"360470508011";132;16;5;0;12;165
"2362";"360470508012";168;24;13;2;11;218
"2363";"360470508031";522;36;15;4;17;594
"2364";"360470508041";102;27;8;1;9;147
"2365";"360470508042";164;16;65;2;15;262
"2366";"360470508043";170;4;21;0;12;207
"2367";"360470509001";4;23;57;15;23;122
"2368";"360470509002";31;18;7;2;10;68
"2369";"360470510011";54;5;3;0;13;75
"2370";"360470510012";175;44;6;0;42;267
"2371";"360470510021";111;14;12;1;12;150
"2372";"360470510022";49;15;5;1;13;83
"2373";"360470510023";81;11;2;0;5;99
"2374";"360470511001";3;7;4;2;5;21
"2375";"360470511002";36;69;23;6;41;175
"2376";"360470511003";53;24;7;4;26;114
"2377";"360470512001";71;23;7;13;16;130
"2378";"360470512002";115;13;6;2;17;153
"2379";"360470512003";65;19;4;4;6;98
"2380";"360470512004";86;38;10;3;8;145
"2381";"360470513001";13;60;36;5;42;156
"2382";"360470513002";58;40;12;6;15;131
"2383";"360470513003";75;77;54;9;63;278
"2384";"360470513004";29;37;10;2;12;90
"2385";"360470514001";54;32;38;3;12;139
"2386";"360470514002";55;18;24;7;12;116
"2387";"360470514003";68;46;14;2;13;143
"2388";"360470514004";180;14;25;5;15;239
"2389";"360470515001";13;53;21;9;41;137
"2390";"360470516011";80;5;10;9;5;109
"2391";"360470516012";85;4;23;1;11;124
"2392";"360470516013";157;31;58;10;49;305
"2393";"360470516021";174;18;26;8;6;232
"2394";"360470516022";63;23;25;7;44;162
"2395";"360470517001";25;38;17;2;33;115
"2396";"360470517002";9;152;34;3;32;230
"2397";"360470518001";34;6;22;3;10;75
"2398";"360470518002";62;18;39;9;8;136
"2399";"360470518003";73;31;22;5;9;140
"2400";"360470519001";44;46;28;5;56;179
"2401";"360470519002";36;40;29;2;35;142
"2402";"360470519003";28;175;65;12;57;337
"2403";"360470520001";28;40;38;12;17;135
"2404";"360470520002";26;9;20;7;9;71
"2405";"360470520003";31;9;2;2;3;47
"2406";"360470523001";55;258;2;3;139;457
"2407";"360470523002";43;231;5;2;32;313
"2408";"360470523003";98;38;9;1;25;171
"2409";"360470523004";12;34;13;0;9;68
"2410";"360470523005";17;53;5;0;15;90
"2411";"360470525001";52;85;14;5;35;191
"2412";"360470525002";113;30;6;0;29;178
"2413";"360470526001";27;29;53;7;32;148
"2414";"360470526002";87;19;42;12;27;187
"2415";"360470526003";1;5;17;8;3;34
"2416";"360470527001";40;26;14;5;30;115
"2417";"360470527002";14;45;0;0;14;73
"2418";"360470527003";30;37;31;8;20;126
"2419";"360470527004";27;109;2;1;15;154
"2420";"360470527005";28;36;4;1;28;97
"2421";"360470527006";28;56;18;3;12;117
"2422";"360470527007";4;29;12;1;8;54
"2423";"360470528001";20;4;14;7;10;55
"2424";"360470528002";5;2;46;5;19;77
"2425";"360470529001";2;8;11;1;10;32
"2426";"360470529002";28;14;3;4;21;70
"2427";"360470529003";28;21;15;4;17;85
"2428";"360470530001";31;3;42;14;12;102
"2429";"360470530002";22;8;32;3;15;80
"2430";"360470530003";6;3;53;36;23;121
"2431";"360470531001";12;10;8;1;17;48
"2432";"360470531002";3;21;15;8;10;57
"2433";"360470531003";0;3;2;1;4;10
"2434";"360470531004";5;2;5;0;0;12
"2435";"360470532001";7;4;44;2;27;84
"2436";"360470532002";44;5;31;2;11;93
"2437";"360470533001";1;0;1;0;2;4
"2438";"360470533002";1;1;3;0;8;13
"2439";"360470533003";0;6;2;0;1;9
"2440";"360470533004";6;2;4;1;10;23
"2441";"360470533005";0;2;3;2;10;17
"2442";"360470534001";56;4;45;1;12;118
"2443";"360470534002";34;4;14;0;11;63
"2444";"360470534003";30;3;16;4;8;61
"2445";"360470534004";31;7;22;6;8;74
"2446";"360470535001";2;1;8;2;7;20
"2447";"360470535002";0;1;1;5;5;12
"2448";"360470535003";0;3;2;3;7;15
"2449";"360470535004";1;9;14;5;17;46
"2450";"360470537001";0;7;1;2;4;14
"2451";"360470537002";3;5;15;2;14;39
"2452";"360470538001";38;4;16;1;11;70
"2453";"360470538002";63;5;20;3;12;103
"2454";"360470538003";28;38;108;5;19;198
"2455";"360470539001";0;2;2;11;4;19
"2456";"360470539002";10;7;2;1;5;25
"2457";"360470542001";26;6;118;11;22;183
"2458";"360470542002";22;13;69;25;28;157
"2459";"360470542003";10;3;44;10;8;75
"2460";"360470543001";3;11;11;13;3;41
"2461";"360470543002";5;65;43;3;44;160
"2462";"360470544001";11;6;44;1;18;80
"2463";"360470544002";15;0;56;2;18;91
"2464";"360470544003";19;6;56;1;11;93
"2465";"360470545001";1;0;0;1;5;7
"2466";"360470545002";4;22;1;1;4;32
"2467";"360470545003";16;24;2;0;9;51
"2468";"360470545004";2;0;0;0;2;4
"2469";"360470545005";133;10;2;7;4;156
"2470";"360470545006";37;26;10;0;16;89
"2471";"360470546001";27;3;43;1;3;77
"2472";"360470546002";117;8;48;3;11;187
"2473";"360470546003";32;9;32;5;13;91
"2474";"360470547001";51;27;16;7;18;119
"2475";"360470547002";6;21;113;1;16;157
"2476";"360470547003";20;25;76;7;23;151
"2477";"360470548001";19;1;55;36;2;113
"2478";"360470548002";8;5;26;31;12;82
"2479";"360470549001";29;41;20;4;38;132
"2480";"360470549002";57;140;37;8;59;301
"2481";"360470550001";54;2;34;7;4;101
"2482";"360470550002";19;3;47;11;22;102
"2483";"360470550003";43;3;59;2;15;122
"2484";"360470551001";30;92;27;3;76;228
"2485";"360470551002";36;98;15;1;26;176
"2486";"360470551003";88;41;18;8;38;193
"2487";"360470551004";25;38;14;3;16;96
"2488";"360470552001";17;6;56;4;14;97
"2489";"360470552002";23;16;25;6;13;83
"2490";"360470552003";14;2;44;5;14;79
"2491";"360470553001";23;99;20;1;58;201
"2492";"360470553002";40;41;9;2;43;135
"2493";"360470553003";19;96;21;5;49;190
"2494";"360470554001";128;8;20;0;35;191
"2495";"360470554002";83;4;31;1;10;129
"2496";"360470554003";19;4;54;6;23;106
"2497";"360470555001";124;173;141;17;133;588
"2498";"360470556001";20;10;58;8;17;113
"2499";"360470556002";21;5;18;1;5;50
"2500";"360470556003";11;0;47;4;33;95
"2501";"360470557001";17;48;21;4;24;114
"2502";"360470557002";37;28;37;7;38;147
"2503";"360470558001";33;4;46;5;20;108
"2504";"360470558002";29;70;70;6;13;188
"2505";"360470560001";15;4;51;27;11;108
"2506";"360470560002";242;3;30;2;6;283
"2507";"360470560003";30;3;23;13;7;76
"2508";"360470561001";19;6;11;10;20;66
"2509";"360470561002";7;2;7;9;6;31
"2510";"360470561003";9;26;23;1;26;85
"2511";"360470561004";11;8;16;1;38;74
"2512";"360470562001";6;0;12;34;2;54
"2513";"360470562002";3;0;27;31;4;65
"2514";"360470563001";8;40;19;2;14;83
"2515";"360470563002";37;85;14;0;24;160
"2516";"360470563003";22;53;22;0;18;115
"2517";"360470563004";28;68;11;3;23;133
"2518";"360470564001";8;31;20;10;6;75
"2519";"360470564002";18;3;16;13;4;54
"2520";"360470564003";4;2;19;6;14;45
"2521";"360470565001";49;152;23;4;48;276
"2522";"360470565002";12;8;18;1;11;50
"2523";"360470565003";34;32;12;2;13;93
"2524";"360470566001";24;6;22;17;10;79
"2525";"360470566002";4;11;12;12;6;45
"2526";"360470568001";1;7;15;12;17;52
"2527";"360470568002";4;1;10;5;13;33
"2528";"360470569001";13;116;5;0;46;180
"2529";"360470569002";67;28;28;1;35;159
"2530";"360470570001";4;2;4;2;3;15
"2531";"360470570002";11;1;5;2;1;20
"2532";"360470570003";3;1;16;7;0;27
"2533";"360470570004";11;6;39;14;15;85
"2534";"360470571001";21;8;6;5;31;71
"2535";"360470571002";16;8;11;4;19;58
"2536";"360470571003";8;14;6;5;23;56
"2537";"360470571004";9;7;8;11;19;54
"2538";"360470572001";228;11;3;9;6;257
"2539";"360470572002";312;15;0;5;7;339
"2540";"360470573001";9;3;20;1;29;62
"2541";"360470573002";18;9;16;2;4;49
"2542";"360470573003";9;6;20;1;17;53
"2543";"360470574001";11;5;9;19;10;54
"2544";"360470574002";3;3;15;10;21;52
"2545";"360470575001";18;27;9;3;29;86
"2546";"360470575002";9;7;12;7;15;50
"2547";"360470575003";26;65;12;1;20;124
"2548";"360470575004";9;26;35;4;19;93
"2549";"360470576001";9;11;18;14;20;72
"2550";"360470576002";3;11;30;13;15;72
"2551";"360470578001";36;4;61;12;18;131
"2552";"360470578002";73;3;60;3;20;159
"2553";"360470579001";11;4;13;0;13;41
"2554";"360470579002";6;9;75;31;53;174
"2555";"360470580001";36;304;37;2;20;399
"2556";"360470580002";25;213;40;2;18;298
"2557";"360470582001";11;2;37;3;14;67
"2558";"360470582002";11;5;9;4;5;34
"2559";"360470582003";24;28;47;7;11;117
"2560";"360470584001";20;2;47;11;8;88
"2561";"360470584002";62;14;91;13;14;194
"2562";"360470586001";12;3;39;6;23;83
"2563";"360470586002";6;5;38;16;12;77
"2564";"360470588001";40;5;96;6;29;176
"2565";"360470588002";25;0;35;1;15;76
"2566";"360470589001";35;4;24;10;44;117
"2567";"360470589002";28;12;20;1;20;81
"2568";"360470590001";16;19;99;18;27;179
"2569";"360470591001";27;2;12;4;14;59
"2570";"360470591002";15;7;9;6;12;49
"2571";"360470591003";5;1;10;3;12;31
"2572";"360470591004";7;19;10;1;13;50
"2573";"360470592001";11;2;15;1;0;29
"2574";"360470592002";27;12;64;15;20;138
"2575";"360470592003";28;3;18;3;8;60
"2576";"360470593001";0;1;27;9;47;84
"2577";"360470593002";40;24;5;4;34;107
"2578";"360470594011";0;2;20;18;4;44
"2579";"360470594012";3;2;43;19;40;107
"2580";"360470594013";9;7;37;38;15;106
"2581";"360470594014";5;4;69;35;41;154
"2582";"360470594015";31;2;19;16;6;74
"2583";"360470594016";34;4;28;16;3;85
"2584";"360470594021";17;9;13;6;16;61
"2585";"360470594022";6;2;38;10;2;58
"2586";"360470594023";7;0;45;17;8;77
"2587";"360470594024";1;1;45;9;15;71
"2588";"360470596001";6;4;4;6;12;32
"2589";"360470596002";1;1;2;3;0;7
"2590";"360470596003";5;5;32;17;8;67
"2591";"360470598001";26;1;35;50;37;149
"2592";"360470598002";16;3;34;29;10;92
"2593";"360470600001";32;1;26;8;3;70
"2594";"360470600002";18;1;74;24;21;138
"2595";"360470600003";16;3;78;64;36;197
"2596";"360470600004";10;0;36;7;8;61
"2597";"360470600005";14;11;43;4;18;90
"2598";"360470606001";12;9;23;4;30;78
"2599";"360470606002";4;0;31;10;8;53
"2600";"360470608001";23;14;43;14;24;118
"2601";"360470608002";12;2;33;18;23;88
"2602";"360470608003";80;13;47;3;14;157
"2603";"360470610021";21;10;21;0;8;60
"2604";"360470610022";31;21;18;1;9;80
"2605";"360470610031";13;6;16;0;16;51
"2606";"360470610032";19;1;24;7;14;65
"2607";"360470610041";16;36;50;1;27;130
"2608";"360470610042";15;5;39;4;18;81
"2609";"360470610043";8;11;81;8;7;115
"2610";"360470610044";39;1;6;2;5;53
"2611";"360470610045";20;13;20;0;20;73
"2612";"360470612001";28;7;38;6;14;93
"2613";"360470616001";13;1;106;16;45;181
"2614";"360470620001";4;5;28;10;15;62
"2615";"360470620002";3;7;48;2;14;74
"2616";"360470622001";49;7;101;15;37;209
"2617";"360470622002";12;31;26;26;31;126
"2618";"360470626001";14;3;21;14;10;62
"2619";"360470626002";11;10;15;19;20;75
"2620";"360470628001";1;3;21;23;12;60
"2621";"360470628002";13;25;47;33;38;156
"2622";"360470628003";3;0;13;20;19;55
"2623";"360470628004";5;1;29;38;29;102
"2624";"360470632001";64;2;6;7;5;84
"2625";"360470632002";0;0;18;9;1;28
"2626";"360470636001";9;5;25;13;8;60
"2627";"360470638001";1;0;7;9;1;18
"2628";"360470638002";1;2;15;17;13;48
"2629";"360470640001";8;7;23;15;14;67
"2630";"360470640002";1;2;14;12;11;40
"2631";"360470642001";45;7;36;30;22;140
"2632";"360470642002";21;0;41;26;3;91
"2633";"360470644001";1;4;52;8;19;84
"2634";"360470644002";6;3;30;29;22;90
"2635";"360470646001";6;6;40;18;16;86
"2636";"360470646002";5;6;24;19;24;78
"2637";"360470648001";31;14;43;84;41;213
"2638";"360470648002";7;0;22;30;8;67
"2639";"360470650001";1;11;25;10;8;55
"2640";"360470650002";44;11;20;50;24;149
"2641";"360470652001";16;67;32;21;40;176
"2642";"360470654001";12;0;25;18;6;61
"2643";"360470654002";0;2;23;4;11;40
"2644";"360470656001";7;19;22;7;16;71
"2645";"360470656002";1;0;10;4;5;20
"2646";"360470658001";2;1;42;12;12;69
"2647";"360470658002";2;3;23;17;9;54
"2648";"360470660001";5;1;30;5;15;56
"2649";"360470660002";0;1;24;10;9;44
"2650";"360470662001";3;9;37;41;30;120
"2651";"360470666001";15;26;17;17;10;85
"2652";"360470670001";13;1;52;35;10;111
"2653";"360470670002";33;8;116;33;37;227
"2654";"360470672001";15;8;57;79;32;191
"2655";"360470674001";4;6;23;10;11;54
"2656";"360470674002";16;7;68;72;36;199
"2657";"360470676001";15;6;40;30;5;96
"2658";"360470676002";9;48;25;51;12;145
"2659";"360470678001";24;3;41;39;13;120
"2660";"360470678002";9;1;24;48;7;89
"2661";"360470680001";22;2;24;38;12;98
"2662";"360470680002";14;141;20;27;20;222
"2663";"360470682001";34;29;41;49;22;175
"2664";"360470682002";46;5;26;41;16;134
"2665";"360470686001";14;2;25;11;24;76
"2666";"360470686002";8;1;12;28;7;56
"2667";"360470688001";27;7;23;17;25;99
"2668";"360470688002";5;5;11;17;13;51
"2669";"360470690001";14;3;17;20;47;101
"2670";"360470690002";26;11;27;28;15;107
"2671";"360470692001";32;8;47;47;37;171
"2672";"360470692002";18;1;26;11;10;66
"2673";"360470696011";31;1;52;27;14;125
"2674";"360470696012";52;3;151;25;21;252
"2675";"360470696021";4;6;24;15;7;56
"2676";"360470696022";25;5;68;20;19;137
"2677";"360470696023";13;1;168;44;35;261
"2678";"360470698001";4;0;9;3;1;17
"2679";"360470698002";8;8;49;29;21;115
"2680";"360470700001";5;1;5;3;2;16
"2681";"360470700002";7;4;45;11;17;84
"2682";"360470702011";10;2;25;9;10;56
"2683";"360470702012";8;3;1;5;4;21
"2684";"360470702013";9;5;8;5;12;39
"2685";"360470702014";10;2;167;22;17;218
"2686";"360470702015";9;1;70;18;31;129
"2687";"360470702021";0;0;0;1;0;1
"2688";"360470706001";4;0;12;11;21;48
"2689";"360470706002";5;17;28;24;10;84
"2690";"360470720001";59;13;71;34;40;217
"2691";"360470722001";27;10;89;12;12;150
"2692";"360470722002";15;2;60;28;13;118
"2693";"360470724001";10;3;21;7;7;48
"2694";"360470724002";10;4;31;40;15;100
"2695";"360470726001";27;15;48;38;16;144
"2696";"360470728001";105;6;40;9;25;185
"2697";"360470728002";10;2;18;30;3;63
"2698";"360470730001";17;12;65;24;4;122
"2699";"360470730002";13;7;29;15;7;71
"2700";"360470732001";41;9;53;11;7;121
"2701";"360470732002";22;8;27;10;12;79
"2702";"360470734001";9;1;21;4;7;42
"2703";"360470734002";4;2;25;10;13;54
"2704";"360470736001";127;1;19;14;5;166
"2705";"360470736002";9;7;10;12;24;62
"2706";"360470736003";20;15;24;19;19;97
"2707";"360470738001";31;13;50;6;23;123
"2708";"360470738002";28;3;15;4;4;54
"2709";"360470738003";25;5;23;8;24;85
"2710";"360470740001";108;7;42;10;17;184
"2711";"360470740002";62;7;98;7;34;208
"2712";"360470742001";17;9;119;7;20;172
"2713";"360470742002";20;8;31;1;10;70
"2714";"360470744001";6;7;44;17;2;76
"2715";"360470744002";9;4;33;3;2;51
"2716";"360470746001";7;5;30;15;21;78
"2717";"360470746002";0;5;64;6;13;88
"2718";"360470748001";13;10;44;22;13;102
"2719";"360470748002";0;1;20;18;2;41
"2720";"360470750001";11;1;49;9;13;83
"2721";"360470750002";29;3;37;3;9;81
"2722";"360470752001";3;0;33;14;4;54
"2723";"360470754001";1;2;10;5;4;22
"2724";"360470754002";3;0;7;7;3;20
"2725";"360470756001";10;0;28;3;5;46
"2726";"360470756002";7;1;27;9;1;45
"2727";"360470758001";6;4;54;12;15;91
"2728";"360470758002";32;4;39;9;7;91
"2729";"360470760001";0;0;15;8;1;24
"2730";"360470760002";19;3;9;6;9;46
"2731";"360470760003";22;3;14;2;8;49
"2732";"360470762001";70;1;12;3;0;86
"2733";"360470762002";22;1;25;2;2;52
"2734";"360470762003";118;3;16;3;17;157
"2735";"360470764001";88;10;22;8;3;131
"2736";"360470764002";19;5;16;5;3;48
"2737";"360470764003";12;11;9;3;15;50
"2738";"360470766001";68;12;62;10;29;181
"2739";"360470768001";28;7;26;1;18;80
"2740";"360470768002";24;5;47;5;26;107
"2741";"360470768003";23;1;95;2;14;135
"2742";"360470770001";72;18;30;9;16;145
"2743";"360470770002";133;24;79;32;51;319
"2744";"360470772001";34;15;73;9;42;173
"2745";"360470772002";69;24;36;8;9;146
"2746";"360470774001";29;1;11;7;9;57
"2747";"360470774002";79;36;59;11;7;192
"2748";"360470776001";69;8;9;8;13;107
"2749";"360470776002";11;134;27;6;12;190
"2750";"360470776003";9;2;26;10;12;59
"2751";"360470780001";15;0;20;5;20;60
"2752";"360470780002";21;6;37;28;16;108
"2753";"360470782001";36;5;30;9;10;90
"2754";"360470782002";108;7;44;8;11;178
"2755";"360470784001";11;8;38;16;13;86
"2756";"360470784002";46;21;42;9;16;134
"2757";"360470786001";34;5;16;6;19;80
"2758";"360470786002";42;9;26;6;19;102
"2759";"360470786003";253;10;102;7;10;382
"2760";"360470788001";16;4;49;4;14;87
"2761";"360470788002";23;1;45;8;19;96
"2762";"360470788003";6;3;41;26;22;98
"2763";"360470790001";27;40;28;31;14;140
"2764";"360470790002";103;225;72;15;31;446
"2765";"360470790003";15;3;12;18;13;61
"2766";"360470790004";10;5;15;10;11;51
"2767";"360470792001";33;72;47;30;16;198
"2768";"360470792002";67;12;9;8;12;108
"2769";"360470792003";44;17;34;20;42;157
"2770";"360470794001";40;23;34;7;42;146
"2771";"360470794002";11;5;14;10;12;52
"2772";"360470796011";67;25;42;8;19;161
"2773";"360470796012";166;25;28;6;18;243
"2774";"360470796021";118;26;33;6;18;201
"2775";"360470796022";80;15;50;9;9;163
"2776";"360470798011";69;57;20;1;19;166
"2777";"360470798012";72;29;39;3;26;169
"2778";"360470798021";99;17;6;4;9;135
"2779";"360470798022";151;25;1;4;33;214
"2780";"360470798023";118;38;25;4;34;219
"2781";"360470800001";29;11;14;5;25;84
"2782";"360470800002";39;25;18;7;8;97
"2783";"360470800003";23;10;32;4;19;88
"2784";"360470802001";49;19;41;4;20;133
"2785";"360470802002";30;9;36;3;11;89
"2786";"360470802003";155;16;32;6;17;226
"2787";"360470804001";92;35;28;7;28;190
"2788";"360470804002";40;7;9;2;16;74
"2789";"360470804003";16;5;94;6;26;147
"2790";"360470806001";38;18;44;6;17;123
"2791";"360470806002";52;28;62;4;17;163
"2792";"360470808001";1;7;25;21;5;59
"2793";"360470810001";56;22;42;11;14;145
"2794";"360470810002";17;6;35;2;5;65
"2795";"360470814001";34;5;41;1;15;96
"2796";"360470814002";15;5;70;9;24;123
"2797";"360470816001";40;11;63;3;5;122
"2798";"360470816002";73;149;28;1;17;268
"2799";"360470818001";104;29;47;6;18;204
"2800";"360470818002";38;2;24;3;19;86
"2801";"360470818003";54;12;57;2;8;133
"2802";"360470820001";42;18;75;0;15;150
"2803";"360470820002";189;21;51;0;16;277
"2804";"360470820003";37;42;53;4;21;157
"2805";"360470822001";43;7;25;0;11;86
"2806";"360470822002";249;51;57;1;11;369
"2807";"360470822003";114;9;30;0;9;162
"2808";"360470822004";44;12;86;2;17;161
"2809";"360470824001";29;10;18;2;21;80
"2810";"360470824002";27;10;25;1;18;81
"2811";"360470824003";53;9;142;11;6;221
"2812";"360470824004";44;14;38;2;14;112
"2813";"360470826001";49;5;23;2;13;92
"2814";"360470826002";31;5;35;10;17;98
"2815";"360470826003";57;5;38;22;26;148
"2816";"360470826004";27;81;33;3;8;152
"2817";"360470828001";23;52;14;8;14;111
"2818";"360470828002";69;16;44;12;25;166
"2819";"360470828003";18;28;67;8;36;157
"2820";"360470830001";37;7;80;6;10;140
"2821";"360470830002";12;8;25;15;21;81
"2822";"360470830003";127;2;26;1;14;170
"2823";"360470830004";99;3;3;0;3;108
"2824";"360470832001";28;2;48;27;5;110
"2825";"360470832002";20;17;24;11;10;82
"2826";"360470834001";6;0;10;8;5;29
"2827";"360470834002";18;5;35;12;3;73
"2828";"360470836001";7;1;16;24;9;57
"2829";"360470836002";11;36;24;23;15;109
"2830";"360470838001";17;4;35;6;16;78
"2831";"360470838002";13;9;44;9;6;81
"2832";"360470840001";12;4;21;12;10;59
"2833";"360470840002";17;3;25;30;7;82
"2834";"360470846001";16;84;48;51;19;218
"2835";"360470846002";8;15;66;12;7;108
"2836";"360470848001";14;6;13;16;15;64
"2837";"360470848002";18;6;22;25;5;76
"2838";"360470850001";27;5;28;29;11;100
"2839";"360470852001";0;1;3;0;0;4
"2840";"360470854001";13;7;10;17;7;54
"2841";"360470854002";18;6;57;17;18;116
"2842";"360470856001";26;13;36;6;10;91
"2843";"360470856002";77;4;18;1;0;100
"2844";"360470856003";38;13;38;7;10;106
"2845";"360470858001";32;6;16;2;10;66
"2846";"360470858002";27;18;34;2;14;95
"2847";"360470860001";17;20;41;1;12;91
"2848";"360470860002";43;36;31;8;13;131
"2849";"360470860003";176;6;11;12;10;215
"2850";"360470862001";23;2;34;2;5;66
"2851";"360470862002";38;20;85;8;8;159
"2852";"360470862003";16;8;36;4;11;75
"2853";"360470864001";11;3;63;18;15;110
"2854";"360470864002";33;22;44;32;16;147
"2855";"360470866001";45;21;73;10;10;159
"2856";"360470866002";30;12;38;0;16;96
"2857";"360470866003";41;25;26;5;10;107
"2858";"360470868001";27;1;16;2;6;52
"2859";"360470868002";61;6;106;11;20;204
"2860";"360470868003";31;6;44;7;15;103
"2861";"360470870001";24;3;39;3;11;80
"2862";"360470870002";18;19;21;9;17;84
"2863";"360470870003";10;0;21;16;5;52
"2864";"360470872001";0;6;6;6;1;19
"2865";"360470872002";17;3;36;5;8;69
"2866";"360470872003";20;2;18;3;8;51
"2867";"360470874011";35;22;65;15;31;168
"2868";"360470874012";224;41;27;4;6;302
"2869";"360470876001";246;15;38;9;23;331
"2870";"360470876002";10;1;29;11;10;61
"2871";"360470878001";19;19;32;4;8;82
"2872";"360470878002";0;2;14;1;2;19
"2873";"360470878003";33;6;15;20;20;94
"2874";"360470880001";12;7;40;10;9;78
"2875";"360470880002";32;4;3;4;2;45
"2876";"360470880003";25;15;27;4;17;88
"2877";"360470882001";94;1;22;3;4;124
"2878";"360470882002";46;3;18;4;12;83
"2879";"360470882003";50;3;10;1;10;74
"2880";"360470882004";47;39;58;8;21;173
"2881";"360470884001";110;41;24;0;12;187
"2882";"360470884002";33;8;28;2;17;88
"2883";"360470884003";39;10;35;8;15;107
"2884";"360470886001";47;10;18;1;27;103
"2885";"360470886002";147;10;65;3;26;251
"2886";"360470886003";88;5;63;10;17;183
"2887";"360470888001";98;16;35;1;7;157
"2888";"360470888002";30;6;33;10;10;89
"2889";"360470888003";37;10;19;7;14;87
"2890";"360470890001";93;2;13;4;7;119
"2891";"360470890002";15;6;51;2;22;96
"2892";"360470890003";24;4;7;0;3;38
"2893";"360470890004";73;20;24;1;11;129
"2894";"360470890005";21;11;15;5;6;58
"2895";"360470890006";5;1;8;0;1;15
"2896";"360470892001";358;2;12;6;11;389
"2897";"360470892002";13;2;21;5;35;76
"2898";"360470892003";53;1;11;5;22;92
"2899";"360470892004";31;2;4;11;10;58
"2900";"360470894001";15;4;10;1;9;39
"2901";"360470894002";13;6;11;15;20;65
"2902";"360470894003";24;5;9;6;17;61
"2903";"360470894004";16;3;8;3;10;40
"2904";"360470896001";24;30;5;3;17;79
"2905";"360470896002";47;8;37;1;23;116
"2906";"360470896003";53;5;13;4;13;88
"2907";"360470898001";13;11;20;0;7;51
"2908";"360470898002";34;7;23;6;27;97
"2909";"360470900001";7;8;17;6;5;43
"2910";"360470900002";5;2;1;3;0;11
"2911";"360470900003";25;7;9;1;10;52
"2912";"360470900004";15;9;13;1;15;53
"2913";"360470900005";57;33;15;15;46;166
"2914";"360470900006";212;39;5;4;15;275
"2915";"360470900007";5;1;5;2;3;16
"2916";"360470902001";5;3;2;2;2;14
"2917";"360470902002";6;3;4;2;1;16
"2918";"360470902003";4;1;0;0;2;7
"2919";"360470902004";31;2;2;12;14;61
"2920";"360470902005";4;4;17;2;3;30
"2921";"360470906001";18;1;1;1;5;26
"2922";"360470906002";106;1;9;6;34;156
"2923";"360470906003";149;2;2;0;0;153
"2924";"360470908001";170;15;31;11;21;248
"2925";"360470908002";78;4;2;2;7;93
"2926";"360470908003";88;7;2;1;16;114
"2927";"360470910001";138;0;1;0;0;139
"2928";"360470910002";307;3;0;2;2;314
"2929";"360470910003";80;1;0;0;0;81
"2930";"360470910004";11;3;8;11;21;54
"2931";"360470912001";38;4;3;1;2;48
"2932";"360470912002";38;2;1;0;0;41
"2933";"360470912003";111;3;5;0;0;119
"2934";"360470916001";15;4;0;1;3;23
"2935";"360470916002";17;7;14;2;16;56
"2936";"360470916003";29;7;16;6;16;74
"2937";"360470916004";65;26;55;2;28;176
"2938";"360470918001";96;1;12;1;10;120
"2939";"360470918002";6;7;13;10;4;40
"2940";"360470920001";9;1;5;3;2;20
"2941";"360470920002";104;11;19;3;9;146
"2942";"360470920003";8;13;49;62;12;144
"2943";"360470922001";15;5;13;5;5;43
"2944";"360470922002";87;7;11;5;8;118
"2945";"360470924001";12;6;12;0;13;43
"2946";"360470924002";15;4;44;1;10;74
"2947";"360470924003";28;7;2;2;4;43
"2948";"360470928001";30;8;57;16;8;119
"2949";"360470928002";14;7;47;26;16;110
"2950";"360470930001";13;2;47;3;4;69
"2951";"360470930002";25;6;52;10;7;100
"2952";"360470932001";16;28;119;94;17;274
"2953";"360470934001";20;5;33;27;7;92
"2954";"360470934002";44;4;30;22;16;116
"2955";"360470936001";28;2;25;19;5;79
"2956";"360470936002";18;8;17;24;3;70
"2957";"360470938001";17;3;27;19;9;75
"2958";"360470938002";12;3;29;14;9;67
"2959";"360470944011";10;1;10;18;2;41
"2960";"360470944012";20;2;38;11;8;79
"2961";"360470944013";93;16;21;27;9;166
"2962";"360470944014";6;6;13;17;7;49
"2963";"360470944021";125;37;15;3;2;182
"2964";"360470946001";5;5;10;6;9;35
"2965";"360470946002";3;3;8;8;3;25
"2966";"360470946003";8;33;25;40;7;113
"2967";"360470950001";23;1;34;14;16;88
"2968";"360470950002";30;1;25;11;11;78
"2969";"360470954001";10;1;32;12;15;70
"2970";"360470954002";24;2;17;15;14;72
"2971";"360470954003";25;3;60;13;23;124
"2972";"360470956001";21;5;21;8;13;68
"2973";"360470956002";35;5;127;14;28;209
"2974";"360470958001";29;4;20;18;12;83
"2975";"360470958002";41;12;87;22;20;182
"2976";"360470960001";12;9;31;44;9;105
"2977";"360470962001";38;9;57;29;47;180
"2978";"360470964001";21;1;16;10;10;58
"2979";"360470964002";75;8;48;17;27;175
"2980";"360470966001";48;4;30;6;11;99
"2981";"360470966002";21;5;20;4;16;66
"2982";"360470968001";20;15;44;1;28;108
"2983";"360470968002";18;9;25;4;8;64
"2984";"360470970001";9;4;48;13;8;82
"2985";"360470970002";41;6;37;13;9;106
"2986";"360470974001";86;6;69;26;18;205
"2987";"360470974002";21;0;49;9;10;89
"2988";"360470982001";71;15;5;5;4;100
"2989";"360470982002";71;5;4;2;1;83
"2990";"360470984001";25;3;39;9;37;113
"2991";"360470986001";29;7;32;24;11;103
"2992";"360470986002";24;6;18;15;7;70
"2993";"360470988001";48;6;23;6;21;104
"2994";"360470988002";31;0;41;3;5;80
"2995";"360470990001";89;64;47;10;23;233
"2996";"360470992001";33;7;46;18;18;122
"2997";"360470994001";31;3;63;35;13;145
"2998";"360470996001";71;3;74;10;15;173
"2999";"360470996002";29;7;72;17;18;143
"3000";"360470998001";20;4;76;16;24;140
"3001";"360470998002";24;2;75;5;19;125
"3002";"360471004001";36;4;75;10;25;150
"3003";"360471006001";27;12;30;14;14;97
"3004";"360471006002";35;6;49;16;9;115
"3005";"360471008001";51;2;35;16;7;111
"3006";"360471008002";16;3;22;13;4;58
"3007";"360471010001";15;11;40;4;12;82
"3008";"360471010002";20;5;40;10;15;90
"3009";"360471012001";27;2;44;6;11;90
"3010";"360471012002";12;4;32;5;6;59
"3011";"360471014001";20;3;9;13;21;66
"3012";"360471014002";52;5;4;4;2;67
"3013";"360471016001";34;6;6;2;5;53
"3014";"360471018001";20;2;16;12;11;61
"3015";"360471020001";26;6;25;24;28;109
"3016";"360471022001";98;7;55;22;33;215
"3017";"360471024001";81;5;158;18;31;293
"3018";"360471026001";37;9;109;24;23;202
"3019";"360471028001";27;24;23;14;3;91
"3020";"360471028002";14;2;20;11;5;52
"3021";"360471034001";424;19;29;8;7;487
"3022";"360471058011";1;1;1;0;0;3
"3023";"360471058012";12;2;2;3;7;26
"3024";"360471058013";24;0;0;3;1;28
"3025";"360471058041";1;2;3;7;2;15
"3026";"360471058042";1;1;3;0;1;6
"3027";"360471058043";0;1;8;10;0;19
"3028";"360471058044";7;3;10;6;4;30
"3029";"360471070001";7;7;7;30;2;53
"3030";"360471078001";26;1;11;7;5;50
"3031";"360471078002";5;7;5;6;4;27
"3032";"360471078003";58;1;24;3;6;92
"3033";"360471078004";47;1;1;1;0;50
"3034";"360471098001";52;6;32;26;20;136
"3035";"360471098002";16;5;80;37;22;160
"3036";"360471104001";20;3;49;54;20;146
"3037";"360471104002";58;10;13;13;16;110
"3038";"360471104003";20;6;4;2;6;38
"3039";"360471104004";45;4;23;14;23;109
"3040";"360471106001";112;9;2;0;1;124
"3041";"360471106002";120;4;1;1;0;126
"3042";"360471110001";223;8;3;3;6;243
"3043";"360471110002";43;4;0;0;2;49
"3044";"360471116001";45;8;36;13;15;117
"3045";"360471116002";15;9;65;16;29;134
"3046";"360471118001";48;17;23;7;30;125
"3047";"360471118002";26;7;42;17;33;125
"3048";"360471120001";12;7;9;7;23;58
"3049";"360471120002";64;5;13;7;19;108
"3050";"360471122001";30;5;47;9;43;134
"3051";"360471122002";70;17;38;11;20;156
"3052";"360471124001";7;3;21;4;24;59
"3053";"360471124002";15;6;13;8;22;64
"3054";"360471124003";33;3;7;1;28;72
"3055";"360471126001";35;4;11;5;20;75
"3056";"360471126002";42;0;10;0;14;66
"3057";"360471126003";20;9;16;0;11;56
"3058";"360471128001";22;1;10;1;14;48
"3059";"360471128002";27;7;17;1;26;78
"3060";"360471128003";55;3;17;4;30;109
"3061";"360471130001";2;0;5;0;2;9
"3062";"360471130002";33;11;2;3;5;54
"3063";"360471130003";61;13;25;2;23;124
"3064";"360471130004";39;10;32;16;20;117
"3065";"360471132001";11;3;10;5;12;41
"3066";"360471132002";49;5;48;29;18;149
"3067";"360471134001";10;1;6;3;10;30
"3068";"360471134002";19;1;3;3;0;26
"3069";"360471134003";12;1;7;2;9;31
"3070";"360471142011";19;4;25;9;15;72
"3071";"360471142012";17;7;80;23;20;147
"3072";"360471142021";71;8;87;10;26;202
"3073";"360471142022";57;15;43;6;32;153
"3074";"360471144001";5;7;19;20;14;65
"3075";"360471144002";79;2;5;6;30;122
"3076";"360471144003";27;0;6;15;27;75
"3077";"360471144004";12;5;6;4;4;31
"3078";"360471146001";41;5;34;3;32;115
"3079";"360471146002";31;16;52;15;67;181
"3080";"360471150001";8;4;17;2;25;56
"3081";"360471150002";66;0;14;3;13;96
"3082";"360471150003";16;5;9;3;21;54
"3083";"360471152001";33;7;121;23;29;213
"3084";"360471152002";56;9;7;2;6;80
"3085";"360471152003";43;5;17;19;29;113
"3086";"360471156001";15;9;17;5;13;59
"3087";"360471156002";445;5;2;1;2;455
"3088";"360471156003";31;6;0;0;3;40
"3089";"360471156004";35;0;6;1;6;48
"3090";"360471158001";26;4;26;1;23;80
"3091";"360471158002";11;5;4;1;22;43
"3092";"360471158003";72;4;8;1;16;101
"3093";"360471160001";9;6;4;5;5;29
"3094";"360471160002";23;10;0;3;11;47
"3095";"360471160003";4;6;18;9;14;51
"3096";"360471162001";34;2;21;4;6;67
"3097";"360471162002";11;0;3;2;9;25
"3098";"360471162003";6;5;13;11;6;41
"3099";"360471164001";23;5;14;9;20;71
"3100";"360471164002";25;6;21;1;8;61
"3101";"360471164003";15;5;14;3;10;47
"3102";"360471166001";17;0;42;2;26;87
"3103";"360471166002";21;5;22;12;17;77
"3104";"360471166003";19;8;29;4;17;77
"3105";"360471168001";14;11;16;12;37;90
"3106";"360471168002";22;9;17;3;31;82
"3107";"360471170001";32;9;24;6;23;94
"3108";"360471170002";59;17;61;4;48;189
"3109";"360471172011";48;3;57;8;43;159
"3110";"360471172012";45;20;17;4;43;129
"3111";"360471172021";41;16;30;6;26;119
"3112";"360471172022";44;14;59;8;49;174
"3113";"360471174001";78;20;48;17;52;215
"3114";"360471174002";44;81;76;22;65;288
"3115";"360471176011";20;8;47;11;32;118
"3116";"360471176012";31;71;37;2;44;185
"3117";"360471176021";32;6;15;5;37;95
"3118";"360471176022";235;12;55;7;62;371
"3119";"360471178001";29;21;25;9;56;140
"3120";"360471180001";9;7;8;4;18;46
"3121";"360471182011";55;17;35;3;19;129
"3122";"360471182012";20;8;36;5;31;100
"3123";"360471182021";72;9;26;9;32;148
"3124";"360471182022";66;12;27;4;31;140
"3125";"360471184001";26;24;20;8;53;131
"3126";"360471184002";43;24;36;9;61;173
"3127";"360471184003";25;17;16;13;37;108
"3128";"360471186001";41;4;22;4;32;103
"3129";"360471186002";80;8;34;7;24;153
"3130";"360471188001";16;1;20;3;141;181
"3131";"360471188002";27;13;26;0;51;117
"3132";"360471188003";48;6;12;0;37;103
"3133";"360471190001";97;26;55;5;27;210
"3134";"360471190002";78;8;18;3;47;154
"3135";"360471192001";20;5;56;11;21;113
"3136";"360471192002";20;7;18;1;15;61
"3137";"360471192003";62;4;14;10;24;114
"3138";"360471194001";80;8;22;5;17;132
"3139";"360471194002";88;5;23;2;17;135
"3140";"360471194003";30;8;29;9;29;105
"3141";"360471196001";55;19;64;22;26;186
"3142";"360471196002";8;25;18;3;21;75
"3143";"360471196003";24;12;27;2;18;83
"3144";"360471196004";49;7;51;3;16;126
"3145";"360471198001";3;2;26;16;22;69
"3146";"360471198002";20;7;95;21;58;201
"3147";"360471198003";36;12;31;11;82;172
"3148";"360471200001";10;3;27;2;17;59
"3149";"360471200002";32;0;25;10;20;87
"3150";"360471202001";38;4;10;4;24;80
"3151";"360471202002";17;8;18;12;30;85
"3152";"360471208001";8;1;23;3;31;66
"3153";"360471208002";138;10;55;14;20;237
"3154";"360471208003";12;1;1;1;1;16
"3155";"360471208004";46;1;0;0;0;47
"3156";"360471208005";23;4;29;14;17;87
"3157";"360471210001";71;0;0;0;3;74
"3158";"360471210002";116;0;0;0;1;117
"3159";"360471214001";125;2;1;0;3;131
"3160";"360471214002";270;9;2;8;0;289
"3161";"360471220001";240;12;77;51;24;404
"3162";"360471220002";210;17;86;42;50;405
"3163";"360471237001";9;15;60;5;49;138
"3164";"360471237002";9;9;20;6;29;73
"3165";"360471237003";11;11;28;17;71;138
"3166";"360471502001";14;1;17;1;9;42
"3167";"360471502002";2;2;10;9;9;32
"3168";"360471502003";14;13;49;18;27;121
"3169";"360471522001";62;30;39;51;26;208
"3170";"360471522002";16;21;46;23;30;136
"3171";"360471522003";35;13;66;31;15;160
"3172";"360593026001";0;0;0;1;0;1
"3173";"360594043002";0;0;1;0;3;4
"3174";"360594043003";2;0;0;0;0;2
"3175";"360594103005";1;0;0;0;0;1
"3176";"360610001001";0;3;0;0;0;3
"3177";"360610002011";32;3;5;1;25;66
"3178";"360610002012";62;12;23;0;4;101
"3179";"360610002021";16;10;13;0;9;48
"3180";"360610002022";11;12;26;2;5;56
"3181";"360610002023";126;9;4;0;2;141
"3182";"360610002024";101;3;3;5;2;114
"3183";"360610002025";102;24;100;2;3;231
"3184";"360610005001";0;3;0;0;0;3
"3185";"360610006001";9;55;68;0;38;170
"3186";"360610006002";59;11;16;1;5;92
"3187";"360610006003";30;39;5;1;25;100
"3188";"360610006004";9;3;4;0;24;40
"3189";"360610006005";9;5;8;1;3;26
"3190";"360610006006";9;2;10;1;6;28
"3191";"360610007001";96;159;59;8;49;371
"3192";"360610008001";11;7;10;1;101;130
"3193";"360610008002";1;4;20;1;50;76
"3194";"360610008003";14;10;13;0;77;114
"3195";"360610008004";4;5;3;0;11;23
"3196";"360610008005";22;16;9;0;5;52
"3197";"360610008006";8;80;42;6;123;259
"3198";"360610009001";37;55;60;4;26;182
"3199";"360610010011";40;7;43;12;1;103
"3200";"360610010021";91;3;2;0;0;96
"3201";"360610010022";31;12;1;0;1;45
"3202";"360610010023";89;9;14;5;4;121
"3203";"360610012001";25;3;14;1;9;52
"3204";"360610012002";7;7;37;4;4;59
"3205";"360610012003";27;12;30;10;1;80
"3206";"360610013001";9;186;18;5;18;236
"3207";"360610013002";32;68;25;1;37;163
"3208";"360610014011";5;65;11;1;3;85
"3209";"360610014012";3;16;7;0;1;27
"3210";"360610014021";76;79;18;5;32;210
"3211";"360610014022";32;26;6;3;68;135
"3212";"360610015010";0;0;0;0;1;1
"3213";"360610015011";6;33;26;0;21;86
"3214";"360610015012";10;17;11;1;1;40
"3215";"360610015013";18;61;47;4;19;149
"3216";"360610015021";67;57;28;10;52;214
"3217";"360610015022";38;85;31;8;13;175
"3218";"360610016001";11;18;27;0;119;175
"3219";"360610016002";9;24;3;0;96;132
"3220";"360610016003";14;17;13;3;107;154
"3221";"360610016004";39;61;11;5;55;171
"3222";"360610016005";36;317;27;6;136;522
"3223";"360610018001";38;67;0;0;34;139
"3224";"360610018002";16;44;2;0;68;130
"3225";"360610018003";20;209;5;2;63;299
"3226";"360610018004";14;16;6;0;33;69
"3227";"360610018005";22;105;6;0;125;258
"3228";"360610018006";4;28;4;0;65;101
"3229";"360610018007";7;22;10;1;75;115
"3230";"360610020001";64;19;3;1;1;88
"3231";"360610020002";62;2;5;0;0;69
"3232";"360610020003";33;5;9;3;1;51
"3233";"360610021001";47;126;36;3;67;279
"3234";"360610021002";21;63;36;2;17;139
"3235";"360610022011";75;29;11;1;39;155
"3236";"360610022012";73;195;7;0;56;331
"3237";"360610022013";23;35;2;0;3;63
"3238";"360610022014";12;8;2;0;7;29
"3239";"360610022021";126;40;43;3;81;293
"3240";"360610024001";242;33;6;2;3;286
"3241";"360610024002";95;5;3;1;5;109
"3242";"360610025001";97;34;6;0;22;159
"3243";"360610025002";9;7;1;0;5;22
"3244";"360610025003";58;10;2;0;1;71
"3245";"360610026011";124;175;20;4;62;385
"3246";"360610026012";70;145;36;12;60;323
"3247";"360610026021";79;61;37;5;48;230
"3248";"360610026022";124;202;23;10;43;402
"3249";"360610027001";13;11;18;2;38;82
"3250";"360610028001";41;39;3;1;12;96
"3251";"360610028002";50;15;15;5;18;103
"3252";"360610028003";95;107;20;5;37;264
"3253";"360610028004";124;142;41;4;15;326
"3254";"360610029001";19;17;6;2;53;97
"3255";"360610029002";2;25;0;2;35;64
"3256";"360610029003";4;50;14;2;86;156
"3257";"360610029004";3;18;8;0;18;47
"3258";"360610030011";49;169;3;1;62;284
"3259";"360610030012";27;134;3;5;73;242
"3260";"360610030013";51;41;14;2;49;157
"3261";"360610030014";85;56;5;1;67;214
"3262";"360610030021";71;89;63;4;55;282
"3263";"360610030022";91;405;16;2;71;585
"3264";"360610031001";12;87;60;3;101;263
"3265";"360610032001";72;256;20;1;64;413
"3266";"360610032002";19;61;6;1;68;155
"3267";"360610032003";7;48;9;0;34;98
"3268";"360610032004";4;13;2;0;12;31
"3269";"360610032005";42;90;35;1;30;198
"3270";"360610032006";136;49;23;6;91;305
"3271";"360610032007";22;38;6;3;33;102
"3272";"360610033001";60;86;37;3;129;315
"3273";"360610033002";14;70;16;2;26;128
"3274";"360610033003";22;34;26;9;20;111
"3275";"360610034001";52;134;14;13;76;289
"3276";"360610034002";67;251;11;5;27;361
"3277";"360610034003";62;111;14;14;81;282
"3278";"360610034004";71;72;13;5;49;210
"3279";"360610036011";28;87;4;0;20;139
"3280";"360610036012";33;67;6;1;52;159
"3281";"360610036013";56;99;9;2;70;236
"3282";"360610036021";67;128;34;11;73;313
"3283";"360610036022";20;74;14;0;39;147
"3284";"360610037001";24;67;46;10;29;176
"3285";"360610037002";10;89;17;4;26;146
"3286";"360610037003";12;78;36;3;23;152
"3287";"360610038001";81;107;7;2;61;258
"3288";"360610038002";19;51;10;0;24;104
"3289";"360610038003";35;108;25;5;49;222
"3290";"360610038004";34;60;8;4;26;132
"3291";"360610038005";55;94;11;0;53;213
"3292";"360610038006";16;69;2;1;41;129
"3293";"360610038007";90;59;5;0;27;181
"3294";"360610039001";28;23;30;5;40;126
"3295";"360610039002";6;11;6;0;5;28
"3296";"360610039003";0;1;1;0;0;2
"3297";"360610039004";27;97;51;4;35;214
"3298";"360610040001";83;51;15;2;27;178
"3299";"360610040002";14;26;5;0;11;56
"3300";"360610040003";25;41;6;8;18;98
"3301";"360610040004";26;10;0;5;11;52
"3302";"360610040005";44;28;11;2;16;101
"3303";"360610040006";70;43;10;2;19;144
"3304";"360610041001";21;67;0;3;74;165
"3305";"360610041002";5;24;4;0;54;87
"3306";"360610041003";7;11;4;0;51;73
"3307";"360610041004";23;130;5;3;54;215
"3308";"360610041005";10;15;9;0;52;86
"3309";"360610041006";30;150;17;3;61;261
"3310";"360610042001";36;101;12;1;18;168
"3311";"360610042002";43;91;31;4;12;181
"3312";"360610043001";43;94;9;3;98;247
"3313";"360610043002";31;46;11;1;33;122
"3314";"360610043003";42;183;33;9;81;348
"3315";"360610044001";48;33;7;2;8;98
"3316";"360610044002";2;5;4;0;4;15
"3317";"360610044003";13;7;2;0;5;27
"3318";"360610044004";10;4;2;0;1;17
"3319";"360610044005";3;4;3;3;2;15
"3320";"360610044006";1;0;1;0;0;2
"3321";"360610044007";12;9;7;3;22;53
"3322";"360610044008";10;37;9;0;13;69
"3323";"360610045001";55;353;187;6;158;759
"3324";"360610047001";17;36;30;0;35;118
"3325";"360610047002";87;234;40;5;113;479
"3326";"360610048001";9;3;4;3;8;27
"3327";"360610048002";5;3;3;1;2;14
"3328";"360610048003";11;6;7;2;7;33
"3329";"360610048004";19;98;11;6;11;145
"3330";"360610048005";36;20;9;0;7;72
"3331";"360610048006";37;15;12;2;16;82
"3332";"360610048007";0;3;6;0;2;11
"3333";"360610049001";71;288;65;12;149;585
"3334";"360610049002";56;66;12;5;39;178
"3335";"360610049003";30;26;2;1;22;81
"3336";"360610050001";14;20;9;2;8;53
"3337";"360610050002";8;23;7;0;13;51
"3338";"360610050003";5;73;7;1;12;98
"3339";"360610050004";2;11;7;1;8;29
"3340";"360610050005";10;90;11;4;15;130
"3341";"360610052001";8;185;31;1;38;263
"3342";"360610052002";23;169;18;0;28;238
"3343";"360610054001";40;180;24;4;50;298
"3344";"360610054002";14;10;11;0;4;39
"3345";"360610054003";2;10;9;0;4;25
"3346";"360610055011";25;68;8;2;17;120
"3347";"360610055012";0;14;6;0;2;22
"3348";"360610055013";2;9;6;0;2;19
"3349";"360610055021";13;33;22;5;43;116
"3350";"360610055022";44;165;44;10;64;327
"3351";"360610056001";24;35;39;0;12;110
"3352";"360610056002";7;48;11;3;10;79
"3353";"360610056003";12;30;8;1;2;53
"3354";"360610057001";6;64;10;1;15;96
"3355";"360610057002";11;93;9;2;22;137
"3356";"360610058001";62;211;29;4;63;369
"3357";"360610059001";27;12;4;3;12;58
"3358";"360610059002";8;45;4;3;0;60
"3359";"360610059003";33;26;6;5;12;82
"3360";"360610059004";2;4;1;0;2;9
"3361";"360610059005";7;11;1;0;4;23
"3362";"360610060001";5;1;5;1;2;14
"3363";"360610060002";6;1;2;0;2;11
"3364";"360610060003";1;0;0;1;1;3
"3365";"360610061001";17;66;10;3;17;113
"3366";"360610061002";31;44;12;5;8;100
"3367";"360610061003";14;126;21;1;23;185
"3368";"360610062001";0;23;36;3;7;69
"3369";"360610062002";2;63;12;0;7;84
"3370";"360610063001";10;38;9;3;14;74
"3371";"360610063002";9;13;24;1;9;56
"3372";"360610063003";18;34;30;3;6;91
"3373";"360610063004";12;48;1;0;9;70
"3374";"360610063005";22;55;8;5;7;97
"3375";"360610064001";29;17;7;0;30;83
"3376";"360610064002";89;4;3;0;4;100
"3377";"360610064003";5;29;5;1;5;45
"3378";"360610064004";70;21;24;3;25;143
"3379";"360610064005";17;26;22;2;5;72
"3380";"360610064006";5;1;2;0;1;9
"3381";"360610065001";19;107;16;5;19;166
"3382";"360610065002";40;232;14;2;24;312
"3383";"360610065003";22;194;10;3;14;243
"3384";"360610065004";20;104;11;1;25;161
"3385";"360610065005";27;145;3;1;23;199
"3386";"360610066001";35;37;2;2;5;81
"3387";"360610066002";57;17;13;2;7;96
"3388";"360610066003";43;25;9;0;11;88
"3389";"360610066004";16;14;7;0;10;47
"3390";"360610066005";26;16;8;3;12;65
"3391";"360610066006";2;4;3;0;7;16
"3392";"360610066007";9;9;0;0;3;21
"3393";"360610066008";115;28;8;5;3;159
"3394";"360610066009";9;1;12;0;0;22
"3395";"360610067001";40;170;7;3;21;241
"3396";"360610067002";39;119;16;15;53;242
"3397";"360610067003";24;60;14;0;21;119
"3398";"360610067004";17;25;15;13;26;96
"3399";"360610068001";26;60;20;1;17;124
"3400";"360610068002";10;21;13;5;5;54
"3401";"360610068003";26;38;10;0;6;80
"3402";"360610068004";14;14;6;0;14;48
"3403";"360610068005";5;19;11;1;12;48
"3404";"360610068006";28;56;5;0;17;106
"3405";"360610069001";431;108;45;12;32;628
"3406";"360610070001";48;79;13;2;17;159
"3407";"360610070002";25;26;13;0;21;85
"3408";"360610070003";34;22;14;0;17;87
"3409";"360610070004";2;15;14;2;7;40
"3410";"360610070005";1;0;2;0;0;3
"3411";"360610070006";74;22;3;0;2;101
"3412";"360610071001";3;3;0;1;5;12
"3413";"360610071002";3;11;0;0;5;19
"3414";"360610071003";18;78;26;10;20;152
"3415";"360610071004";36;60;2;1;12;111
"3416";"360610071005";14;42;7;1;13;77
"3417";"360610072001";22;14;2;1;2;41
"3418";"360610072002";14;12;17;1;11;55
"3419";"360610072003";34;30;8;2;25;99
"3420";"360610072004";20;46;15;1;17;99
"3421";"360610072005";2;5;7;0;11;25
"3422";"360610072006";6;5;4;0;5;20
"3423";"360610072007";2;9;1;1;2;15
"3424";"360610073001";8;18;7;2;8;43
"3425";"360610073002";18;10;2;0;9;39
"3426";"360610073003";21;43;12;3;17;96
"3427";"360610073004";41;219;8;3;49;320
"3428";"360610073005";17;10;5;5;16;53
"3429";"360610073006";24;174;6;7;31;242
"3430";"360610074001";23;45;17;2;26;113
"3431";"360610074002";3;4;2;0;17;26
"3432";"360610074003";42;156;19;3;39;259
"3433";"360610075001";10;51;28;5;23;117
"3434";"360610075002";23;27;12;2;7;71
"3435";"360610075003";25;96;7;0;21;149
"3436";"360610076001";20;112;26;1;56;215
"3437";"360610076002";11;64;18;1;60;154
"3438";"360610077001";56;49;10;3;28;146
"3439";"360610077002";5;14;6;4;13;42
"3440";"360610077003";36;126;14;1;33;210
"3441";"360610077004";30;41;18;2;27;118
"3442";"360610077005";27;12;4;4;13;60
"3443";"360610078001";5;17;2;1;2;27
"3444";"360610078002";11;13;9;0;12;45
"3445";"360610078003";8;11;8;1;3;31
"3446";"360610078004";8;19;8;2;18;55
"3447";"360610078005";22;6;1;0;5;34
"3448";"360610078006";21;3;2;1;3;30
"3449";"360610078007";21;3;1;0;10;35
"3450";"360610079001";21;200;28;4;52;305
"3451";"360610079002";4;13;14;5;3;39
"3452";"360610079003";17;64;21;5;9;116
"3453";"360610079004";1;52;5;0;11;69
"3454";"360610080001";14;47;16;0;8;85
"3455";"360610080002";11;111;9;3;10;144
"3456";"360610080003";5;4;7;1;2;19
"3457";"360610080004";19;21;11;0;9;60
"3458";"360610080005";18;10;11;0;8;47
"3459";"360610081001";20;33;10;4;16;83
"3460";"360610081002";60;34;28;2;18;142
"3461";"360610081003";17;2;15;4;8;46
"3462";"360610081004";42;26;5;3;23;99
"3463";"360610081005";39;16;6;3;7;71
"3464";"360610081006";25;51;21;2;17;116
"3465";"360610082001";7;60;36;4;28;135
"3466";"360610082002";9;28;14;1;11;63
"3467";"360610082003";3;11;3;3;16;36
"3468";"360610083001";55;88;16;0;26;185
"3469";"360610083002";11;22;7;9;12;61
"3470";"360610083003";123;251;159;2;26;561
"3471";"360610084001";0;14;5;1;5;25
"3472";"360610084002";20;66;34;1;54;175
"3473";"360610086011";3;11;8;0;6;28
"3474";"360610086012";6;16;8;0;1;31
"3475";"360610086021";1;16;13;0;9;39
"3476";"360610086031";2;8;5;0;1;16
"3477";"360610086032";7;4;4;0;1;16
"3478";"360610086033";10;4;9;1;1;25
"3479";"360610086034";4;7;12;1;5;29
"3480";"360610087001";29;37;27;1;39;133
"3481";"360610087002";19;75;8;13;12;127
"3482";"360610087003";18;11;3;0;8;40
"3483";"360610087004";24;16;8;3;7;58
"3484";"360610087005";17;14;12;2;3;48
"3485";"360610088001";6;37;17;2;9;71
"3486";"360610088002";14;20;7;1;9;51
"3487";"360610088003";2;3;4;0;0;9
"3488";"360610088004";0;3;2;0;1;6
"3489";"360610088005";17;12;4;0;1;34
"3490";"360610088006";1;3;11;0;1;16
"3491";"360610088007";6;1;2;1;0;10
"3492";"360610089001";38;6;2;0;10;56
"3493";"360610089002";51;37;3;1;18;110
"3494";"360610089003";45;13;26;11;11;106
"3495";"360610089004";7;40;22;2;27;98
"3496";"360610089005";15;2;16;0;6;39
"3497";"360610090001";9;35;23;1;10;78
"3498";"360610090002";12;3;8;0;9;32
"3499";"360610090003";2;10;14;1;7;34
"3500";"360610090004";18;9;20;0;4;51
"3501";"360610090005";2;8;3;0;2;15
"3502";"360610090006";1;7;3;0;2;13
"3503";"360610091001";55;82;29;2;60;228
"3504";"360610091002";13;73;6;1;22;115
"3505";"360610091003";22;12;0;1;12;47
"3506";"360610091004";17;72;20;1;22;132
"3507";"360610092001";22;143;56;3;35;259
"3508";"360610093001";1;24;13;1;3;42
"3509";"360610093002";12;44;14;0;19;89
"3510";"360610093003";3;9;0;0;1;13
"3511";"360610093004";3;1;4;0;1;9
"3512";"360610093005";15;9;6;1;19;50
"3513";"360610093006";67;27;7;0;2;103
"3514";"360610093007";12;60;16;4;7;99
"3515";"360610094001";4;53;45;2;22;126
"3516";"360610095001";37;103;28;2;143;313
"3517";"360610095002";35;106;29;3;73;246
"3518";"360610096001";2;154;42;2;47;247
"3519";"360610097001";15;30;12;2;7;66
"3520";"360610097002";70;38;18;1;11;138
"3521";"360610097003";2;7;5;0;0;14
"3522";"360610097004";931;14;4;5;10;964
"3523";"360610098001";11;48;7;2;10;78
"3524";"360610098002";5;39;7;0;28;79
"3525";"360610098003";61;42;4;0;23;130
"3526";"360610098004";24;12;7;1;5;49
"3527";"360610098005";5;49;3;1;7;65
"3528";"360610098006";16;38;37;3;11;105
"3529";"360610098007";15;15;7;1;13;51
"3530";"360610099001";52;168;187;14;148;569
"3531";"360610100001";10;26;28;0;16;80
"3532";"360610100002";5;9;23;1;15;53
"3533";"360610101001";9;79;43;3;36;170
"3534";"360610102001";0;77;35;1;20;133
"3535";"360610103001";85;51;37;3;25;201
"3536";"360610104001";9;128;30;1;31;199
"3537";"360610106011";2;6;5;1;6;20
"3538";"360610106012";8;11;20;2;3;44
"3539";"360610106013";7;41;6;0;6;60
"3540";"360610106014";2;12;5;0;14;33
"3541";"360610106015";1;5;2;0;0;8
"3542";"360610106016";0;5;12;1;8;26
"3543";"360610106021";4;9;5;2;0;20
"3544";"360610106022";3;37;19;3;17;79
"3545";"360610106023";2;29;6;0;4;41
"3546";"360610108001";11;3;2;1;5;22
"3547";"360610108002";19;3;4;0;6;32
"3548";"360610108003";7;19;5;0;9;40
"3549";"360610108004";2;3;4;0;4;13
"3550";"360610108005";15;10;6;0;12;43
"3551";"360610108006";3;28;10;0;11;52
"3552";"360610108007";2;30;16;1;14;63
"3553";"360610109001";5;118;27;0;36;186
"3554";"360610110001";4;26;1;0;3;34
"3555";"360610110002";5;10;5;0;6;26
"3556";"360610110003";50;47;8;3;18;126
"3557";"360610110004";2;10;1;0;2;15
"3558";"360610110005";6;100;2;1;4;113
"3559";"360610110006";26;22;6;1;25;80
"3560";"360610111001";40;45;27;4;43;159
"3561";"360610111002";11;21;8;3;16;59
"3562";"360610111003";24;21;10;0;8;63
"3563";"360610112011";7;15;28;6;22;78
"3564";"360610112021";3;68;57;1;27;156
"3565";"360610112031";16;5;4;1;6;32
"3566";"360610112032";0;6;11;1;14;32
"3567";"360610113001";23;223;43;5;64;358
"3568";"360610114011";7;10;15;0;6;38
"3569";"360610114012";8;58;15;4;13;98
"3570";"360610114021";10;26;14;2;17;69
"3571";"360610114022";6;19;20;1;22;68
"3572";"360610115001";31;95;68;0;53;247
"3573";"360610115002";18;71;25;0;32;146
"3574";"360610116001";7;18;17;1;3;46
"3575";"360610116002";8;3;8;3;1;23
"3576";"360610116003";3;17;9;5;4;38
"3577";"360610117001";10;29;16;2;10;67
"3578";"360610118001";1;16;3;0;0;20
"3579";"360610118002";2;1;7;0;1;11
"3580";"360610118003";4;5;8;1;1;19
"3581";"360610118004";20;7;12;0;20;59
"3582";"360610118005";12;14;10;3;11;50
"3583";"360610118006";15;8;20;1;6;50
"3584";"360610118007";10;14;12;1;4;41
"3585";"360610118008";4;5;5;3;5;22
"3586";"360610119001";79;46;30;0;12;167
"3587";"360610119002";42;58;38;0;12;150
"3588";"360610120001";2;7;3;0;3;15
"3589";"360610120002";6;5;18;1;2;32
"3590";"360610120003";6;12;16;1;8;43
"3591";"360610120004";0;6;19;4;5;34
"3592";"360610121001";72;53;10;2;17;154
"3593";"360610121002";3;6;6;0;4;19
"3594";"360610121003";40;23;9;4;17;93
"3595";"360610121004";30;99;26;2;21;178
"3596";"360610121005";64;63;11;2;13;153
"3597";"360610121006";29;52;9;3;18;111
"3598";"360610122001";10;4;8;3;3;28
"3599";"360610122002";4;7;6;0;6;23
"3600";"360610122003";11;15;9;0;14;49
"3601";"360610122004";2;15;15;0;2;34
"3602";"360610124001";21;24;10;1;30;86
"3603";"360610124002";21;8;10;1;6;46
"3604";"360610124003";13;117;17;0;5;152
"3605";"360610124004";12;14;6;1;5;38
"3606";"360610124005";3;11;7;1;5;27
"3607";"360610124006";10;3;4;0;5;22
"3608";"360610124007";0;51;8;0;4;63
"3609";"360610124008";2;1;1;1;0;5
"3610";"360610125001";14;67;14;0;32;127
"3611";"360610125002";14;136;32;2;20;204
"3612";"360610126001";24;45;41;7;17;134
"3613";"360610126002";9;9;14;1;10;43
"3614";"360610126003";10;9;12;2;5;38
"3615";"360610126004";51;13;23;2;6;95
"3616";"360610126005";8;9;13;1;13;44
"3617";"360610126006";24;26;16;3;9;78
"3618";"360610126007";24;9;5;2;8;48
"3619";"360610126008";20;7;9;0;1;37
"3620";"360610127001";30;39;9;1;19;98
"3621";"360610127002";39;28;5;0;27;99
"3622";"360610127003";55;29;3;3;23;113
"3623";"360610127004";51;124;45;3;35;258
"3624";"360610127005";3;16;24;0;7;50
"3625";"360610128001";7;24;7;0;11;49
"3626";"360610128002";2;8;3;1;6;20
"3627";"360610128003";5;12;10;1;13;41
"3628";"360610128004";4;18;21;1;11;55
"3629";"360610128005";2;7;29;1;9;48
"3630";"360610129001";45;78;76;15;37;251
"3631";"360610129002";54;38;68;11;37;208
"3632";"360610130001";2;3;9;1;3;18
"3633";"360610130002";5;13;12;7;6;43
"3634";"360610130003";2;16;15;1;4;38
"3635";"360610130004";19;13;10;4;4;50
"3636";"360610131001";8;34;94;2;13;151
"3637";"360610131002";22;117;16;2;15;172
"3638";"360610132001";28;8;16;1;11;64
"3639";"360610132002";19;31;12;1;17;80
"3640";"360610132003";15;20;12;2;11;60
"3641";"360610132004";36;38;39;7;20;140
"3642";"360610132005";42;8;9;6;8;73
"3643";"360610132006";10;1;3;0;12;26
"3644";"360610132007";7;9;7;0;3;26
"3645";"360610133001";24;16;3;2;4;49
"3646";"360610133002";19;70;9;0;21;119
"3647";"360610133003";27;51;16;2;31;127
"3648";"360610133004";35;59;15;3;8;120
"3649";"360610133005";37;37;14;2;7;97
"3650";"360610134001";25;20;1;1;8;55
"3651";"360610134002";24;16;2;2;7;51
"3652";"360610134003";13;11;14;1;9;48
"3653";"360610134004";15;30;12;0;8;65
"3654";"360610134005";36;35;4;1;4;80
"3655";"360610134006";10;32;8;0;4;54
"3656";"360610134007";46;37;25;2;19;129
"3657";"360610134008";7;51;8;1;12;79
"3658";"360610134009";36;36;4;0;15;91
"3659";"360610135001";48;24;77;3;19;171
"3660";"360610135002";33;23;61;16;26;159
"3661";"360610136001";22;16;16;4;18;76
"3662";"360610136002";229;11;6;2;17;265
"3663";"360610136003";19;8;15;0;9;51
"3664";"360610136004";23;17;17;3;24;84
"3665";"360610136005";8;8;8;0;6;30
"3666";"360610136006";8;5;4;1;5;23
"3667";"360610136007";40;11;11;1;15;78
"3668";"360610136008";31;38;24;6;23;122
"3669";"360610137001";10;19;15;0;9;53
"3670";"360610137002";6;16;22;1;6;51
"3671";"360610137003";4;75;16;0;21;116
"3672";"360610137004";4;48;110;1;41;204
"3673";"360610137005";2;6;6;0;3;17
"3674";"360610137006";13;75;33;5;7;133
"3675";"360610138001";11;9;4;2;21;47
"3676";"360610138002";30;45;4;1;11;91
"3677";"360610138003";11;14;10;8;17;60
"3678";"360610138004";55;95;14;0;28;192
"3679";"360610138005";17;11;3;0;11;42
"3680";"360610138006";20;8;13;3;2;46
"3681";"360610138007";28;24;15;0;9;76
"3682";"360610138008";15;5;3;1;6;30
"3683";"360610138009";15;8;9;0;9;41
"3684";"360610139001";34;9;5;0;22;70
"3685";"360610139002";15;13;10;0;13;51
"3686";"360610139003";67;38;22;3;20;150
"3687";"360610139004";23;18;2;0;7;50
"3688";"360610139005";23;112;6;4;14;159
"3689";"360610139006";8;24;10;1;14;57
"3690";"360610139007";10;36;11;3;17;77
"3691";"360610140001";6;24;22;3;15;70
"3692";"360610140002";16;31;11;1;17;76
"3693";"360610140003";7;13;6;0;11;37
"3694";"360610140004";1;3;12;1;12;29
"3695";"360610140005";7;7;11;1;13;39
"3696";"360610140006";17;2;8;0;11;38
"3697";"360610142001";5;8;15;0;4;32
"3698";"360610142002";3;3;12;2;0;20
"3699";"360610142003";4;4;8;0;5;21
"3700";"360610142004";5;1;5;0;7;18
"3701";"360610142005";5;29;6;0;2;42
"3702";"360610142006";0;5;5;0;6;16
"3703";"360610143001";19;291;86;5;74;475
"3704";"360610144011";0;6;4;1;4;15
"3705";"360610144012";29;22;19;0;3;73
"3706";"360610144013";28;14;1;0;6;49
"3707";"360610144014";11;25;5;0;4;45
"3708";"360610144021";5;26;7;2;13;53
"3709";"360610144022";29;2;4;1;10;46
"3710";"360610144023";27;2;1;0;5;35
"3711";"360610144024";12;22;25;5;11;75
"3712";"360610144025";23;10;11;0;7;51
"3713";"360610145001";3;15;19;3;12;52
"3714";"360610145002";2;2;2;0;2;8
"3715";"360610145003";4;24;34;2;10;74
"3716";"360610145004";9;15;34;0;11;69
"3717";"360610146011";8;52;17;2;13;92
"3718";"360610146012";14;88;4;1;22;129
"3719";"360610146013";11;26;6;2;11;56
"3720";"360610146014";27;17;8;0;9;61
"3721";"360610146021";4;11;10;1;7;33
"3722";"360610146022";19;3;10;0;3;35
"3723";"360610146023";41;19;7;2;24;93
"3724";"360610146024";6;9;8;1;13;37
"3725";"360610146025";8;17;3;0;9;37
"3726";"360610146026";7;11;1;1;16;36
"3727";"360610147001";9;9;24;0;10;52
"3728";"360610148011";18;83;6;0;5;112
"3729";"360610148012";9;25;16;0;6;56
"3730";"360610148021";50;24;19;3;19;115
"3731";"360610148022";11;19;12;2;50;94
"3732";"360610148023";7;11;13;2;15;48
"3733";"360610148024";10;11;8;4;13;46
"3734";"360610148025";4;2;7;0;6;19
"3735";"360610149001";15;118;61;2;18;214
"3736";"360610149002";6;6;1;0;1;14
"3737";"360610149003";6;18;16;3;11;54
"3738";"360610149004";3;28;10;0;5;46
"3739";"360610149005";10;10;38;1;11;70
"3740";"360610150011";2;16;4;0;3;25
"3741";"360610150012";7;10;10;1;3;31
"3742";"360610150021";5;10;9;1;2;27
"3743";"360610150022";0;6;13;3;1;23
"3744";"360610150023";3;1;20;0;1;25
"3745";"360610150024";4;5;10;3;5;27
"3746";"360610151001";313;24;3;3;8;351
"3747";"360610151002";203;6;7;0;2;218
"3748";"360610151003";29;16;5;1;0;51
"3749";"360610151004";19;10;19;3;9;60
"3750";"360610152001";78;6;4;2;1;91
"3751";"360610152002";133;14;6;1;4;158
"3752";"360610152003";5;6;7;2;13;33
"3753";"360610152004";9;5;1;0;14;29
"3754";"360610152005";5;7;10;0;5;27
"3755";"360610152006";2;18;10;0;2;32
"3756";"360610153001";4;23;9;1;8;45
"3757";"360610153002";11;4;11;0;4;30
"3758";"360610153003";0;19;52;1;7;79
"3759";"360610153004";8;22;64;1;5;100
"3760";"360610153005";12;6;1;1;4;24
"3761";"360610153006";12;11;19;2;14;58
"3762";"360610153007";8;24;8;0;9;49
"3763";"360610154001";29;29;4;2;16;80
"3764";"360610154002";46;5;1;0;9;61
"3765";"360610154003";36;16;6;1;12;71
"3766";"360610154004";27;5;5;0;6;43
"3767";"360610154005";39;42;4;3;14;102
"3768";"360610154006";22;23;6;2;22;75
"3769";"360610154007";33;7;11;1;6;58
"3770";"360610154008";20;14;13;5;16;68
"3771";"360610154009";5;7;6;0;5;23
"3772";"360610155001";0;6;6;0;2;14
"3773";"360610155002";5;11;5;3;2;26
"3774";"360610155003";2;8;0;0;0;10
"3775";"360610155004";1;1;34;5;4;45
"3776";"360610155005";1;0;1;0;0;2
"3777";"360610155006";11;21;24;4;7;67
"3778";"360610156011";6;8;1;1;6;22
"3779";"360610156012";23;3;13;1;14;54
"3780";"360610156013";7;8;10;0;13;38
"3781";"360610156014";1;6;5;0;1;13
"3782";"360610156021";65;40;27;3;2;137
"3783";"360610157001";25;5;18;3;4;55
"3784";"360610157002";29;6;3;1;5;44
"3785";"360610157003";14;38;8;0;10;70
"3786";"360610157004";4;18;4;0;7;33
"3787";"360610157005";10;7;6;6;7;36
"3788";"360610157006";51;31;7;0;9;98
"3789";"360610157007";76;43;11;2;24;156
"3790";"360610157008";7;3;5;0;8;23
"3791";"360610158011";11;81;13;1;18;124
"3792";"360610158012";39;12;6;2;33;92
"3793";"360610158013";16;10;6;1;10;43
"3794";"360610158014";1;17;13;0;11;42
"3795";"360610158021";20;8;19;1;3;51
"3796";"360610158022";117;16;19;1;6;159
"3797";"360610159001";12;5;7;1;5;30
"3798";"360610159002";7;3;19;0;7;36
"3799";"360610159003";7;6;2;2;6;23
"3800";"360610159004";6;20;14;1;8;49
"3801";"360610159005";13;61;9;1;24;108
"3802";"360610159006";20;40;12;2;13;87
"3803";"360610159007";27;22;3;2;5;59
"3804";"360610160011";0;5;7;4;1;17
"3805";"360610160012";3;10;27;4;6;50
"3806";"360610160013";8;7;13;3;5;36
"3807";"360610160014";5;6;11;3;2;27
"3808";"360610160021";9;19;9;2;6;45
"3809";"360610160022";9;5;3;1;4;22
"3810";"360610161001";98;27;18;3;11;157
"3811";"360610161002";14;13;8;0;6;41
"3812";"360610161003";45;5;13;2;9;74
"3813";"360610161004";7;2;7;0;1;17
"3814";"360610161005";19;10;15;2;11;57
"3815";"360610161006";12;3;11;1;0;27
"3816";"360610162001";63;17;4;0;3;87
"3817";"360610162002";21;2;2;1;1;27
"3818";"360610162003";54;5;3;1;1;64
"3819";"360610162004";271;35;16;1;4;327
"3820";"360610162005";34;4;7;3;4;52
"3821";"360610163001";9;5;30;6;5;55
"3822";"360610163002";17;7;20;2;6;52
"3823";"360610163003";15;18;4;1;12;50
"3824";"360610163004";20;14;11;1;13;59
"3825";"360610163005";3;20;16;1;17;57
"3826";"360610164001";4;35;39;0;10;88
"3827";"360610164002";87;59;22;1;14;183
"3828";"360610164003";98;24;4;1;6;133
"3829";"360610164004";34;20;6;0;3;63
"3830";"360610165001";10;32;19;1;12;74
"3831";"360610165002";16;16;10;2;9;53
"3832";"360610165003";5;14;8;1;2;30
"3833";"360610165004";25;122;6;1;4;158
"3834";"360610165005";30;27;18;5;9;89
"3835";"360610166001";47;33;1;0;15;96
"3836";"360610166002";49;27;10;1;5;92
"3837";"360610166003";29;20;8;3;10;70
"3838";"360610166004";57;7;11;2;15;92
"3839";"360610166005";43;16;3;1;4;67
"3840";"360610166006";53;25;11;3;14;106
"3841";"360610167001";4;12;11;1;8;36
"3842";"360610167002";4;6;15;1;16;42
"3843";"360610167003";1;21;15;0;9;46
"3844";"360610167004";23;38;6;0;19;86
"3845";"360610167005";11;27;9;0;16;63
"3846";"360610168001";205;4;2;0;3;214
"3847";"360610168002";433;7;20;0;1;461
"3848";"360610168003";11;21;13;0;6;51
"3849";"360610169001";5;12;10;1;11;39
"3850";"360610169002";9;23;5;3;12;52
"3851";"360610169003";10;105;15;1;12;143
"3852";"360610169004";47;85;11;6;21;170
"3853";"360610169005";11;0;5;1;4;21
"3854";"360610169006";26;3;5;0;4;38
"3855";"360610170001";3;8;2;0;2;15
"3856";"360610170002";42;20;5;0;12;79
"3857";"360610170003";20;39;15;5;31;110
"3858";"360610170004";4;8;4;2;1;19
"3859";"360610170005";22;18;4;0;13;57
"3860";"360610171001";39;55;8;0;26;128
"3861";"360610171002";10;21;4;0;18;53
"3862";"360610171003";6;18;1;0;13;38
"3863";"360610171004";11;3;4;0;2;20
"3864";"360610171005";6;6;9;1;9;31
"3865";"360610171006";13;8;15;2;5;43
"3866";"360610172001";81;108;15;3;21;228
"3867";"360610172002";96;6;2;0;2;106
"3868";"360610172003";31;15;5;1;6;58
"3869";"360610172004";24;31;10;0;38;103
"3870";"360610172005";37;11;2;0;25;75
"3871";"360610173001";11;5;9;1;7;33
"3872";"360610173002";12;3;3;1;5;24
"3873";"360610173003";113;29;33;1;10;186
"3874";"360610173004";40;7;12;2;2;63
"3875";"360610173005";7;5;9;3;6;30
"3876";"360610173006";17;6;5;0;9;37
"3877";"360610173007";16;4;5;0;11;36
"3878";"360610174011";24;8;6;0;4;42
"3879";"360610174012";71;19;4;0;1;95
"3880";"360610174013";62;15;5;1;14;97
"3881";"360610174021";79;19;2;2;8;110
"3882";"360610175001";34;26;11;4;17;92
"3883";"360610175002";5;4;5;1;4;19
"3884";"360610175003";53;2;9;1;14;79
"3885";"360610175004";3;4;3;2;3;15
"3886";"360610175005";1;6;6;0;6;19
"3887";"360610175006";31;34;4;3;16;88
"3888";"360610175007";12;24;14;1;17;68
"3889";"360610177001";13;14;5;0;3;35
"3890";"360610177002";79;19;18;2;5;123
"3891";"360610177003";13;33;3;1;6;56
"3892";"360610177004";142;30;7;6;3;188
"3893";"360610177005";62;53;17;1;4;137
"3894";"360610177006";88;23;5;3;2;121
"3895";"360610177007";20;21;12;1;4;58
"3896";"360610177008";45;21;11;0;2;79
"3897";"360610178001";46;42;15;0;32;135
"3898";"360610178002";38;64;27;0;12;141
"3899";"360610178003";64;88;19;3;28;202
"3900";"360610179001";49;16;12;1;52;130
"3901";"360610179002";1;1;3;0;2;7
"3902";"360610179003";13;5;6;2;0;26
"3903";"360610179004";33;1;5;0;11;50
"3904";"360610179005";28;4;1;1;5;39
"3905";"360610179006";73;69;15;8;15;180
"3906";"360610179007";10;20;1;3;4;38
"3907";"360610180001";201;38;2;2;9;252
"3908";"360610180002";56;44;15;3;31;149
"3909";"360610180003";67;24;18;3;22;134
"3910";"360610180004";36;2;2;0;2;42
"3911";"360610181001";5;3;8;0;7;23
"3912";"360610181002";9;2;9;1;0;21
"3913";"360610181003";29;9;2;0;6;46
"3914";"360610181004";12;3;10;1;1;27
"3915";"360610181005";16;8;7;2;3;36
"3916";"360610181006";5;5;2;0;2;14
"3917";"360610182001";40;41;3;0;18;102
"3918";"360610182002";45;34;6;0;9;94
"3919";"360610182003";26;31;11;2;63;133
"3920";"360610182004";68;24;6;0;0;98
"3921";"360610182005";113;18;4;1;2;138
"3922";"360610183001";46;7;5;0;22;80
"3923";"360610183002";26;1;4;0;0;31
"3924";"360610183003";16;8;7;0;8;39
"3925";"360610183004";4;18;8;0;8;38
"3926";"360610183005";3;11;14;0;14;42
"3927";"360610183006";38;200;19;2;21;280
"3928";"360610183007";31;19;6;2;26;84
"3929";"360610184001";62;36;16;4;30;148
"3930";"360610184002";41;24;7;1;22;95
"3931";"360610184003";40;7;2;1;1;51
"3932";"360610184004";118;2;5;2;0;127
"3933";"360610185001";9;7;8;0;6;30
"3934";"360610185002";25;16;17;0;6;64
"3935";"360610185003";0;18;7;0;0;25
"3936";"360610186001";162;35;6;1;0;204
"3937";"360610186002";70;28;6;2;14;120
"3938";"360610186003";203;8;0;0;1;212
"3939";"360610187001";34;7;17;1;12;71
"3940";"360610187002";9;8;11;0;9;37
"3941";"360610187003";27;15;7;0;16;65
"3942";"360610187004";22;8;5;1;6;42
"3943";"360610187005";160;51;4;1;21;237
"3944";"360610187006";63;22;9;0;20;114
"3945";"360610188001";160;40;18;1;31;250
"3946";"360610188002";62;185;17;4;44;312
"3947";"360610188003";49;62;9;0;66;186
"3948";"360610188004";65;44;11;1;36;157
"3949";"360610189001";34;31;9;1;8;83
"3950";"360610189002";48;74;16;2;24;164
"3951";"360610189003";448;40;3;0;4;495
"3952";"360610189004";62;182;3;2;19;268
"3953";"360610189005";82;76;3;3;34;198
"3954";"360610189006";158;9;4;0;6;177
"3955";"360610190001";152;45;21;2;27;247
"3956";"360610191001";18;10;6;0;7;41
"3957";"360610191002";10;11;11;0;17;49
"3958";"360610191003";15;5;1;0;1;22
"3959";"360610191004";53;11;5;1;6;76
"3960";"360610191005";44;92;6;0;27;169
"3961";"360610191006";74;63;7;0;15;159
"3962";"360610192001";130;66;21;4;12;233
"3963";"360610192002";25;6;2;0;2;35
"3964";"360610193001";18;32;2;0;110;162
"3965";"360610193002";83;52;6;0;14;155
"3966";"360610193003";85;40;6;1;27;159
"3967";"360610193004";41;27;4;3;19;94
"3968";"360610193005";54;28;3;0;15;100
"3969";"360610193006";20;29;13;3;26;91
"3970";"360610194001";301;11;7;0;12;331
"3971";"360610194002";27;14;11;1;28;81
"3972";"360610194003";15;16;3;0;11;45
"3973";"360610194004";55;7;9;1;10;82
"3974";"360610195001";15;41;4;1;5;66
"3975";"360610195002";19;66;12;0;12;109
"3976";"360610195003";132;142;2;1;20;297
"3977";"360610195004";67;87;5;2;16;177
"3978";"360610195005";46;38;6;0;18;108
"3979";"360610196001";75;4;6;0;11;96
"3980";"360610196002";65;10;8;3;17;103
"3981";"360610196003";32;8;19;2;46;107
"3982";"360610197011";23;70;11;1;14;119
"3983";"360610197021";79;45;9;0;32;165
"3984";"360610198001";107;84;15;6;36;248
"3985";"360610198002";7;21;8;3;7;46
"3986";"360610199001";17;56;13;1;8;95
"3987";"360610199002";7;10;6;0;8;31
"3988";"360610199003";7;0;3;1;2;13
"3989";"360610199004";10;13;11;0;5;39
"3990";"360610199005";19;9;4;0;7;39
"3991";"360610199006";47;65;11;1;21;145
"3992";"360610200001";160;17;2;4;17;200
"3993";"360610200002";90;352;51;1;97;591
"3994";"360610201011";1;11;9;0;2;23
"3995";"360610201021";21;54;13;0;13;101
"3996";"360610201022";154;79;16;3;22;274
"3997";"360610201023";9;17;4;4;7;41
"3998";"360610201024";96;12;5;3;12;128
"3999";"360610203001";9;3;4;0;3;19
"4000";"360610203002";2;10;7;1;1;21
"4001";"360610205001";16;14;3;1;3;37
"4002";"360610205002";4;2;7;0;1;14
"4003";"360610205003";0;2;3;0;2;7
"4004";"360610206001";135;176;26;3;59;399
"4005";"360610206002";42;32;27;10;29;140
"4006";"360610207011";5;10;2;0;2;19
"4007";"360610207012";1;5;6;0;7;19
"4008";"360610208001";57;16;7;6;11;97
"4009";"360610208002";148;57;4;5;14;228
"4010";"360610208003";47;23;7;3;14;94
"4011";"360610209011";66;23;17;1;37;144
"4012";"360610209012";115;21;6;1;2;145
"4013";"360610210001";50;9;9;0;8;76
"4014";"360610210002";75;10;10;1;4;100
"4015";"360610210003";174;15;8;1;3;201
"4016";"360610210004";211;10;5;5;1;232
"4017";"360610211001";19;12;3;0;5;39
"4018";"360610211002";18;21;1;0;6;46
"4019";"360610211003";64;111;5;0;22;202
"4020";"360610211004";64;4;6;0;4;78
"4021";"360610211005";68;0;1;0;0;69
"4022";"360610211006";2;10;4;0;1;17
"4023";"360610211007";21;14;5;0;13;53
"4024";"360610212001";75;36;10;1;6;128
"4025";"360610212002";2;3;5;0;2;12
"4026";"360610212003";10;2;1;0;2;15
"4027";"360610212004";36;30;9;1;4;80
"4028";"360610213031";36;16;4;1;21;78
"4029";"360610213032";40;79;20;2;11;152
"4030";"360610213033";142;84;6;1;18;251
"4031";"360610213034";177;20;1;0;22;220
"4032";"360610214001";37;6;8;3;10;64
"4033";"360610214002";34;16;6;0;2;58
"4034";"360610215001";15;33;9;0;28;85
"4035";"360610215002";95;51;10;1;10;167
"4036";"360610216001";129;30;11;2;26;198
"4037";"360610216002";48;12;1;0;6;67
"4038";"360610216003";139;70;2;0;12;223
"4039";"360610216004";51;49;10;4;26;140
"4040";"360610216005";115;63;21;5;13;217
"4041";"360610217031";16;135;13;2;3;169
"4042";"360610218001";41;39;18;2;25;125
"4043";"360610218002";80;89;9;1;26;205
"4044";"360610218003";90;84;29;3;30;236
"4045";"360610218004";142;124;19;3;28;316
"4046";"360610219001";28;27;24;2;34;115
"4047";"360610219002";78;58;10;0;10;156
"4048";"360610219003";262;4;2;3;5;276
"4049";"360610219004";21;6;2;2;1;32
"4050";"360610220001";42;33;8;8;23;114
"4051";"360610220002";55;25;1;1;22;104
"4052";"360610220003";26;13;4;0;5;48
"4053";"360610220004";59;54;10;1;13;137
"4054";"360610220005";98;18;2;3;25;146
"4055";"360610221021";111;50;10;0;30;201
"4056";"360610221022";16;18;13;4;13;64
"4057";"360610222001";59;32;24;2;57;174
"4058";"360610222002";90;96;18;0;48;252
"4059";"360610223011";69;65;5;0;16;155
"4060";"360610223012";74;122;10;0;45;251
"4061";"360610223013";189;176;9;0;30;404
"4062";"360610223014";194;91;2;1;13;301
"4063";"360610223021";66;86;7;2;17;178
"4064";"360610224001";38;16;12;0;14;80
"4065";"360610224002";45;34;22;4;34;139
"4066";"360610224003";112;7;10;0;7;136
"4067";"360610224004";263;5;9;0;1;278
"4068";"360610225001";322;90;5;2;40;459
"4069";"360610225002";74;41;5;1;28;149
"4070";"360610225003";104;135;12;4;37;292
"4071";"360610225004";71;20;3;0;5;99
"4072";"360610225005";115;60;14;0;33;222
"4073";"360610226001";67;68;13;1;16;165
"4074";"360610226002";66;38;10;4;13;131
"4075";"360610226003";90;67;29;0;21;207
"4076";"360610227001";177;22;17;3;50;269
"4077";"360610227002";75;7;12;1;10;105
"4078";"360610227003";157;46;18;2;17;240
"4079";"360610228001";120;88;11;3;16;238
"4080";"360610228002";89;17;8;0;6;120
"4081";"360610228003";117;80;7;4;17;225
"4082";"360610228004";25;30;11;2;9;77
"4083";"360610229001";18;6;3;0;15;42
"4084";"360610229002";64;42;4;1;14;125
"4085";"360610229003";119;52;3;6;60;240
"4086";"360610229004";94;35;2;1;18;150
"4087";"360610229005";112;62;9;0;30;213
"4088";"360610230001";113;25;8;1;18;165
"4089";"360610230002";121;17;12;1;11;162
"4090";"360610230003";28;23;15;7;16;89
"4091";"360610230004";134;32;12;3;7;188
"4092";"360610230005";138;32;3;0;8;181
"4093";"360610231001";73;67;25;5;28;198
"4094";"360610231002";213;240;17;1;392;863
"4095";"360610231003";160;109;18;1;51;339
"4096";"360610232001";47;15;11;1;22;96
"4097";"360610232002";290;17;4;5;12;328
"4098";"360610232003";350;35;1;4;5;395
"4099";"360610232004";110;27;11;4;14;166
"4100";"360610233001";209;139;6;1;46;401
"4101";"360610233002";104;60;10;2;39;215
"4102";"360610233003";146;76;28;1;37;288
"4103";"360610234001";216;233;8;12;38;507
"4104";"360610234002";102;45;14;7;13;181
"4105";"360610235011";26;19;12;0;20;77
"4106";"360610235012";192;90;6;0;69;357
"4107";"360610235013";24;12;4;2;10;52
"4108";"360610235014";135;18;5;0;24;182
"4109";"360610235021";112;28;8;4;26;178
"4110";"360610236001";74;26;15;5;10;130
"4111";"360610236002";161;24;4;6;9;204
"4112";"360610236003";27;5;0;1;0;33
"4113";"360610236004";88;17;8;1;5;119
"4114";"360610237001";199;140;27;3;36;405
"4115";"360610237002";174;132;5;2;24;337
"4116";"360610237003";136;63;31;5;42;277
"4117";"360610238011";5;2;0;1;7;15
"4118";"360610238021";0;1;0;0;1;2
"4119";"360610238022";1;2;0;0;0;3
"4120";"360610239001";49;14;5;0;19;87
"4121";"360610239002";68;97;5;1;21;192
"4122";"360610240001";2;81;3;0;2;88
"4123";"360610241001";64;54;8;6;28;160
"4124";"360610241002";35;62;3;1;16;117
"4125";"360610241003";53;96;9;2;28;188
"4126";"360610241004";137;62;3;1;27;230
"4127";"360610241005";74;49;2;0;18;143
"4128";"360610242001";62;12;9;2;8;93
"4129";"360610242002";36;4;3;0;6;49
"4130";"360610242003";33;10;31;12;51;137
"4131";"360610243011";207;33;8;0;26;274
"4132";"360610243012";71;21;15;1;35;143
"4133";"360610243013";24;24;3;0;23;74
"4134";"360610243021";864;27;22;2;14;929
"4135";"360610243023";73;0;0;0;1;74
"4136";"360610245001";141;86;6;3;37;273
"4137";"360610245002";127;45;1;1;29;203
"4138";"360610245003";352;142;4;0;58;556
"4139";"360610245004";85;44;87;0;85;301
"4140";"360610245005";92;60;2;1;56;211
"4141";"360610245006";169;32;7;0;59;267
"4142";"360610245007";113;42;1;0;34;190
"4143";"360610247001";71;35;27;2;36;171
"4144";"360610247002";93;80;3;2;31;209
"4145";"360610247003";116;79;4;0;16;215
"4146";"360610247004";112;131;3;1;32;279
"4147";"360610247005";41;47;6;0;11;105
"4148";"360610249001";72;21;3;2;32;130
"4149";"360610251001";27;29;20;0;26;102
"4150";"360610251002";115;30;8;3;40;196
"4151";"360610253001";47;13;4;1;14;79
"4152";"360610253002";101;67;5;0;52;225
"4153";"360610253003";52;59;8;0;36;155
"4154";"360610253004";23;26;12;0;32;93
"4155";"360610253005";293;84;6;0;25;408
"4156";"360610253006";137;55;13;2;18;225
"4157";"360610255001";64;26;15;5;4;114
"4158";"360610255002";71;61;6;5;15;158
"4159";"360610255003";107;25;3;1;10;146
"4160";"360610255004";36;19;3;1;12;71
"4161";"360610257001";109;34;11;1;51;206
"4162";"360610257002";22;49;17;0;11;99
"4163";"360610257003";48;24;6;1;9;88
"4164";"360610259001";112;67;38;23;11;251
"4165";"360610259002";35;50;12;3;23;123
"4166";"360610261001";90;74;1;1;43;209
"4167";"360610261002";67;32;1;0;11;111
"4168";"360610261003";87;9;1;0;12;109
"4169";"360610261004";34;26;5;1;25;91
"4170";"360610261005";61;37;6;2;17;123
"4171";"360610261006";21;23;4;4;11;63
"4172";"360610261007";51;75;6;1;29;162
"4173";"360610263001";46;52;8;0;31;137
"4174";"360610263002";60;43;2;0;26;131
"4175";"360610263003";123;146;16;1;35;321
"4176";"360610263004";152;67;16;1;36;272
"4177";"360610263005";56;25;11;2;23;117
"4178";"360610265001";71;6;4;1;5;87
"4179";"360610265002";79;32;3;0;19;133
"4180";"360610265003";42;79;6;5;23;155
"4181";"360610265004";130;26;5;0;33;194
"4182";"360610265005";37;21;8;2;15;83
"4183";"360610267001";70;7;7;4;3;91
"4184";"360610269001";50;11;6;1;11;79
"4185";"360610269002";67;35;5;0;20;127
"4186";"360610269003";19;8;3;3;13;46
"4187";"360610269004";55;43;1;1;62;162
"4188";"360610269005";73;50;8;0;40;171
"4189";"360610269006";163;70;2;1;33;269
"4190";"360610271001";121;68;10;0;26;225
"4191";"360610271002";65;150;8;1;42;266
"4192";"360610271003";58;53;25;4;23;163
"4193";"360610271004";75;96;17;1;17;206
"4194";"360610271005";73;8;8;2;4;95
"4195";"360610273001";120;55;23;1;8;207
"4196";"360610273002";38;13;12;2;10;75
"4197";"360610273003";30;106;21;1;39;197
"4198";"360610273004";32;19;2;0;9;62
"4199";"360610275001";7;18;3;0;5;33
"4200";"360610275002";1;3;2;0;1;7
"4201";"360610277001";120;40;17;3;39;219
"4202";"360610277002";69;15;3;0;25;112
"4203";"360610277003";61;105;6;5;38;215
"4204";"360610277004";25;11;0;0;13;49
"4205";"360610279001";51;38;4;0;17;110
"4206";"360610279002";160;145;4;2;25;336
"4207";"360610279003";60;143;2;1;45;251
"4208";"360610279004";69;68;13;2;34;186
"4209";"360610279005";73;50;8;0;9;140
"4210";"360610279006";41;35;4;0;9;89
"4211";"360610279007";33;53;0;0;11;97
"4212";"360610281001";25;18;6;6;6;61
"4213";"360610281002";69;71;24;0;19;183
"4214";"360610283001";7;13;1;0;16;37
"4215";"360610283002";339;126;34;3;47;549
"4216";"360610283003";63;36;7;1;9;116
"4217";"360610283004";95;42;1;1;21;160
"4218";"360610285001";173;91;7;2;121;394
"4219";"360610285002";185;52;2;0;20;259
"4220";"360610285003";240;26;0;0;13;279
"4221";"360610285004";228;110;7;0;35;380
"4222";"360610287001";87;197;23;4;35;346
"4223";"360610287002";112;47;5;0;12;176
"4224";"360610287003";107;145;6;0;48;306
"4225";"360610291001";93;33;1;0;15;142
"4226";"360610291002";56;12;2;0;15;85
"4227";"360610291003";35;13;6;0;10;64
"4228";"360610291004";64;79;1;0;19;163
"4229";"360610291005";108;111;3;0;9;231
"4230";"360610291006";69;52;3;0;30;154
"4231";"360610291007";100;49;3;2;24;178
"4232";"360610293001";139;83;20;2;32;276
"4233";"360610293002";77;43;8;3;31;162
"4234";"360610293003";81;66;16;0;32;195
"4235";"360610293004";109;104;11;1;41;266
"4236";"360610293005";73;20;0;1;22;116
"4237";"360610295001";92;80;15;2;21;210
"4238";"360610295002";110;220;11;1;21;363
"4239";"360610295003";165;32;15;1;23;236
"4240";"360610295004";80;21;19;0;42;162
"4241";"360610297001";19;121;28;2;13;183
"4242";"360610299001";206;48;20;0;9;283
"4243";"360610299002";35;113;65;10;60;283
"4244";"360610303001";62;124;6;1;46;239
"4245";"360610303002";121;86;15;3;39;264
"4246";"360610303003";64;55;19;1;9;148
"4247";"360610307001";48;69;14;0;16;147
"4248";"360610307002";6;4;15;3;1;29
"4249";"360610307003";91;23;8;0;8;130
"4250";"360610309001";162;16;8;2;9;197
"4251";"360610309002";90;15;16;0;25;146
"4252";"360610309003";102;11;10;0;12;135
"4253";"360610309004";61;83;65;3;24;236
"4254";"360610311001";27;47;23;6;14;117
"4255";"360610317031";7;33;8;0;7;55
"4256";"360610317032";0;32;16;2;2;52
"4257";"360610317041";16;41;29;1;10;97
"4258";"360610317042";2;11;7;0;0;20
"4259";"360610317043";2;8;13;1;2;26
"4260";"360610317044";14;12;14;0;12;52
"4261";"360610319001";1;5;5;0;0;11
"4262";"360810001001";18;59;137;31;47;292
"4263";"360810002001";35;9;52;22;34;152
"4264";"360810002002";104;19;71;26;46;266
"4265";"360810004001";50;42;65;23;60;240
"4266";"360810004002";47;68;37;33;60;245
"4267";"360810004003";18;8;69;44;35;174
"4268";"360810006001";15;30;66;32;33;176
"4269";"360810006002";21;12;52;24;22;131
"4270";"360810006003";57;9;60;33;37;196
"4271";"360810007001";42;18;59;8;16;143
"4272";"360810007002";14;8;64;14;17;117
"4273";"360810007003";8;28;80;20;24;160
"4274";"360810007004";25;36;96;14;33;204
"4275";"360810008001";34;8;53;18;40;153
"4276";"360810008002";72;5;99;22;35;233
"4277";"360810010001";13;5;16;7;24;65
"4278";"360810010002";66;5;59;28;48;206
"4279";"360810012001";16;3;31;28;20;98
"4280";"360810012002";18;6;91;13;19;147
"4281";"360810012003";45;4;43;9;20;121
"4282";"360810014001";21;3;36;26;26;112
"4283";"360810014002";19;5;42;9;17;92
"4284";"360810014003";73;8;62;30;55;228
"4285";"360810016001";34;2;52;23;36;147
"4286";"360810016002";68;7;75;17;63;230
"4287";"360810018001";68;8;38;6;38;158
"4288";"360810018002";30;6;65;22;17;140
"4289";"360810019001";13;39;230;106;95;483
"4290";"360810020001";74;7;38;33;45;197
"4291";"360810022001";23;13;70;14;17;137
"4292";"360810022002";54;8;22;14;21;119
"4293";"360810024001";16;4;37;25;24;106
"4294";"360810024002";23;13;81;14;33;164
"4295";"360810025001";46;7;2;0;2;57
"4296";"360810025002";67;9;1;0;2;79
"4297";"360810025003";125;9;3;0;5;142
"4298";"360810025004";54;4;0;1;10;69
"4299";"360810025005";42;1;2;0;2;47
"4300";"360810025006";49;6;1;0;4;60
"4301";"360810026001";19;6;23;20;19;87
"4302";"360810026002";52;19;76;31;87;265
"4303";"360810028001";61;15;88;30;63;257
"4304";"360810028002";31;12;44;39;41;167
"4305";"360810030001";36;9;54;13;29;141
"4306";"360810031001";17;14;28;13;20;92
"4307";"360810031002";25;7;78;24;28;162
"4308";"360810032001";51;9;52;28;40;180
"4309";"360810033001";30;32;41;4;52;159
"4310";"360810033002";20;42;102;6;25;195
"4311";"360810033003";19;2;94;23;32;170
"4312";"360810033004";7;1;39;58;21;126
"4313";"360810034001";20;15;48;27;79;189
"4314";"360810034002";28;22;19;28;41;138
"4315";"360810036001";30;9;52;36;42;169
"4316";"360810036002";30;6;43;38;37;154
"4317";"360810037001";1;9;5;2;5;22
"4318";"360810038001";67;2;59;26;26;180
"4319";"360810038002";44;9;45;18;39;155
"4320";"360810039001";28;8;127;46;39;248
"4321";"360810040011";30;6;63;5;22;126
"4322";"360810040012";29;5;47;9;18;108
"4323";"360810040021";31;7;61;60;37;196
"4324";"360810042001";37;9;44;31;51;172
"4325";"360810042002";16;28;36;25;55;160
"4326";"360810042003";21;55;26;21;61;184
"4327";"360810043001";240;31;13;6;9;299
"4328";"360810043002";2;1;29;32;3;67
"4329";"360810044011";20;12;34;18;107;191
"4330";"360810044012";31;4;44;34;41;154
"4331";"360810045001";16;8;64;19;8;115
"4332";"360810045002";1;2;4;6;0;13
"4333";"360810045003";3;3;5;0;3;14
"4334";"360810047001";23;8;51;4;62;148
"4335";"360810047002";198;8;5;0;2;213
"4336";"360810050001";1;0;5;7;0;13
"4337";"360810051001";40;25;42;14;28;149
"4338";"360810051002";16;10;67;23;21;137
"4339";"360810052001";24;7;27;15;43;116
"4340";"360810052002";33;14;40;11;61;159
"4341";"360810053001";12;134;25;4;14;189
"4342";"360810053002";109;3;31;8;19;170
"4343";"360810053003";13;5;26;1;6;51
"4344";"360810053004";23;15;71;0;30;139
"4345";"360810054001";15;6;36;21;12;90
"4346";"360810054002";20;3;53;16;19;111
"4347";"360810054003";52;18;80;31;69;250
"4348";"360810054004";47;8;73;26;81;235
"4349";"360810055001";34;86;58;9;52;239
"4350";"360810057001";52;75;29;12;39;207
"4351";"360810057002";46;9;23;2;8;88
"4352";"360810057003";50;182;22;1;39;294
"4353";"360810058001";53;18;113;43;44;271
"4354";"360810058002";11;8;24;19;31;93
"4355";"360810058003";25;3;32;21;38;119
"4356";"360810058004";6;7;37;36;24;110
"4357";"360810059001";16;18;49;6;26;115
"4358";"360810059002";25;39;39;0;19;122
"4359";"360810059003";14;129;31;2;47;223
"4360";"360810061001";15;27;61;0;14;117
"4361";"360810061002";23;32;30;1;17;103
"4362";"360810061003";33;79;8;1;16;137
"4363";"360810061004";5;8;39;0;17;69
"4364";"360810062011";13;0;6;12;5;36
"4365";"360810062012";27;3;20;32;22;104
"4366";"360810062021";3;17;8;10;44;82
"4367";"360810062022";16;11;49;12;16;104
"4368";"360810062023";8;4;42;20;43;117
"4369";"360810062024";5;0;23;4;7;39
"4370";"360810062025";14;1;15;11;37;78
"4371";"360810062026";11;3;20;13;20;67
"4372";"360810062027";29;4;72;21;70;196
"4373";"360810063001";24;7;57;6;26;120
"4374";"360810063002";29;28;34;2;28;121
"4375";"360810063003";17;18;16;5;23;79
"4376";"360810063004";8;52;24;3;20;107
"4377";"360810065011";35;74;5;5;13;132
"4378";"360810065012";17;3;41;2;32;95
"4379";"360810065013";9;52;61;1;1;124
"4380";"360810065021";26;148;45;5;49;273
"4381";"360810065022";24;18;48;5;16;111
"4382";"360810065023";18;11;64;4;21;118
"4383";"360810069001";32;56;58;0;18;164
"4384";"360810069002";60;39;44;4;27;174
"4385";"360810069003";14;78;39;8;23;162
"4386";"360810071001";9;10;45;2;19;85
"4387";"360810071002";15;4;11;1;4;35
"4388";"360810071003";25;7;32;1;17;82
"4389";"360810071004";15;78;63;5;30;191
"4390";"360810073001";32;21;24;4;14;95
"4391";"360810073002";25;6;26;1;13;71
"4392";"360810073003";40;5;39;0;9;93
"4393";"360810075001";49;4;72;2;16;143
"4394";"360810075002";57;7;17;0;14;95
"4395";"360810075003";14;16;22;0;10;62
"4396";"360810077001";28;14;83;12;42;179
"4397";"360810079001";41;22;60;31;39;193
"4398";"360810079002";8;6;58;20;23;115
"4399";"360810081001";29;20;49;29;30;157
"4400";"360810083001";19;19;190;16;42;286
"4401";"360810083002";48;30;73;37;25;213
"4402";"360810085001";17;20;78;28;29;172
"4403";"360810085002";1;9;42;17;31;100
"4404";"360810086001";17;5;51;19;43;135
"4405";"360810086002";32;5;41;30;26;134
"4406";"360810087001";116;6;7;0;3;132
"4407";"360810087002";16;9;20;14;7;66
"4408";"360810087003";28;5;4;3;1;41
"4409";"360810088001";22;8;54;44;42;170
"4410";"360810088002";15;4;45;18;33;115
"4411";"360810091001";5;6;15;5;13;44
"4412";"360810091002";33;13;87;14;14;161
"4413";"360810094001";63;16;50;15;81;225
"4414";"360810094002";52;31;37;21;91;232
"4415";"360810095001";10;6;33;0;3;52
"4416";"360810095002";23;16;24;13;26;102
"4417";"360810096001";61;11;53;19;118;262
"4418";"360810096002";71;23;76;18;80;268
"4419";"360810097001";22;3;19;0;6;50
"4420";"360810097002";5;6;23;10;14;58
"4421";"360810097003";9;2;6;3;13;33
"4422";"360810097004";16;49;21;5;23;114
"4423";"360810098001";46;7;87;13;69;222
"4424";"360810098002";134;30;48;15;64;291
"4425";"360810099001";0;30;6;8;5;49
"4426";"360810100001";48;30;23;13;62;176
"4427";"360810100002";60;22;55;30;211;378
"4428";"360810101001";13;6;33;12;29;93
"4429";"360810101002";18;65;38;8;28;157
"4430";"360810102001";23;5;65;24;58;175
"4431";"360810102002";31;26;48;19;34;158
"4432";"360810103001";16;54;7;11;13;101
"4433";"360810103002";5;13;33;9;10;70
"4434";"360810103003";16;4;22;5;16;63
"4435";"360810103004";12;9;15;0;12;48
"4436";"360810104001";86;19;74;9;100;288
"4437";"360810104002";106;15;74;34;57;286
"4438";"360810105001";126;14;6;5;3;154
"4439";"360810105002";65;23;5;4;1;98
"4440";"360810105003";8;8;12;2;10;40
"4441";"360810105004";24;5;18;2;8;57
"4442";"360810106001";53;11;89;24;84;261
"4443";"360810106002";80;27;89;14;98;308
"4444";"360810107011";0;1;10;8;3;22
"4445";"360810108001";104;6;66;5;185;366
"4446";"360810108002";48;10;113;32;128;331
"4447";"360810110001";8;8;54;51;37;158
"4448";"360810110002";51;53;91;31;68;294
"4449";"360810111001";20;8;17;27;12;84
"4450";"360810111002";16;5;33;4;11;69
"4451";"360810112001";48;8;38;15;117;226
"4452";"360810112002";19;5;102;17;107;250
"4453";"360810113001";21;4;5;1;12;43
"4454";"360810113002";39;21;19;1;14;94
"4455";"360810113003";19;16;38;4;32;109
"4456";"360810114001";49;26;25;26;52;178
"4457";"360810115001";26;31;85;7;55;204
"4458";"360810115002";8;18;45;3;46;120
"4459";"360810116001";48;26;22;34;42;172
"4460";"360810116002";43;12;57;30;38;180
"4461";"360810117001";14;10;32;2;7;65
"4462";"360810117002";18;5;8;5;26;62
"4463";"360810117003";17;16;69;5;26;133
"4464";"360810117004";15;4;24;4;15;62
"4465";"360810118001";21;5;128;24;105;283
"4466";"360810118002";21;4;26;15;43;109
"4467";"360810119001";65;12;21;1;12;111
"4468";"360810119002";20;4;29;8;10;71
"4469";"360810120001";7;2;17;9;17;52
"4470";"360810120002";28;13;61;18;63;183
"4471";"360810121001";16;5;56;7;31;115
"4472";"360810121002";14;5;27;1;21;68
"4473";"360810122001";55;142;34;7;43;281
"4474";"360810122002";35;12;45;30;78;200
"4475";"360810123011";11;20;50;39;39;159
"4476";"360810123012";9;5;66;5;51;136
"4477";"360810123013";3;2;12;8;14;39
"4478";"360810124001";27;3;36;43;51;160
"4479";"360810124002";46;23;72;32;68;241
"4480";"360810125001";13;5;53;6;30;107
"4481";"360810125002";13;34;17;2;16;82
"4482";"360810126011";55;12;54;32;69;222
"4483";"360810126012";23;45;39;23;38;168
"4484";"360810126021";20;48;24;8;63;163
"4485";"360810126022";30;20;38;22;51;161
"4486";"360810128001";26;5;12;15;8;66
"4487";"360810128002";47;22;48;16;58;191
"4488";"360810130001";16;2;6;11;8;43
"4489";"360810130002";19;12;11;22;46;110
"4490";"360810132001";8;9;36;11;12;76
"4491";"360810132002";32;11;18;16;71;148
"4492";"360810134001";110;2;44;0;9;165
"4493";"360810134002";37;5;38;3;7;90
"4494";"360810134003";63;5;23;3;8;102
"4495";"360810134004";15;0;9;2;7;33
"4496";"360810135001";5;2;43;6;23;79
"4497";"360810136001";6;6;18;3;12;45
"4498";"360810136002";8;8;14;2;8;40
"4499";"360810137001";18;24;130;14;28;214
"4500";"360810138001";43;5;30;0;18;96
"4501";"360810138002";81;13;122;12;52;280
"4502";"360810140001";45;5;42;8;40;140
"4503";"360810140002";213;24;84;9;38;368
"4504";"360810141001";18;1;14;4;2;39
"4505";"360810141002";38;8;82;22;29;179
"4506";"360810142011";19;4;82;5;68;178
"4507";"360810142012";55;13;78;34;117;297
"4508";"360810142021";27;17;168;31;69;312
"4509";"360810142022";16;6;43;18;51;134
"4510";"360810143001";45;9;89;2;21;166
"4511";"360810143002";80;154;65;1;66;366
"4512";"360810144001";35;10;118;14;87;264
"4513";"360810145001";7;2;46;20;36;111
"4514";"360810145002";10;8;49;12;9;88
"4515";"360810147001";6;3;20;10;10;49
"4516";"360810147002";11;2;10;18;8;49
"4517";"360810147003";14;35;74;2;21;146
"4518";"360810148001";51;12;65;27;90;245
"4519";"360810149001";22;20;33;3;18;96
"4520";"360810149002";25;15;37;4;53;134
"4521";"360810150001";111;7;33;24;29;204
"4522";"360810150002";55;1;38;15;44;153
"4523";"360810151001";9;9;50;14;24;106
"4524";"360810151002";27;13;62;8;26;136
"4525";"360810152001";22;6;73;10;56;167
"4526";"360810152002";29;7;48;41;66;191
"4527";"360810153001";16;4;53;7;25;105
"4528";"360810153002";15;12;35;5;25;92
"4529";"360810154001";20;2;25;12;23;82
"4530";"360810154002";28;24;50;24;52;178
"4531";"360810155001";11;41;48;0;18;118
"4532";"360810155002";9;38;22;1;39;109
"4533";"360810156001";41;16;51;20;83;211
"4534";"360810156002";43;10;57;16;93;219
"4535";"360810157001";38;49;27;23;29;166
"4536";"360810158011";38;18;45;35;54;190
"4537";"360810158012";56;4;22;8;56;146
"4538";"360810158013";63;13;66;19;93;254
"4539";"360810158021";59;18;65;14;49;205
"4540";"360810158022";42;59;116;9;99;325
"4541";"360810158023";74;14;50;12;87;237
"4542";"360810159001";13;6;43;1;16;79
"4543";"360810159002";33;11;16;15;21;96
"4544";"360810159003";46;8;10;4;20;88
"4545";"360810159004";30;48;57;2;13;150
"4546";"360810161001";14;27;33;3;33;110
"4547";"360810161002";35;12;18;2;12;79
"4548";"360810163001";7;4;13;4;27;55
"4549";"360810163002";28;33;1;0;1;63
"4550";"360810163003";108;11;9;3;2;133
"4551";"360810164001";33;4;170;12;47;266
"4552";"360810164002";81;18;95;14;99;307
"4553";"360810166001";56;7;99;13;112;287
"4554";"360810166002";28;16;44;5;43;136
"4555";"360810168001";127;14;38;24;72;275
"4556";"360810168002";31;9;78;33;31;182
"4557";"360810169001";25;9;14;4;5;57
"4558";"360810169002";21;4;49;2;15;91
"4559";"360810169003";37;5;49;1;12;104
"4560";"360810169004";23;15;10;0;10;58
"4561";"360810170001";55;10;83;29;41;218
"4562";"360810170002";31;10;37;24;53;155
"4563";"360810171001";4;20;74;36;27;161
"4564";"360810172001";58;8;50;16;38;170
"4565";"360810172002";31;14;18;30;22;115
"4566";"360810174001";44;17;27;27;17;132
"4567";"360810174002";33;4;67;38;47;189
"4568";"360810176001";33;4;36;12;32;117
"4569";"360810176002";19;2;26;7;27;81
"4570";"360810178001";62;14;50;11;28;165
"4571";"360810178002";31;5;45;26;37;144
"4572";"360810179001";8;4;60;21;22;115
"4573";"360810179002";12;21;38;1;16;88
"4574";"360810180001";13;8;51;47;39;158
"4575";"360810181011";38;2;8;0;7;55
"4576";"360810181012";61;22;10;0;15;108
"4577";"360810181013";46;22;6;2;10;86
"4578";"360810181021";31;7;7;2;12;59
"4579";"360810181022";17;10;5;1;11;44
"4580";"360810181023";69;16;14;0;10;109
"4581";"360810182001";28;8;27;21;24;108
"4582";"360810182002";54;2;41;23;28;148
"4583";"360810183001";18;4;10;9;7;48
"4584";"360810183002";22;8;7;0;3;40
"4585";"360810183003";33;13;18;1;9;74
"4586";"360810183004";47;11;19;2;22;101
"4587";"360810183005";43;164;18;1;37;263
"4588";"360810184011";97;9;77;68;55;306
"4589";"360810184021";15;6;38;13;43;115
"4590";"360810184022";5;2;47;19;14;87
"4591";"360810185011";3;4;22;6;9;44
"4592";"360810185012";42;4;3;3;1;53
"4593";"360810185013";30;6;39;0;25;100
"4594";"360810185021";15;3;14;0;6;38
"4595";"360810185022";41;8;68;2;16;135
"4596";"360810185023";13;70;14;1;12;110
"4597";"360810186001";68;9;80;54;48;259
"4598";"360810187001";29;4;33;1;11;78
"4599";"360810187002";8;2;28;4;18;60
"4600";"360810187003";10;2;29;4;21;66
"4601";"360810188001";14;3;37;25;17;96
"4602";"360810189001";86;25;14;0;24;149
"4603";"360810189002";48;14;77;10;35;184
"4604";"360810189003";160;3;18;1;5;187
"4605";"360810190001";41;6;42;23;23;135
"4606";"360810190002";11;3;40;13;23;90
"4607";"360810192001";24;7;31;17;27;106
"4608";"360810192002";28;17;25;23;37;130
"4609";"360810194001";5;3;21;38;23;90
"4610";"360810194002";28;13;60;42;46;189
"4611";"360810196001";43;2;27;9;24;105
"4612";"360810196002";19;12;26;57;33;147
"4613";"360810198001";24;32;14;10;20;100
"4614";"360810198002";31;6;12;35;24;108
"4615";"360810198003";12;0;14;23;28;77
"4616";"360810199001";1;1;72;7;27;108
"4617";"360810199002";51;1;87;85;68;292
"4618";"360810202001";14;5;72;44;37;172
"4619";"360810204001";14;3;43;51;62;173
"4620";"360810204002";20;8;32;38;58;156
"4621";"360810205001";0;7;39;12;23;81
"4622";"360810205002";18;4;18;38;3;81
"4623";"360810206001";36;11;115;134;57;353
"4624";"360810208001";18;3;72;16;22;131
"4625";"360810208002";21;50;84;60;77;292
"4626";"360810212001";11;6;30;3;63;113
"4627";"360810212002";46;6;68;11;34;165
"4628";"360810214001";120;5;79;3;8;215
"4629";"360810214002";27;16;83;9;13;148
"4630";"360810214003";30;18;157;38;66;309
"4631";"360810216001";13;5;48;2;12;80
"4632";"360810216002";8;4;60;7;5;84
"4633";"360810216003";51;5;35;16;18;125
"4634";"360810219001";1;1;37;18;37;94
"4635";"360810220011";5;1;40;12;18;76
"4636";"360810220012";72;6;132;1;10;221
"4637";"360810220013";52;10;27;4;11;104
"4638";"360810220014";29;5;4;1;1;40
"4639";"360810220021";9;3;25;7;13;57
"4640";"360810220022";20;4;54;9;10;97
"4641";"360810220023";87;7;82;2;50;228
"4642";"360810220024";49;4;54;2;12;121
"4643";"360810229001";1;1;23;12;6;43
"4644";"360810230001";4;0;21;6;22;53
"4645";"360810230002";16;1;11;7;35;70
"4646";"360810232001";11;1;13;3;2;30
"4647";"360810232002";14;4;126;1;19;164
"4648";"360810232003";11;3;59;7;37;117
"4649";"360810235001";31;9;12;2;21;75
"4650";"360810235002";39;46;8;2;24;119
"4651";"360810235003";17;5;12;5;9;48
"4652";"360810235004";30;9;24;3;56;122
"4653";"360810236001";16;5;39;5;31;96
"4654";"360810236002";38;12;8;2;28;88
"4655";"360810238001";7;10;19;0;16;52
"4656";"360810238002";16;19;9;4;47;95
"4657";"360810238003";187;6;2;4;9;208
"4658";"360810238004";24;4;22;0;49;99
"4659";"360810240001";24;7;15;2;47;95
"4660";"360810240002";16;12;17;2;35;82
"4661";"360810240003";39;7;6;2;12;66
"4662";"360810243001";4;1;16;28;29;78
"4663";"360810243002";7;4;21;26;19;77
"4664";"360810243003";13;7;65;32;52;169
"4665";"360810243004";27;7;105;133;46;318
"4666";"360810245001";4;0;2;0;1;7
"4667";"360810245002";18;1;25;6;5;55
"4668";"360810245003";0;0;5;3;10;18
"4669";"360810245004";12;2;47;11;5;77
"4670";"360810246001";1;0;14;1;11;27
"4671";"360810247001";19;5;34;8;12;78
"4672";"360810249001";29;3;47;4;24;107
"4673";"360810249002";57;4;22;4;13;100
"4674";"360810249003";22;27;89;4;24;166
"4675";"360810251001";26;9;17;1;14;67
"4676";"360810251002";14;2;32;1;14;63
"4677";"360810251003";27;22;116;2;27;194
"4678";"360810251004";84;24;29;5;44;186
"4679";"360810253011";46;6;38;1;11;102
"4680";"360810253012";53;85;7;1;13;159
"4681";"360810253013";63;4;0;0;4;71
"4682";"360810253014";69;30;25;2;23;149
"4683";"360810253021";29;4;1;1;8;43
"4684";"360810253022";48;19;106;2;30;205
"4685";"360810254001";19;8;43;27;46;143
"4686";"360810254002";41;6;17;13;15;92
"4687";"360810254003";142;23;17;6;10;198
"4688";"360810254004";43;6;5;22;12;88
"4689";"360810254005";55;3;84;27;21;190
"4690";"360810254006";15;8;39;32;8;102
"4691";"360810255001";21;13;86;25;42;187
"4692";"360810257001";19;11;98;27;41;196
"4693";"360810258001";14;17;33;20;33;117
"4694";"360810258002";28;3;23;15;16;85
"4695";"360810259001";41;10;74;9;39;173
"4696";"360810259002";37;12;50;3;33;135
"4697";"360810260001";12;1;12;6;22;53
"4698";"360810260002";53;2;30;31;28;144
"4699";"360810261001";15;28;12;0;17;72
"4700";"360810261002";59;0;44;1;19;123
"4701";"360810261003";86;540;17;4;76;723
"4702";"360810261004";53;73;69;4;44;243
"4703";"360810262001";22;4;54;22;24;126
"4704";"360810263001";11;95;31;2;46;185
"4705";"360810263002";38;27;41;0;50;156
"4706";"360810263003";34;5;44;0;12;95
"4707";"360810264001";11;2;17;11;15;56
"4708";"360810264002";45;7;35;33;20;140
"4709";"360810265001";34;20;70;2;46;172
"4710";"360810265002";31;2;50;1;21;105
"4711";"360810266001";38;18;18;19;38;131
"4712";"360810267001";44;24;44;1;25;138
"4713";"360810267002";13;14;30;1;21;79
"4714";"360810267003";31;6;99;6;29;171
"4715";"360810269011";27;52;11;1;44;135
"4716";"360810269012";51;6;7;0;10;74
"4717";"360810269013";31;9;8;0;12;60
"4718";"360810269014";6;32;29;1;34;102
"4719";"360810269021";98;7;37;1;21;164
"4720";"360810269022";32;3;36;0;27;98
"4721";"360810270001";39;6;57;33;64;199
"4722";"360810271001";107;43;24;0;12;186
"4723";"360810271002";19;2;18;1;18;58
"4724";"360810271003";25;4;56;2;22;109
"4725";"360810271004";27;3;8;0;11;49
"4726";"360810271005";70;2;6;0;16;94
"4727";"360810272001";5;1;37;18;17;78
"4728";"360810272002";13;11;24;13;16;77
"4729";"360810273001";11;6;15;2;4;38
"4730";"360810273002";98;4;5;1;12;120
"4731";"360810273003";106;21;6;0;12;145
"4732";"360810273004";27;4;32;2;35;100
"4733";"360810273005";46;13;51;3;26;139
"4734";"360810274001";24;4;28;25;24;105
"4735";"360810275001";6;2;1;1;1;11
"4736";"360810275002";64;5;55;3;39;166
"4737";"360810275003";78;2;69;7;63;219
"4738";"360810276001";80;31;71;30;29;241
"4739";"360810277001";10;0;2;0;5;17
"4740";"360810277002";38;11;14;1;25;89
"4741";"360810277003";73;2;10;0;6;91
"4742";"360810277004";22;5;11;3;20;61
"4743";"360810277005";96;19;39;6;36;196
"4744";"360810278001";26;7;9;7;11;60
"4745";"360810278002";28;5;1;1;3;38
"4746";"360810279001";26;5;52;2;21;106
"4747";"360810279002";42;5;27;1;20;95
"4748";"360810279003";20;54;8;6;15;103
"4749";"360810279004";4;10;4;1;5;24
"4750";"360810280001";21;7;32;22;56;138
"4751";"360810281001";47;34;46;7;13;147
"4752";"360810281002";73;9;13;3;15;113
"4753";"360810281003";15;25;12;0;7;59
"4754";"360810281004";42;23;19;0;14;98
"4755";"360810282001";11;6;31;4;34;86
"4756";"360810283001";27;13;9;0;7;56
"4757";"360810283002";52;11;6;0;14;83
"4758";"360810283003";14;42;3;0;25;84
"4759";"360810283004";32;13;7;1;19;72
"4760";"360810283005";90;3;2;1;7;103
"4761";"360810284001";24;3;39;29;35;130
"4762";"360810284002";41;2;12;12;21;88
"4763";"360810285001";9;12;1;6;1;29
"4764";"360810285002";39;1;6;1;1;48
"4765";"360810285003";9;8;17;1;12;47
"4766";"360810285004";47;64;10;6;23;150
"4767";"360810287001";36;8;13;5;6;68
"4768";"360810287002";6;8;7;0;2;23
"4769";"360810287003";65;35;55;2;22;179
"4770";"360810287004";74;10;8;6;4;102
"4771";"360810288001";11;1;6;9;18;45
"4772";"360810288002";16;11;24;13;23;87
"4773";"360810288003";11;7;8;8;10;44
"4774";"360810288004";43;10;24;24;25;126
"4775";"360810289001";52;17;12;1;14;96
"4776";"360810289002";20;4;38;1;6;69
"4777";"360810289003";99;37;35;0;28;199
"4778";"360810291001";12;1;11;5;30;59
"4779";"360810291002";50;7;17;7;45;126
"4780";"360810291003";35;4;9;2;40;90
"4781";"360810291004";35;7;31;2;37;112
"4782";"360810293001";8;3;47;55;26;139
"4783";"360810294001";10;3;21;27;14;75
"4784";"360810294002";12;10;40;17;29;108
"4785";"360810294003";17;2;76;35;21;151
"4786";"360810294004";6;0;10;18;3;37
"4787";"360810294005";23;3;16;24;39;105
"4788";"360810294006";10;1;27;16;10;64
"4789";"360810295001";19;13;14;7;3;56
"4790";"360810295002";30;8;102;55;38;233
"4791";"360810297001";6;3;52;37;24;122
"4792";"360810297002";23;18;147;39;29;256
"4793";"360810299001";0;0;6;9;5;20
"4794";"360810306001";15;9;38;28;24;114
"4795";"360810306002";11;7;36;36;13;103
"4796";"360810306003";62;17;42;61;30;212
"4797";"360810306004";7;6;45;18;12;88
"4798";"360810309021";12;2;24;3;6;47
"4799";"360810309022";46;0;65;5;50;166
"4800";"360810309023";37;1;44;8;20;110
"4801";"360810309024";16;5;24;4;12;61
"4802";"360810309025";76;5;41;4;18;144
"4803";"360810309031";25;12;69;31;65;202
"4804";"360810309032";18;12;61;6;37;134
"4805";"360810309033";34;9;54;14;56;167
"4806";"360810309041";35;12;60;21;38;166
"4807";"360810309042";27;5;37;13;38;120
"4808";"360810317001";13;3;72;12;33;133
"4809";"360810317002";9;3;17;5;36;70
"4810";"360810317003";14;1;44;4;11;74
"4811";"360810317004";13;0;50;10;46;119
"4812";"360810320001";19;9;21;52;42;143
"4813";"360810320002";5;5;32;28;7;77
"4814";"360810320003";34;7;23;22;20;106
"4815";"360810320004";16;3;11;13;18;61
"4816";"360810327001";44;8;81;12;61;206
"4817";"360810327002";61;65;55;1;26;208
"4818";"360810328001";26;5;26;37;16;110
"4819";"360810328002";13;2;25;32;15;87
"4820";"360810329001";17;3;44;12;26;102
"4821";"360810329002";17;6;53;24;18;118
"4822";"360810329003";36;9;76;14;59;194
"4823";"360810330001";33;13;33;31;49;159
"4824";"360810330002";3;1;16;14;3;37
"4825";"360810330003";19;2;10;22;24;77
"4826";"360810330004";15;3;12;6;11;47
"4827";"360810330005";12;1;22;19;11;65
"4828";"360810331001";1;2;10;1;1;15
"4829";"360810334011";7;4;47;9;31;98
"4830";"360810334012";12;7;39;27;23;108
"4831";"360810334021";22;1;3;0;0;26
"4832";"360810334022";3;2;0;0;0;5
"4833";"360810334023";5;17;0;3;0;25
"4834";"360810334024";8;5;6;0;1;20
"4835";"360810334025";6;8;3;1;3;21
"4836";"360810334026";29;5;36;26;15;111
"4837";"360810337001";27;8;48;4;41;128
"4838";"360810337002";34;47;179;7;61;328
"4839";"360810339001";43;7;15;4;42;111
"4840";"360810339002";17;3;1;0;3;24
"4841";"360810339003";26;19;32;0;15;92
"4842";"360810347001";47;6;61;14;63;191
"4843";"360810347002";35;6;103;8;42;194
"4844";"360810351001";29;8;17;2;16;72
"4845";"360810351002";144;14;25;5;12;200
"4846";"360810351003";22;37;48;4;28;139
"4847";"360810352001";33;15;12;36;21;117
"4848";"360810352002";11;7;15;28;19;80
"4849";"360810353001";20;13;16;7;28;84
"4850";"360810353002";42;49;27;8;46;172
"4851";"360810357001";90;11;144;14;25;284
"4852";"360810357002";20;17;47;18;32;134
"4853";"360810357003";17;17;76;4;12;126
"4854";"360810358001";16;3;13;11;21;64
"4855";"360810358002";19;10;15;28;22;94
"4856";"360810358003";12;5;10;31;22;80
"4857";"360810358004";2;1;1;12;7;23
"4858";"360810361001";66;19;48;2;33;168
"4859";"360810361002";62;15;41;4;21;143
"4860";"360810363001";27;4;31;12;32;106
"4861";"360810363002";17;12;53;7;12;101
"4862";"360810365001";49;7;65;10;33;164
"4863";"360810365002";41;14;86;3;29;173
"4864";"360810366001";31;8;52;22;32;145
"4865";"360810366002";19;69;42;12;41;183
"4866";"360810367001";8;2;20;17;20;67
"4867";"360810367002";47;19;55;24;39;184
"4868";"360810368001";7;1;13;22;17;60
"4869";"360810368002";18;9;33;26;10;96
"4870";"360810371001";14;4;88;12;33;151
"4871";"360810373001";20;13;52;22;33;140
"4872";"360810373002";245;156;164;40;25;630
"4873";"360810375001";46;17;88;12;64;227
"4874";"360810375002";69;19;62;2;71;223
"4875";"360810376001";16;1;20;4;29;70
"4876";"360810376002";30;2;11;10;21;74
"4877";"360810376003";12;0;4;8;16;40
"4878";"360810376004";20;7;19;16;21;83
"4879";"360810376005";23;37;15;23;18;116
"4880";"360810377001";36;16;64;4;37;157
"4881";"360810377002";32;1;34;4;23;94
"4882";"360810379001";63;43;117;6;61;290
"4883";"360810379002";42;13;50;3;70;178
"4884";"360810379003";61;8;49;12;49;179
"4885";"360810381001";46;2;43;5;26;122
"4886";"360810381002";101;10;97;4;43;255
"4887";"360810381003";67;12;83;11;46;219
"4888";"360810383011";0;2;48;108;4;162
"4889";"360810383020";0;1;0;2;0;3
"4890";"360810383021";13;23;44;28;22;130
"4891";"360810384001";27;4;27;16;20;94
"4892";"360810384002";25;6;21;19;27;98
"4893";"360810394001";41;19;25;22;31;138
"4894";"360810394002";15;1;15;16;11;58
"4895";"360810394003";16;3;16;12;17;64
"4896";"360810398001";15;5;12;14;20;66
"4897";"360810398002";2;1;8;9;6;26
"4898";"360810399001";46;3;46;7;28;130
"4899";"360810399002";5;10;35;8;23;81
"4900";"360810399003";20;2;31;4;35;92
"4901";"360810400001";6;5;13;14;17;55
"4902";"360810400002";21;4;10;9;7;51
"4903";"360810401001";64;7;86;7;62;226
"4904";"360810401002";34;20;69;12;119;254
"4905";"360810401003";24;5;45;3;39;116
"4906";"360810402001";7;3;16;18;7;51
"4907";"360810402002";16;3;8;35;14;76
"4908";"360810403001";101;14;127;9;65;316
"4909";"360810403002";29;12;31;6;88;166
"4910";"360810403003";21;2;72;9;50;154
"4911";"360810404001";17;1;14;20;10;62
"4912";"360810404002";30;10;17;19;14;90
"4913";"360810404003";21;3;7;10;10;51
"4914";"360810404004";24;4;27;25;17;97
"4915";"360810405001";21;10;13;2;49;95
"4916";"360810405002";20;49;19;10;82;180
"4917";"360810407001";16;7;46;9;30;108
"4918";"360810407002";47;10;33;2;55;147
"4919";"360810407003";12;2;15;3;37;69
"4920";"360810407004";40;5;44;1;35;125
"4921";"360810407005";11;3;5;1;32;52
"4922";"360810409001";31;2;29;1;42;105
"4923";"360810409002";38;13;12;1;42;106
"4924";"360810409003";14;10;29;17;23;93
"4925";"360810409004";27;12;22;0;62;123
"4926";"360810411001";33;13;32;6;66;150
"4927";"360810411002";47;11;54;8;34;154
"4928";"360810413001";43;6;74;10;101;234
"4929";"360810413002";33;8;56;13;62;172
"4930";"360810414001";62;4;29;55;52;202
"4931";"360810414002";133;11;8;3;7;162
"4932";"360810414003";35;5;24;32;22;118
"4933";"360810415001";86;12;68;30;81;277
"4934";"360810415002";24;11;63;27;48;173
"4935";"360810424001";16;9;28;33;14;100
"4936";"360810424002";11;1;5;27;9;53
"4937";"360810424003";6;2;6;5;4;23
"4938";"360810426001";6;3;4;4;10;27
"4939";"360810427001";93;3;87;14;60;257
"4940";"360810427002";56;9;116;10;54;245
"4941";"360810432001";15;8;22;25;10;80
"4942";"360810434001";13;12;48;29;25;127
"4943";"360810437011";17;6;105;20;68;216
"4944";"360810437012";14;2;26;11;21;74
"4945";"360810437021";91;12;16;9;11;139
"4946";"360810437022";72;5;118;3;33;231
"4947";"360810437023";36;5;136;3;55;235
"4948";"360810439001";52;8;104;8;54;226
"4949";"360810439002";95;17;101;4;97;314
"4950";"360810440001";31;3;41;45;38;158
"4951";"360810440002";19;3;43;51;16;132
"4952";"360810440003";47;5;37;24;40;153
"4953";"360810443011";35;6;72;17;75;205
"4954";"360810443012";89;13;69;3;41;215
"4955";"360810443021";11;2;79;13;56;161
"4956";"360810443022";20;3;50;5;64;142
"4957";"360810443023";61;23;109;8;29;230
"4958";"360810444001";21;11;49;2;23;106
"4959";"360810444002";15;42;75;13;32;177
"4960";"360810444003";17;18;46;47;64;192
"4961";"360810446011";20;15;6;2;41;84
"4962";"360810446012";36;108;5;6;88;243
"4963";"360810446021";60;21;47;3;59;190
"4964";"360810446022";64;22;5;0;44;135
"4965";"360810448001";20;2;56;5;29;112
"4966";"360810448002";7;1;23;5;23;59
"4967";"360810450001";13;1;55;11;10;90
"4968";"360810450002";1;6;8;2;27;44
"4969";"360810452001";15;6;12;2;17;52
"4970";"360810454001";15;7;59;9;37;127
"4971";"360810454002";40;3;83;2;38;166
"4972";"360810455001";16;1;3;0;10;30
"4973";"360810455002";24;6;2;0;0;32
"4974";"360810455003";23;8;2;1;3;37
"4975";"360810455004";24;0;0;0;3;27
"4976";"360810455005";8;0;1;0;3;12
"4977";"360810455006";0;0;2;2;0;4
"4978";"360810456001";13;2;26;5;23;69
"4979";"360810457001";37;5;139;5;12;198
"4980";"360810457002";19;8;53;0;22;102
"4981";"360810458001";98;8;76;12;45;239
"4982";"360810459001";28;0;69;4;52;153
"4983";"360810459002";21;1;42;10;14;88
"4984";"360810460001";81;6;34;1;40;162
"4985";"360810460002";72;8;13;1;82;176
"4986";"360810460003";71;3;7;2;9;92
"4987";"360810461001";40;24;43;2;62;171
"4988";"360810462001";36;37;29;3;25;130
"4989";"360810462002";112;53;47;7;52;271
"4990";"360810462003";102;10;86;2;52;252
"4991";"360810463001";110;11;50;1;43;215
"4992";"360810463002";30;14;69;13;42;168
"4993";"360810464001";8;1;25;5;5;44
"4994";"360810465001";23;29;28;5;30;115
"4995";"360810465002";26;1;28;1;48;104
"4996";"360810466001";57;9;43;1;5;115
"4997";"360810466002";18;24;28;1;8;79
"4998";"360810467001";23;0;17;2;11;53
"4999";"360810467002";143;13;77;1;17;251
"5000";"360810467003";41;37;42;2;22;144
"5001";"360810467004";33;7;12;1;26;79
"5002";"360810468001";44;25;55;5;40;169
"5003";"360810468002";47;8;89;11;46;201
"5004";"360810469001";67;13;37;5;37;159
"5005";"360810469002";45;0;15;0;4;64
"5006";"360810469003";9;1;27;1;17;55
"5007";"360810469004";29;3;5;0;4;41
"5008";"360810469005";60;2;8;0;9;79
"5009";"360810470001";44;4;53;5;42;148
"5010";"360810470002";50;75;74;8;81;288
"5011";"360810471001";94;20;26;0;57;197
"5012";"360810471002";26;5;39;2;24;96
"5013";"360810472001";45;1;36;3;8;93
"5014";"360810472002";39;3;26;23;25;116
"5015";"360810472003";22;0;13;1;3;39
"5016";"360810473001";19;0;75;1;13;108
"5017";"360810473002";33;6;25;4;22;90
"5018";"360810473003";0;0;6;0;8;14
"5019";"360810475001";14;2;56;2;18;92
"5020";"360810475002";28;1;126;4;52;211
"5021";"360810476001";4;1;9;22;18;54
"5022";"360810476002";11;2;12;9;12;46
"5023";"360810478001";15;2;23;9;5;54
"5024";"360810478002";40;5;35;50;22;152
"5025";"360810478003";82;11;58;13;30;194
"5026";"360810479001";60;11;77;16;35;199
"5027";"360810479002";3;5;17;28;24;77
"5028";"360810479003";8;12;27;5;20;72
"5029";"360810480001";97;23;57;22;38;237
"5030";"360810480002";45;10;46;11;40;152
"5031";"360810481001";10;3;56;2;20;91
"5032";"360810481002";56;2;29;0;8;95
"5033";"360810481003";43;2;33;0;15;93
"5034";"360810481004";6;1;0;1;11;19
"5035";"360810482001";32;9;39;24;59;163
"5036";"360810483001";26;3;77;2;32;140
"5037";"360810483002";30;46;76;59;23;234
"5038";"360810484001";33;1;51;14;61;160
"5039";"360810484002";25;8;36;25;28;122
"5040";"360810484003";13;2;34;10;23;82
"5041";"360810484004";12;1;33;31;22;99
"5042";"360810485001";1;2;19;2;15;39
"5043";"360810485002";8;3;21;1;23;56
"5044";"360810485003";22;6;61;9;27;125
"5045";"360810489001";4;11;103;48;40;206
"5046";"360810489002";4;0;25;8;9;46
"5047";"360810492001";101;11;23;21;18;174
"5048";"360810492002";5;0;22;4;40;71
"5049";"360810492003";18;5;26;20;6;75
"5050";"360810493011";4;1;63;38;18;124
"5051";"360810493012";7;4;58;32;19;120
"5052";"360810493021";12;68;59;24;37;200
"5053";"360810493022";2;3;68;22;33;128
"5054";"360810495001";8;2;84;33;17;144
"5055";"360810496001";27;5;18;10;18;78
"5056";"360810496002";25;7;26;5;28;91
"5057";"360810496003";17;7;28;13;35;100
"5058";"360810497001";34;6;35;20;51;146
"5059";"360810497002";12;7;61;24;28;132
"5060";"360810499001";17;2;34;43;33;129
"5061";"360810499002";21;5;57;43;36;162
"5062";"360810499003";26;3;64;22;45;160
"5063";"360810500001";14;10;37;50;23;134
"5064";"360810500002";137;3;60;16;33;249
"5065";"360810502011";23;7;27;51;16;124
"5066";"360810502021";24;1;14;39;21;99
"5067";"360810504001";28;2;10;16;14;70
"5068";"360810504002";28;7;14;9;4;62
"5069";"360810505001";22;0;96;25;22;165
"5070";"360810506001";8;0;24;21;11;64
"5071";"360810506002";4;2;13;32;8;59
"5072";"360810507001";11;3;115;54;28;211
"5073";"360810507002";7;0;37;15;33;92
"5074";"360810508001";14;14;13;19;20;80
"5075";"360810508002";6;15;17;14;18;70
"5076";"360810510001";31;5;12;36;10;94
"5077";"360810510002";8;0;31;14;17;70
"5078";"360810511001";1;5;51;16;26;99
"5079";"360810511002";4;19;29;18;20;90
"5080";"360810512001";24;19;9;14;26;92
"5081";"360810512002";9;6;10;20;35;80
"5082";"360810512003";13;0;15;9;22;59
"5083";"360810513001";23;2;131;27;38;221
"5084";"360810513002";11;1;75;19;6;112
"5085";"360810515001";4;18;48;13;27;110
"5086";"360810515002";18;3;40;7;10;78
"5087";"360810515003";4;7;76;28;23;138
"5088";"360810516001";5;3;6;6;12;32
"5089";"360810516002";10;2;15;23;18;68
"5090";"360810517001";3;5;25;27;28;88
"5091";"360810517002";18;4;83;28;20;153
"5092";"360810518001";7;5;10;12;22;56
"5093";"360810518002";12;3;21;10;24;70
"5094";"360810520001";7;6;28;28;33;102
"5095";"360810521001";96;8;60;4;9;177
"5096";"360810521002";15;5;75;35;26;156
"5097";"360810522001";49;12;28;18;18;125
"5098";"360810524001";7;0;13;20;12;52
"5099";"360810524002";10;0;14;15;11;50
"5100";"360810525001";12;8;92;20;28;160
"5101";"360810525002";8;32;79;44;16;179
"5102";"360810526001";18;14;14;11;62;119
"5103";"360810526002";17;24;17;13;15;86
"5104";"360810528001";32;28;32;18;34;144
"5105";"360810530001";8;2;12;20;12;54
"5106";"360810530002";49;11;22;13;43;138
"5107";"360810531001";14;7;126;87;54;288
"5108";"360810531002";10;2;30;11;14;67
"5109";"360810531003";9;4;49;26;46;134
"5110";"360810532001";9;6;17;16;17;65
"5111";"360810532002";13;1;18;8;32;72
"5112";"360810534011";9;3;9;26;18;65
"5113";"360810534012";20;4;20;9;14;67
"5114";"360810535001";8;8;94;39;55;204
"5115";"360810536011";7;4;5;16;6;38
"5116";"360810536012";10;3;9;17;13;52
"5117";"360810538001";12;0;9;11;3;35
"5118";"360810538002";7;0;13;10;16;46
"5119";"360810539001";27;9;47;17;51;151
"5120";"360810539002";15;11;38;18;21;103
"5121";"360810539003";25;8;63;18;17;131
"5122";"360810540001";60;12;23;24;32;151
"5123";"360810540002";11;5;24;38;15;93
"5124";"360810540003";17;3;21;18;10;69
"5125";"360810542001";12;1;14;20;36;83
"5126";"360810542002";11;2;27;10;78;128
"5127";"360810542003";18;6;30;11;47;112
"5128";"360810542004";23;2;21;18;46;110
"5129";"360810545001";41;18;29;0;13;101
"5130";"360810545002";12;13;44;2;6;77
"5131";"360810545003";37;10;36;0;15;98
"5132";"360810547001";25;65;40;0;17;147
"5133";"360810547002";38;53;39;1;11;142
"5134";"360810547003";35;7;11;8;13;74
"5135";"360810548001";38;5;21;11;72;147
"5136";"360810548002";48;5;13;10;15;91
"5137";"360810549001";24;22;31;4;17;98
"5138";"360810549002";33;14;27;0;14;88
"5139";"360810549003";175;19;17;0;15;226
"5140";"360810549004";44;15;3;4;9;75
"5141";"360810551001";4;10;15;2;14;45
"5142";"360810551002";29;18;6;1;17;71
"5143";"360810551003";32;38;11;2;20;103
"5144";"360810551004";24;2;4;0;10;40
"5145";"360810552001";14;4;17;14;14;63
"5146";"360810552002";37;12;41;6;26;122
"5147";"360810553001";25;24;42;3;21;115
"5148";"360810553002";17;8;20;8;8;61
"5149";"360810554001";19;2;22;9;12;64
"5150";"360810554002";13;2;19;16;18;68
"5151";"360810555001";102;5;21;5;29;162
"5152";"360810555002";26;38;62;8;37;171
"5153";"360810556001";33;7;17;13;44;114
"5154";"360810556002";11;4;4;3;25;47
"5155";"360810557001";19;14;63;4;18;118
"5156";"360810557002";16;21;87;8;31;163
"5157";"360810557003";18;12;6;2;5;43
"5158";"360810558001";13;1;5;0;10;29
"5159";"360810558002";46;3;8;14;35;106
"5160";"360810559001";38;16;47;7;40;148
"5161";"360810560001";5;3;29;4;22;63
"5162";"360810560002";13;0;3;1;12;29
"5163";"360810561001";1;15;11;10;7;44
"5164";"360810562001";14;1;15;16;28;74
"5165";"360810564001";40;10;17;11;11;89
"5166";"360810565001";36;12;97;92;25;262
"5167";"360810566001";140;5;5;9;10;169
"5168";"360810566002";12;5;10;10;14;51
"5169";"360810567001";2;2;93;35;15;147
"5170";"360810567002";27;8;132;40;30;237
"5171";"360810567003";47;16;222;28;23;336
"5172";"360810567004";15;10;36;4;25;90
"5173";"360810568001";35;9;29;10;32;115
"5174";"360810568002";5;3;12;33;27;80
"5175";"360810568003";10;9;23;8;25;75
"5176";"360810568004";8;5;22;21;28;84
"5177";"360810577001";35;1;10;1;15;62
"5178";"360810577002";8;7;38;13;18;84
"5179";"360810577003";8;9;43;0;13;73
"5180";"360810579001";35;7;16;2;2;62
"5181";"360810579002";21;2;59;2;11;95
"5182";"360810580001";14;0;6;6;9;35
"5183";"360810580002";5;2;6;17;6;36
"5184";"360810580003";12;1;20;18;17;68
"5185";"360810580004";6;3;4;13;4;30
"5186";"360810581001";32;2;39;4;20;97
"5187";"360810581002";24;9;54;0;36;123
"5188";"360810582001";14;8;14;19;34;89
"5189";"360810582002";46;14;27;35;42;164
"5190";"360810582003";5;2;20;16;13;56
"5191";"360810583001";15;3;46;3;8;75
"5192";"360810583002";13;4;19;2;17;55
"5193";"360810583003";6;2;8;0;3;19
"5194";"360810585001";12;7;18;1;11;49
"5195";"360810585002";14;3;105;3;6;131
"5196";"360810585003";23;6;33;4;36;102
"5197";"360810587001";17;4;106;7;12;146
"5198";"360810587002";40;10;38;0;8;96
"5199";"360810587003";24;14;23;6;13;80
"5200";"360810589001";22;11;80;3;14;130
"5201";"360810589002";30;19;21;1;12;83
"5202";"360810589003";9;28;21;1;10;69
"5203";"360810590001";19;3;36;8;21;87
"5204";"360810591001";23;2;45;2;10;82
"5205";"360810591002";16;6;73;11;10;116
"5206";"360810591003";30;6;66;2;15;119
"5207";"360810591004";34;3;52;1;10;100
"5208";"360810592001";13;1;5;31;9;59
"5209";"360810593001";100;4;55;10;28;197
"5210";"360810593002";54;13;119;9;17;212
"5211";"360810594001";3;0;8;8;7;26
"5212";"360810594002";4;1;1;14;8;28
"5213";"360810595001";10;6;35;17;19;87
"5214";"360810595002";24;6;54;1;17;102
"5215";"360810595003";10;0;32;6;10;58
"5216";"360810595004";44;19;72;8;30;173
"5217";"360810596001";8;4;7;15;15;49
"5218";"360810596002";12;1;4;11;5;33
"5219";"360810598001";8;1;4;7;11;31
"5220";"360810598002";4;2;16;14;7;43
"5221";"360810599001";12;2;25;20;9;68
"5222";"360810599002";6;2;54;15;19;96
"5223";"360810600001";9;3;15;15;9;51
"5224";"360810601001";29;10;58;26;23;146
"5225";"360810601002";15;5;43;22;10;95
"5226";"360810603001";8;11;105;31;41;196
"5227";"360810606001";32;8;21;3;10;74
"5228";"360810606002";5;1;4;16;7;33
"5229";"360810607011";0;1;63;10;12;86
"5230";"360810608001";36;145;23;11;28;243
"5231";"360810610001";11;5;13;22;19;70
"5232";"360810612001";7;2;6;7;5;27
"5233";"360810612002";8;0;23;3;15;49
"5234";"360810613011";86;23;44;10;29;192
"5235";"360810613012";35;11;65;12;32;155
"5236";"360810613013";11;20;29;2;17;79
"5237";"360810613014";26;8;17;1;14;66
"5238";"360810613021";0;0;5;1;1;7
"5239";"360810614001";11;3;5;16;9;44
"5240";"360810616011";7;3;4;8;5;27
"5241";"360810616012";3;0;0;13;5;21
"5242";"360810616013";29;1;5;6;7;48
"5243";"360810616021";6;3;5;19;9;42
"5244";"360810616022";2;2;4;21;19;48
"5245";"360810618001";6;0;3;11;0;20
"5246";"360810618002";12;12;19;16;13;72
"5247";"360810619001";17;13;113;21;37;201
"5248";"360810619002";20;18;52;5;33;128
"5249";"360810620001";13;4;10;40;15;82
"5250";"360810621001";15;33;31;13;47;139
"5251";"360810621002";5;2;23;12;18;60
"5252";"360810621003";3;4;58;12;11;88
"5253";"360810622001";6;2;7;19;10;44
"5254";"360810622002";8;2;13;18;9;50
"5255";"360810623001";2;0;48;21;7;78
"5256";"360810623002";22;4;96;12;16;150
"5257";"360810624001";0;0;2;2;0;4
"5258";"360810625001";16;1;67;2;13;99
"5259";"360810625002";18;7;67;10;22;124
"5260";"360810626001";3;3;10;24;15;55
"5261";"360810626002";14;8;14;28;18;82
"5262";"360810626003";5;3;4;19;13;44
"5263";"360810627001";18;13;87;5;29;152
"5264";"360810627002";4;4;51;0;17;76
"5265";"360810629001";13;21;86;18;12;150
"5266";"360810629002";32;7;20;7;14;80
"5267";"360810629003";8;9;39;4;5;65
"5268";"360810630001";6;3;9;12;20;50
"5269";"360810630002";4;1;22;12;11;50
"5270";"360810632001";5;3;4;5;3;20
"5271";"360810632002";10;5;37;24;23;99
"5272";"360810633011";7;7;72;25;17;128
"5273";"360810633021";5;2;13;5;15;40
"5274";"360810633022";3;4;41;17;16;81
"5275";"360810635001";2;0;24;9;13;48
"5276";"360810635002";3;0;62;19;12;96
"5277";"360810637001";10;3;21;22;18;74
"5278";"360810637002";5;1;38;19;30;93
"5279";"360810637003";23;2;18;21;18;82
"5280";"360810638001";20;14;23;18;24;99
"5281";"360810638002";6;1;9;5;21;42
"5282";"360810638003";4;1;8;32;3;48
"5283";"360810638004";6;1;11;18;8;44
"5284";"360810638005";11;1;7;11;21;51
"5285";"360810639001";23;18;60;25;7;133
"5286";"360810639002";7;11;100;39;21;178
"5287";"360810641011";20;4;28;11;23;86
"5288";"360810641021";16;20;45;28;15;124
"5289";"360810645001";8;8;26;5;3;50
"5290";"360810645002";6;2;77;16;24;125
"5291";"360810646001";15;1;9;25;26;76
"5292";"360810646002";9;1;35;15;13;73
"5293";"360810650001";4;4;7;21;16;52
"5294";"360810650002";22;2;26;36;16;102
"5295";"360810654001";18;30;18;24;26;116
"5296";"360810654002";11;2;11;20;17;61
"5297";"360810654003";8;3;17;7;14;49
"5298";"360810655011";3;4;12;3;6;28
"5299";"360810656001";58;7;18;25;44;152
"5300";"360810656002";18;2;6;16;9;51
"5301";"360810656003";43;6;36;38;41;164
"5302";"360810657021";15;7;77;34;20;153
"5303";"360810657031";7;3;46;9;20;85
"5304";"360810657032";2;5;39;10;12;68
"5305";"360810657033";2;1;31;7;16;57
"5306";"360810659001";5;1;25;18;7;56
"5307";"360810659002";5;2;51;21;8;87
"5308";"360810660001";23;12;26;21;11;93
"5309";"360810660002";12;2;17;35;29;95
"5310";"360810661001";4;2;29;11;11;57
"5311";"360810663001";0;1;39;7;20;67
"5312";"360810663002";4;1;44;21;32;102
"5313";"360810663003";1;6;14;17;22;60
"5314";"360810664001";0;2;2;1;1;6
"5315";"360810664002";13;3;13;23;12;64
"5316";"360810664003";11;1;17;22;11;62
"5317";"360810664004";20;1;8;11;4;44
"5318";"360810664005";21;2;22;23;18;86
"5319";"360810664006";25;2;28;13;21;89
"5320";"360810664007";27;4;44;29;10;114
"5321";"360810664008";16;4;40;23;30;113
"5322";"360810665011";3;1;49;40;9;102
"5323";"360810665012";2;5;19;9;7;42
"5324";"360810665013";7;0;24;10;12;53
"5325";"360810665014";4;2;16;13;6;41
"5326";"360810667011";40;7;40;37;23;147
"5327";"360810667012";2;3;55;22;14;96
"5328";"360810669001";5;1;20;28;12;66
"5329";"360810669002";8;1;38;31;18;96
"5330";"360810671001";4;1;18;27;18;68
"5331";"360810671002";1;2;25;17;18;63
"5332";"360810677001";4;0;19;7;17;47
"5333";"360810677002";2;2;31;15;10;60
"5334";"360810679001";1;2;14;11;7;35
"5335";"360810679002";61;8;19;5;16;109
"5336";"360810679003";20;6;57;19;23;125
"5337";"360810680001";9;1;12;29;20;71
"5338";"360810680002";43;5;23;45;25;141
"5339";"360810680003";14;14;24;40;33;125
"5340";"360810680004";11;3;14;14;21;63
"5341";"360810682001";10;5;14;15;17;61
"5342";"360810682002";3;1;8;16;5;33
"5343";"360810683001";25;12;34;6;9;86
"5344";"360810683002";32;4;54;5;4;99
"5345";"360810683003";14;0;25;10;5;54
"5346";"360810687001";38;1;7;0;0;46
"5347";"360810687002";47;6;78;2;17;150
"5348";"360810687003";6;2;131;6;20;165
"5349";"360810690001";42;6;20;34;12;114
"5350";"360810690002";35;1;20;30;26;112
"5351";"360810693001";62;9;44;1;20;136
"5352";"360810693002";9;25;73;1;26;134
"5353";"360810694001";55;3;23;26;32;139
"5354";"360810694002";17;2;43;33;34;129
"5355";"360810695001";72;5;52;4;15;148
"5356";"360810695002";7;6;28;7;38;86
"5357";"360810697011";23;3;28;0;9;63
"5358";"360810697012";13;4;83;6;7;113
"5359";"360810697013";61;3;22;0;7;93
"5360";"360810697021";1;2;14;5;10;32
"5361";"360810697022";1;7;7;7;11;33
"5362";"360810697023";2;0;23;21;14;60
"5363";"360810697024";30;9;18;16;12;85
"5364";"360810703001";3;4;28;17;15;67
"5365";"360810703002";20;4;46;12;16;98
"5366";"360810707001";6;0;8;1;6;21
"5367";"360810707002";3;1;12;3;17;36
"5368";"360810707003";4;1;27;1;9;42
"5369";"360810709001";159;3;39;7;13;221
"5370";"360810709002";10;5;13;8;8;44
"5371";"360810711001";18;5;10;2;4;39
"5372";"360810711002";58;5;49;2;14;128
"5373";"360810711003";27;0;10;0;3;40
"5374";"360810711004";4;21;36;1;16;78
"5375";"360810713031";50;9;46;0;15;120
"5376";"360810713032";53;33;19;0;11;116
"5377";"360810713033";96;3;18;5;9;131
"5378";"360810713041";51;4;23;0;5;83
"5379";"360810713042";3;3;12;1;0;19
"5380";"360810713043";6;3;1;0;0;10
"5381";"360810713044";35;7;20;0;6;68
"5382";"360810713051";19;2;5;2;6;34
"5383";"360810713052";17;1;14;0;4;36
"5384";"360810713053";51;12;53;6;17;139
"5385";"360810713061";35;4;29;0;4;72
"5386";"360810713062";56;7;58;4;7;132
"5387";"360810713063";27;4;11;1;8;51
"5388";"360810713064";16;8;22;1;32;79
"5389";"360810716001";0;1;7;5;4;17
"5390";"360810717011";7;3;9;0;2;21
"5391";"360810717012";51;8;53;0;9;121
"5392";"360810717013";0;5;7;0;1;13
"5393";"360810717014";10;18;24;1;6;59
"5394";"360810717021";9;6;35;2;7;59
"5395";"360810717022";1;3;21;1;1;27
"5396";"360810719001";27;2;41;2;6;78
"5397";"360810719002";17;6;79;4;13;119
"5398";"360810721001";11;2;7;0;10;30
"5399";"360810721002";11;2;3;1;2;19
"5400";"360810721003";25;0;21;0;10;56
"5401";"360810721004";24;0;8;1;3;36
"5402";"360810721005";35;6;31;5;14;91
"5403";"360810723001";0;0;3;0;2;5
"5404";"360810723002";5;0;23;2;2;32
"5405";"360810723003";1;1;14;10;3;29
"5406";"360810729001";8;1;18;0;3;30
"5407";"360810729002";4;2;27;4;8;45
"5408";"360810731001";4;5;7;5;6;27
"5409";"360810731002";4;14;27;12;12;69
"5410";"360810737001";53;23;14;2;23;115
"5411";"360810737002";5;92;13;1;7;118
"5412";"360810739001";4;0;13;0;1;18
"5413";"360810739002";12;0;14;3;4;33
"5414";"360810739003";14;2;32;1;2;51
"5415";"360810739004";4;1;25;0;2;32
"5416";"360810739005";54;2;1;2;3;62
"5417";"360810741001";1;2;13;0;5;21
"5418";"360810741002";11;3;34;2;2;52
"5419";"360810741003";2;0;12;0;0;14
"5420";"360810741004";1;18;26;2;1;48
"5421";"360810743001";2;3;13;2;4;24
"5422";"360810743002";24;1;14;1;8;48
"5423";"360810743003";42;7;17;2;11;79
"5424";"360810743004";14;1;5;0;7;27
"5425";"360810745001";61;9;22;2;5;99
"5426";"360810745002";22;9;13;1;2;47
"5427";"360810747001";15;1;82;9;24;131
"5428";"360810747002";22;0;22;3;3;50
"5429";"360810749001";1;1;1;2;1;6
"5430";"360810749002";0;0;5;6;3;14
"5431";"360810757011";32;9;53;3;11;108
"5432";"360810757012";11;6;6;0;7;30
"5433";"360810757013";25;15;40;1;8;89
"5434";"360810757021";110;2;7;0;4;123
"5435";"360810757022";6;8;90;9;8;121
"5436";"360810757023";41;4;10;1;1;57
"5437";"360810769011";20;2;10;1;4;37
"5438";"360810769012";63;6;25;1;15;110
"5439";"360810769021";15;8;61;9;35;128
"5440";"360810773001";4;2;34;4;8;52
"5441";"360810773002";16;5;214;1;6;242
"5442";"360810775001";17;7;46;1;18;89
"5443";"360810775002";61;1;45;1;32;140
"5444";"360810775003";5;377;40;2;16;440
"5445";"360810779021";0;2;14;5;14;35
"5446";"360810779022";4;3;23;9;8;47
"5447";"360810779023";2;7;22;8;18;57
"5448";"360810779024";14;0;8;3;0;25
"5449";"360810779025";7;2;20;15;11;55
"5450";"360810779031";3;3;7;1;2;16
"5451";"360810779032";14;2;2;1;4;23
"5452";"360810779033";18;1;10;8;5;42
"5453";"360810779041";5;2;8;9;10;34
"5454";"360810779042";30;7;54;15;27;133
"5455";"360810779043";26;8;36;2;7;79
"5456";"360810779044";4;3;16;6;6;35
"5457";"360810779051";21;21;19;18;15;94
"5458";"360810779052";7;1;4;1;1;14
"5459";"360810779061";10;10;40;3;8;71
"5460";"360810779062";33;7;38;13;11;102
"5461";"360810779071";27;7;22;9;11;76
"5462";"360810779072";32;1;15;3;11;62
"5463";"360810779081";19;5;20;1;12;57
"5464";"360810779082";82;5;2;2;7;98
"5465";"360810788001";47;4;18;33;21;123
"5466";"360810788002";8;4;8;25;7;52
"5467";"360810790001";33;3;18;30;32;116
"5468";"360810790002";18;7;24;34;29;112
"5469";"360810792001";37;4;19;21;19;100
"5470";"360810792002";28;3;111;30;23;195
"5471";"360810793001";0;0;0;2;7;9
"5472";"360810797011";13;1;2;1;2;19
"5473";"360810797012";9;2;1;1;0;13
"5474";"360810797013";1;0;0;1;0;2
"5475";"360810797014";1;2;5;0;5;13
"5476";"360810797021";12;1;93;2;39;147
"5477";"360810797022";40;3;71;1;28;143
"5478";"360810797023";3;4;5;0;6;18
"5479";"360810799001";9;1;50;8;22;90
"5480";"360810799002";4;3;74;0;35;116
"5481";"360810803011";18;4;46;11;24;103
"5482";"360810803012";10;2;88;5;30;135
"5483";"360810803013";4;3;71;8;18;104
"5484";"360810803021";6;1;14;28;43;92
"5485";"360810803022";2;3;28;18;24;75
"5486";"360810803023";8;1;52;39;20;120
"5487";"360810809001";1;1;4;1;0;7
"5488";"360810809002";10;2;3;1;4;20
"5489";"360810809003";3;1;22;3;8;37
"5490";"360810809004";5;11;41;5;15;77
"5491";"360810809005";3;1;25;0;0;29
"5492";"360810809006";15;1;8;3;0;27
"5493";"360810809007";9;2;26;3;2;42
"5494";"360810814001";51;6;36;22;33;148
"5495";"360810814002";27;11;22;19;37;116
"5496";"360810814003";25;6;18;43;27;119
"5497";"360810818001";13;1;30;17;42;103
"5498";"360810818002";25;2;28;11;38;104
"5499";"360810818003";27;2;32;26;69;156
"5500";"360810837001";26;14;38;14;41;133
"5501";"360810837002";15;1;44;40;25;125
"5502";"360810837003";2;0;47;7;20;76
"5503";"360810837004";36;12;28;4;47;127
"5504";"360810838001";23;8;31;28;70;160
"5505";"360810838002";26;3;27;9;31;96
"5506";"360810838003";39;15;22;9;70;155
"5507";"360810838004";24;5;34;12;26;101
"5508";"360810840001";122;30;80;43;87;362
"5509";"360810840002";55;51;57;21;39;223
"5510";"360810840003";38;7;63;11;48;167
"5511";"360810840004";18;2;31;7;12;70
"5512";"360810840005";33;5;51;16;48;153
"5513";"360810845001";8;0;13;0;7;28
"5514";"360810845002";47;5;5;1;9;67
"5515";"360810845003";1;12;53;3;36;105
"5516";"360810846011";19;2;42;37;69;169
"5517";"360810846012";20;6;66;50;52;194
"5518";"360810846021";11;2;33;40;21;107
"5519";"360810849001";86;7;38;2;49;182
"5520";"360810849002";53;3;25;6;36;123
"5521";"360810849003";24;8;34;9;43;118
"5522";"360810849004";1;3;68;7;43;122
"5523";"360810853001";7;9;24;0;70;110
"5524";"360810853002";12;6;15;3;19;55
"5525";"360810853003";12;1;87;1;15;116
"5526";"360810853004";25;0;11;1;10;47
"5527";"360810855001";5;1;1;0;10;17
"5528";"360810855002";47;16;16;1;8;88
"5529";"360810855003";36;7;8;3;11;65
"5530";"360810855004";31;7;4;1;7;50
"5531";"360810857001";9;7;14;0;13;43
"5532";"360810857002";20;3;73;2;29;127
"5533";"360810857003";26;8;39;1;27;101
"5534";"360810859001";62;9;35;1;35;142
"5535";"360810859002";32;6;67;0;39;144
"5536";"360810859003";27;9;20;1;13;70
"5537";"360810861001";19;1;17;0;25;62
"5538";"360810861002";11;5;32;5;38;91
"5539";"360810863001";29;4;8;0;10;51
"5540";"360810863002";18;2;23;0;5;48
"5541";"360810863003";34;1;0;0;5;40
"5542";"360810863004";175;3;88;0;15;281
"5543";"360810864001";29;22;54;20;34;159
"5544";"360810864002";28;1;31;29;35;124
"5545";"360810865001";14;3;23;3;24;67
"5546";"360810865002";4;8;37;3;26;78
"5547";"360810869001";3;22;55;14;77;171
"5548";"360810869002";3;11;82;11;58;165
"5549";"360810871001";75;4;19;0;37;135
"5550";"360810871002";4;29;48;3;97;181
"5551";"360810884001";13;1;21;34;28;97
"5552";"360810884002";0;6;19;7;12;44
"5553";"360810884003";4;3;11;12;22;52
"5554";"360810884004";4;2;10;18;27;61
"5555";"360810884005";3;4;38;4;12;61
"5556";"360810884006";11;13;34;25;40;123
"5557";"360810884007";0;1;6;7;5;19
"5558";"360810884008";0;1;24;11;14;50
"5559";"360810889011";3;3;40;21;37;104
"5560";"360810889012";13;3;4;3;0;23
"5561";"360810889013";21;3;18;5;11;58
"5562";"360810889014";67;1;11;0;21;100
"5563";"360810889015";6;3;6;0;3;18
"5564";"360810889016";203;7;40;0;15;265
"5565";"360810889017";29;2;21;0;9;61
"5566";"360810892001";2;4;3;8;9;26
"5567";"360810892002";0;2;12;13;14;41
"5568";"360810892003";7;10;28;26;18;89
"5569";"360810892004";8;2;8;10;18;46
"5570";"360810892005";10;4;21;17;29;81
"5571";"360810892006";0;0;2;4;8;14
"5572";"360810892007";0;2;7;11;7;27
"5573";"360810892008";2;10;6;0;9;27
"5574";"360810907001";10;14;70;33;75;202
"5575";"360810916011";3;0;0;0;19;22
"5576";"360810916013";1;0;1;0;4;6
"5577";"360810916014";0;0;3;0;5;8
"5578";"360810916021";0;0;4;0;1;5
"5579";"360810918001";0;0;0;0;1;1
"5580";"360810919001";11;0;48;21;27;107
"5581";"360810919002";24;25;102;56;56;263
"5582";"360810919003";24;41;62;18;36;181
"5583";"360810922001";3;0;2;4;7;16
"5584";"360810922002";3;0;2;3;10;18
"5585";"360810922003";2;0;7;1;13;23
"5586";"360810925001";29;12;68;12;61;182
"5587";"360810925002";33;15;89;17;58;212
"5588";"360810925003";14;5;76;49;43;187
"5589";"360810928001";1;2;17;0;6;26
"5590";"360810928002";2;3;4;2;4;15
"5591";"360810928003";2;1;2;3;7;15
"5592";"360810929001";45;0;77;47;42;211
"5593";"360810929002";21;20;103;57;67;268
"5594";"360810929003";4;0;34;12;16;66
"5595";"360810929004";0;1;16;6;8;31
"5596";"360810934011";8;4;21;3;20;56
"5597";"360810934012";10;15;22;6;22;75
"5598";"360810934013";3;3;67;1;17;91
"5599";"360810934021";38;8;35;3;16;100
"5600";"360810934022";13;10;19;1;7;50
"5601";"360810934023";7;6;19;3;32;67
"5602";"360810938001";3;1;5;3;9;21
"5603";"360810938002";18;9;18;0;5;50
"5604";"360810938003";100;23;40;2;62;227
"5605";"360810939001";34;2;52;23;66;177
"5606";"360810939002";12;3;43;14;27;99
"5607";"360810939003";23;1;27;31;28;110
"5608";"360810942011";99;40;47;10;28;224
"5609";"360810942021";46;17;7;7;8;85
"5610";"360810942022";53;8;11;8;55;135
"5611";"360810942031";36;19;31;8;21;115
"5612";"360810942032";16;40;38;0;6;100
"5613";"360810942033";10;3;2;0;1;16
"5614";"360810942034";14;4;1;2;6;27
"5615";"360810942035";3;3;0;0;3;9
"5616";"360810945001";14;14;122;116;42;308
"5617";"360810945002";8;8;46;32;28;122
"5618";"360810947001";25;85;78;25;46;259
"5619";"360810947002";23;7;45;38;29;142
"5620";"360810954001";57;7;12;9;27;112
"5621";"360810954002";24;3;33;3;13;76
"5622";"360810954003";21;21;14;13;15;84
"5623";"360810964001";121;13;29;11;29;203
"5624";"360810964002";28;6;25;6;10;75
"5625";"360810972021";60;2;2;0;12;76
"5626";"360810972031";6;2;7;6;9;30
"5627";"360810972032";19;3;0;0;0;22
"5628";"360810972033";102;1;2;2;4;111
"5629";"360810972034";49;3;7;0;4;63
"5630";"360810972041";30;2;0;4;1;37
"5631";"360810972042";45;5;12;18;25;105
"5632";"360810972043";1;2;4;1;3;11
"5633";"360810973000";0;0;1;0;0;1
"5634";"360810973001";0;1;9;13;9;32
"5635";"360810973002";2;0;8;9;3;22
"5636";"360810973003";1;4;4;7;9;25
"5637";"360810981001";27;20;13;19;43;122
"5638";"360810981002";5;50;37;7;27;126
"5639";"360810987001";4;11;32;14;20;81
"5640";"360810987002";6;15;31;20;36;108
"5641";"360810991001";6;2;8;4;3;23
"5642";"360810991002";3;5;12;4;7;31
"5643";"360810991003";0;2;9;16;7;34
"5644";"360810991004";3;1;7;15;13;39
"5645";"360810991005";7;1;62;14;12;96
"5646";"360810992001";46;2;24;15;32;119
"5647";"360810992002";56;7;21;25;25;134
"5648";"360810997011";2;9;47;8;2;68
"5649";"360810997012";2;2;6;10;8;28
"5650";"360810997013";0;0;9;21;2;32
"5651";"360810997031";20;1;59;13;18;111
"5652";"360810997032";1;1;4;13;0;19
"5653";"360810997033";4;3;42;7;7;63
"5654";"360810997041";8;1;10;6;2;27
"5655";"360810997042";20;1;5;9;6;41
"5656";"360810997043";101;0;9;13;0;123
"5657";"360810997044";4;1;10;2;6;23
"5658";"360810997051";23;3;26;19;6;77
"5659";"360810998011";19;5;25;6;23;78
"5660";"360810998012";46;1;15;2;7;71
"5661";"360810998013";93;3;15;1;13;125
"5662";"360810998014";8;0;1;1;0;10
"5663";"360810998015";45;4;11;26;13;99
"5664";"360810998021";59;15;25;34;25;158
"5665";"360810998022";82;1;2;2;3;90
"5666";"360810998023";5;2;7;0;1;15
"5667";"360811008011";16;1;15;7;5;44
"5668";"360811008012";26;3;14;15;23;81
"5669";"360811008021";76;5;64;4;45;194
"5670";"360811008022";30;1;27;17;21;96
"5671";"360811008023";24;2;18;19;19;82
"5672";"360811008024";36;3;23;28;26;116
"5673";"360811010011";38;6;37;13;21;115
"5674";"360811010012";46;1;18;4;18;87
"5675";"360811010013";39;7;15;3;7;71
"5676";"360811010014";74;6;24;3;13;120
"5677";"360811010021";4;2;23;24;3;56
"5678";"360811010022";58;13;4;6;10;91
"5679";"360811017001";7;1;16;8;5;37
"5680";"360811017002";7;2;9;13;5;36
"5681";"360811017003";3;3;8;5;14;33
"5682";"360811017004";0;0;13;9;2;24
"5683";"360811017005";2;1;12;4;13;32
"5684";"360811017006";4;2;14;6;14;40
"5685";"360811017007";0;0;5;5;1;11
"5686";"360811029001";3;6;53;25;27;114
"5687";"360811029002";9;29;23;15;6;82
"5688";"360811032011";71;5;19;23;16;134
"5689";"360811032012";53;2;16;27;19;117
"5690";"360811032013";66;11;12;3;35;127
"5691";"360811032021";19;7;6;7;12;51
"5692";"360811032022";3;2;4;6;5;20
"5693";"360811032023";111;3;25;2;7;148
"5694";"360811032024";53;5;13;1;12;84
"5695";"360811033001";14;0;17;27;33;91
"5696";"360811033002";3;0;25;12;11;51
"5697";"360811033003";13;0;13;6;8;40
"5698";"360811033004";6;0;18;10;35;69
"5699";"360811039001";15;1;26;33;24;99
"5700";"360811039002";6;0;33;27;22;88
"5701";"360811039003";1;9;31;4;33;78
"5702";"360811039004";6;7;20;22;23;78
"5703";"360811047001";3;1;15;7;67;93
"5704";"360811047002";3;4;22;27;32;88
"5705";"360811047003";4;3;52;11;24;94
"5706";"360811047004";11;1;26;1;34;73
"5707";"360811047005";5;0;33;37;32;107
"5708";"360811059001";3;3;4;3;14;27
"5709";"360811059002";1;3;11;10;26;51
"5710";"360811059003";0;0;6;6;23;35
"5711";"360811059004";5;0;7;8;7;27
"5712";"360811072011";14;5;32;29;46;126
"5713";"360811072020";0;0;0;0;1;1
"5714";"360811085001";2;3;13;13;10;41
"5715";"360811085002";1;4;17;7;15;44
"5716";"360811085003";2;0;14;7;22;45
"5717";"360811093001";4;2;17;10;6;39
"5718";"360811093002";8;1;48;3;21;81
"5719";"360811093003";2;1;11;3;6;23
"5720";"360811097001";2;1;8;10;4;25
"5721";"360811097002";2;4;30;0;12;48
"5722";"360811097003";4;3;19;10;11;47
"5723";"360811099001";5;0;30;28;27;90
"5724";"360811099002";2;1;32;10;19;64
"5725";"360811099003";2;4;49;4;26;85
"5726";"360811113001";1;0;5;3;7;16
"5727";"360811113002";1;1;5;5;5;17
"5728";"360811113003";1;0;5;5;3;14
"5729";"360811123001";11;5;42;12;14;84
"5730";"360811123002";19;28;47;3;26;123
"5731";"360811129001";0;1;9;9;13;32
"5732";"360811129002";2;5;5;11;5;28
"5733";"360811129003";6;4;30;1;15;56
"5734";"360811133001";1;1;21;15;12;50
"5735";"360811133002";3;1;11;6;32;53
"5736";"360811139001";2;2;25;19;16;64
"5737";"360811139002";29;15;79;12;18;153
"5738";"360811139003";4;2;16;14;7;43
"5739";"360811141001";1;2;21;19;23;66
"5740";"360811141002";3;1;4;7;11;26
"5741";"360811147001";4;0;6;12;15;37
"5742";"360811147002";10;2;13;17;22;64
"5743";"360811151001";4;14;9;9;58;94
"5744";"360811155001";8;1;33;2;21;65
"5745";"360811155002";13;1;9;4;31;58
"5746";"360811157001";5;7;34;4;32;82
"5747";"360811157002";24;14;27;1;26;92
"5748";"360811157003";7;1;15;1;10;34
"5749";"360811159001";0;0;16;3;27;46
"5750";"360811159002";3;1;68;6;26;104
"5751";"360811159003";50;3;36;1;32;122
"5752";"360811161001";56;3;56;3;33;151
"5753";"360811161002";89;7;22;1;1;120
"5754";"360811163001";32;3;5;0;7;47
"5755";"360811163002";22;1;30;0;28;81
"5756";"360811163003";37;4;16;2;10;69
"5757";"360811163004";39;3;20;0;15;77
"5758";"360811163005";5;3;43;3;12;66
"5759";"360811167001";9;13;78;14;89;203
"5760";"360811171001";0;8;68;17;45;138
"5761";"360811171002";13;5;32;5;17;72
"5762";"360811171003";210;1;41;5;28;285
"5763";"360811175001";4;1;31;6;11;53
"5764";"360811175002";24;5;50;4;20;103
"5765";"360811175003";5;1;25;12;18;61
"5766";"360811175004";3;10;38;18;29;98
"5767";"360811181001";2;2;44;11;11;70
"5768";"360811181002";6;1;32;3;43;85
"5769";"360811185001";13;3;71;11;72;170
"5770";"360811185002";13;6;77;15;31;142
"5771";"360811187001";41;0;22;4;20;87
"5772";"360811187002";10;1;31;12;30;84
"5773";"360811189001";3;6;50;5;39;103
"5774";"360811189002";10;3;18;10;18;59
"5775";"360811191001";175;3;62;7;61;308
"5776";"360811191002";6;3;57;1;32;99
"5777";"360811193001";8;4;39;11;31;93
"5778";"360811193002";14;0;49;5;20;88
"5779";"360811195001";25;6;54;18;15;118
"5780";"360811199001";13;3;30;20;48;114
"5781";"360811201001";19;2;76;19;39;155
"5782";"360811203001";4;0;21;10;36;71
"5783";"360811203002";2;2;26;4;16;50
"5784";"360811205001";26;9;109;7;138;289
"5785";"360811207001";7;2;26;22;16;73
"5786";"360811207002";7;7;75;39;30;158
"5787";"360811211001";0;0;11;3;3;17
"5788";"360811215001";13;3;60;27;82;185
"5789";"360811215002";7;5;34;14;36;96
"5790";"360811215003";12;2;111;17;55;197
"5791";"360811223001";8;0;58;26;14;106
"5792";"360811223002";4;1;21;14;15;55
"5793";"360811223003";11;1;30;26;16;84
"5794";"360811227011";32;4;67;5;33;141
"5795";"360811227012";2;0;36;18;18;74
"5796";"360811227013";25;3;47;3;9;87
"5797";"360811227014";14;4;25;1;0;44
"5798";"360811227015";54;3;17;0;7;81
"5799";"360811227016";1;0;4;0;1;6
"5800";"360811227017";49;1;8;1;22;81
"5801";"360811227021";54;4;2;0;2;62
"5802";"360811227022";30;3;9;7;8;57
"5803";"360811227023";215;7;8;12;9;251
"5804";"360811227024";3;0;43;9;5;60
"5805";"360811227025";190;5;14;5;4;218
"5806";"360811241001";10;0;25;41;30;106
"5807";"360811241002";11;4;15;14;24;68
"5808";"360811241003";29;2;52;14;14;111
"5809";"360811247001";13;4;16;23;9;65
"5810";"360811247002";3;6;5;6;14;34
"5811";"360811247003";14;0;34;10;15;73
"5812";"360811257001";19;4;74;2;13;112
"5813";"360811257002";20;5;11;7;20;63
"5814";"360811257003";7;4;13;2;5;31
"5815";"360811265001";5;6;71;7;4;93
"5816";"360811265002";7;2;33;9;18;69
"5817";"360811267001";2;5;51;8;21;87
"5818";"360811267002";5;1;51;8;16;81
"5819";"360811267003";15;2;21;11;23;72
"5820";"360811277001";4;4;28;9;11;56
"5821";"360811277002";7;4;17;25;9;62
"5822";"360811277003";8;4;8;6;10;36
"5823";"360811277004";2;1;15;12;10;40
"5824";"360811283001";1;19;15;5;9;49
"5825";"360811291021";2;1;61;15;52;131
"5826";"360811291022";4;1;5;10;27;47
"5827";"360811291023";3;1;0;5;7;16
"5828";"360811291024";3;7;11;2;2;25
"5829";"360811291031";7;2;7;6;6;28
"5830";"360811291032";2;2;7;6;1;18
"5831";"360811291033";0;1;4;7;6;18
"5832";"360811291041";1;0;0;1;27;29
"5833";"360811291042";12;3;6;14;3;38
"5834";"360811291043";0;1;6;8;1;16
"5835";"360811291044";1;2;4;2;15;24
"5836";"360811291045";7;3;4;4;1;19
"5837";"360811301001";10;0;6;12;9;37
"5838";"360811301002";4;1;4;8;10;27
"5839";"360811301003";5;8;15;6;16;50
"5840";"360811301004";17;1;7;5;11;41
"5841";"360811333001";2;0;26;17;14;59
"5842";"360811333002";2;4;37;18;14;75
"5843";"360811333003";2;5;30;11;13;61
"5844";"360811333004";8;5;14;17;8;52
"5845";"360811339001";10;3;25;6;19;63
"5846";"360811341001";6;1;16;20;29;72
"5847";"360811341002";4;1;17;16;31;69
"5848";"360811341003";0;2;13;17;13;45
"5849";"360811347001";8;1;24;12;13;58
"5850";"360811347002";5;1;8;17;0;31
"5851";"360811347003";23;3;8;13;1;48
"5852";"360811347004";32;4;6;9;9;60
"5853";"360811347005";177;6;12;19;3;217
"5854";"360811367001";14;38;60;7;22;141
"5855";"360811367002";1;0;6;9;2;18
"5856";"360811367003";3;1;2;5;0;11
"5857";"360811367004";5;4;6;13;11;39
"5858";"360811367005";11;5;9;6;2;33
"5859";"360811377001";7;1;6;9;7;30
"5860";"360811377002";9;2;13;24;10;58
"5861";"360811377003";0;0;32;7;11;50
"5862";"360811377004";9;0;30;8;13;60
"5863";"360811385011";0;3;22;3;15;43
"5864";"360811385012";4;0;32;1;14;51
"5865";"360811385013";2;3;19;5;9;38
"5866";"360811385014";1;0;17;4;9;31
"5867";"360811385021";2;5;12;7;26;52
"5868";"360811399001";0;0;9;8;8;25
"5869";"360811399002";0;0;14;6;7;27
"5870";"360811403001";1;2;10;7;12;32
"5871";"360811403002";4;1;13;23;22;63
"5872";"360811409011";1;3;4;5;12;25
"5873";"360811409021";2;1;10;9;20;42
"5874";"360811409022";5;0;7;18;21;51
"5875";"360811417001";1;2;2;13;28;46
"5876";"360811417002";13;0;16;20;27;76
"5877";"360811417003";2;3;9;6;25;45
"5878";"360811417004";3;2;15;12;12;44
"5879";"360811417005";1;9;13;4;15;42
"5880";"360811429001";1;0;8;5;12;26
"5881";"360811429002";3;2;21;10;22;58
"5882";"360811429003";2;0;8;14;17;41
"5883";"360811429004";6;0;5;6;16;33
"5884";"360811435001";1;0;15;7;24;47
"5885";"360811435002";9;0;11;5;11;36
"5886";"360811441001";1;0;6;3;12;22
"5887";"360811441002";9;0;6;7;4;26
"5888";"360811441003";1;0;9;4;3;17
"5889";"360811441004";1;1;3;3;16;24
"5890";"360811447001";2;8;29;19;36;94
"5891";"360811447002";3;5;32;9;76;125
"5892";"360811451011";6;2;21;9;19;57
"5893";"360811451021";6;2;13;11;39;71
"5894";"360811451022";8;5;29;15;16;73
"5895";"360811459001";2;7;7;12;19;47
"5896";"360811459002";3;0;18;8;11;40
"5897";"360811459003";5;1;37;13;20;76
"5898";"360811463001";20;5;36;21;29;111
"5899";"360811463002";17;10;37;9;44;117
"5900";"360811467001";12;11;23;14;24;84
"5901";"360811467002";19;0;3;3;2;27
"5902";"360811467003";1;0;23;17;27;68
"5903";"360811471001";3;5;48;19;34;109
"5904";"360811471002";0;3;23;7;24;57
"5905";"360811479001";6;1;55;22;22;106
"5906";"360811479002";5;7;39;9;10;70
"5907";"360811479003";5;3;32;8;57;105
"5908";"360811483001";3;2;4;4;2;15
"5909";"360811483002";2;1;27;5;16;51
"5910";"360811483003";8;1;9;3;7;28
"5911";"360811483004";3;5;7;1;9;25
"5912";"360811507011";7;5;8;6;28;54
"5913";"360811507012";3;0;6;4;17;30
"5914";"360811507013";1;0;14;9;14;38
"5915";"360811507021";1;1;13;3;25;43
"5916";"360811507022";0;0;4;5;8;17
"5917";"360811507023";4;1;11;14;7;37
"5918";"360811507024";6;6;26;6;5;49
"5919";"360811529011";2;1;13;7;8;31
"5920";"360811529012";4;1;78;12;102;197
"5921";"360811529013";3;3;23;12;12;53
"5922";"360811529021";0;0;5;12;5;22
"5923";"360811529022";1;1;8;12;8;30
"5924";"360811529023";6;1;38;15;16;76
"5925";"360811529024";1;1;6;11;4;23
"5926";"360811551011";0;0;1;0;4;5
"5927";"360811551021";15;2;9;9;0;35
"5928";"360811551022";0;0;4;10;14;28
"5929";"360811551023";3;1;83;12;32;131
"5930";"360811551024";0;2;11;24;14;51
"5931";"360811551025";0;0;3;9;1;13
"5932";"360811551026";1;1;6;18;0;26
"5933";"360811567001";2;6;15;8;6;37
"5934";"360811571011";5;4;21;6;10;46
"5935";"360811571012";8;11;7;4;31;61
"5936";"360811571013";1;0;4;4;1;10
"5937";"360811571014";3;4;5;11;11;34
"5938";"360811571015";3;2;6;15;32;58
"5939";"360811571016";5;2;22;19;78;126
"5940";"360811571017";1;2;126;9;35;173
"5941";"360811571018";0;2;8;8;6;24
"5942";"360811571021";5;2;15;14;29;65
"5943";"360811571022";5;5;13;8;20;51
"5944";"360811579011";23;3;3;5;32;66
"5945";"360811579012";0;1;13;6;35;55
"5946";"360811579013";3;3;1;3;9;19
"5947";"360811579014";11;2;5;1;2;21
"5948";"360811579015";1;2;18;17;19;57
"5949";"360811579016";3;1;7;6;23;40
"5950";"360811579021";5;0;8;8;8;29
"5951";"360811579022";3;1;5;2;7;18
"5952";"360811579023";2;4;7;2;5;20
"5953";"360811579024";11;3;9;4;23;50
"5954";"360811579025";2;7;23;4;26;62
"5955";"360811579031";0;1;4;0;7;12
"5956";"360811579032";11;5;13;5;13;47
"5957";"360811579033";7;4;24;8;25;68
"5958";"360811579034";4;1;28;27;8;68
"5959";"360811617001";7;0;20;19;29;75
"5960";"360811617002";1;1;10;4;10;26
"5961";"360811617003";7;1;23;6;13;50
"5962";"360811617004";4;5;42;18;40;109
"5963";"360811621001";1;3;9;6;21;40
"5964";"360811621002";37;4;49;8;32;130
"5965";"360811621003";16;4;15;21;22;78
"5966";"360811621004";3;3;19;13;16;54
"5967";"360811621005";13;10;28;21;55;127
"5968";"360850003001";28;6;13;1;56;104
"5969";"360850003002";16;12;9;0;16;53
"5970";"360850006001";8;8;8;9;20;53
"5971";"360850006002";21;108;50;29;30;238
"5972";"360850007001";92;39;11;8;26;176
"5973";"360850007002";29;10;52;21;14;126
"5974";"360850007003";16;1;62;10;10;99
"5975";"360850007004";41;13;26;2;8;90
"5976";"360850008001";43;12;75;36;36;202
"5977";"360850008002";16;11;41;16;34;118
"5978";"360850008003";9;9;22;41;44;125
"5979";"360850009001";32;6;57;17;11;123
"5980";"360850009002";58;3;8;13;19;101
"5981";"360850011001";39;36;15;21;29;140
"5982";"360850011002";82;6;14;19;25;146
"5983";"360850011003";66;20;17;13;22;138
"5984";"360850017001";15;7;7;6;9;44
"5985";"360850017002";31;9;15;14;11;80
"5986";"360850020011";6;5;20;18;9;58
"5987";"360850020012";7;1;72;16;6;102
"5988";"360850020021";32;3;47;41;22;145
"5989";"360850020022";3;2;26;10;2;43
"5990";"360850021001";25;16;35;42;47;165
"5991";"360850021002";17;31;29;36;31;144
"5992";"360850021003";87;28;49;54;72;290
"5993";"360850027001";43;25;13;17;31;129
"5994";"360850029001";35;4;14;23;29;105
"5995";"360850029002";148;5;4;1;3;161
"5996";"360850029003";62;5;51;44;38;200
"5997";"360850029004";21;18;14;28;17;98
"5998";"360850033001";29;3;16;27;11;86
"5999";"360850033002";55;18;50;22;19;164
"6000";"360850036001";17;2;36;33;6;94
"6001";"360850036002";5;13;24;20;18;80
"6002";"360850039001";3;1;8;5;4;21
"6003";"360850039002";20;4;11;8;3;46
"6004";"360850040001";12;4;43;26;22;107
"6005";"360850040002";106;19;13;19;21;178
"6006";"360850040003";212;9;9;3;13;246
"6007";"360850040004";10;7;18;7;11;53
"6008";"360850040005";7;6;6;2;3;24
"6009";"360850040006";54;13;26;18;18;129
"6010";"360850040007";8;3;17;10;14;52
"6011";"360850047001";16;5;65;51;24;161
"6012";"360850047002";11;9;16;9;9;54
"6013";"360850050001";9;15;84;29;16;153
"6014";"360850050002";5;1;19;10;3;38
"6015";"360850050003";5;3;9;17;15;49
"6016";"360850059001";32;22;21;33;30;138
"6017";"360850059002";6;24;40;12;17;99
"6018";"360850064001";2;2;27;6;6;43
"6019";"360850064002";7;1;7;17;25;57
"6020";"360850064003";74;9;39;14;29;165
"6021";"360850067001";9;2;12;26;15;64
"6022";"360850067002";11;9;42;15;19;96
"6023";"360850067003";12;5;9;12;7;45
"6024";"360850070001";26;12;66;32;50;186
"6025";"360850070002";5;10;67;19;18;119
"6026";"360850070003";11;9;26;33;77;156
"6027";"360850070004";8;5;19;36;36;104
"6028";"360850074001";14;1;37;20;37;109
"6029";"360850074002";18;8;58;29;41;154
"6030";"360850075001";64;7;29;20;32;152
"6031";"360850075002";27;5;23;14;14;83
"6032";"360850075003";22;3;28;31;40;124
"6033";"360850077001";38;8;7;27;23;103
"6034";"360850081001";15;9;19;42;23;108
"6035";"360850081002";71;11;20;15;13;130
"6036";"360850081003";65;38;11;20;21;155
"6037";"360850096011";15;13;22;17;9;76
"6038";"360850096012";22;1;31;18;18;90
"6039";"360850096021";13;6;24;11;17;71
"6040";"360850096022";6;3;16;13;25;63
"6041";"360850096023";14;1;16;9;13;53
"6042";"360850097001";74;15;23;14;14;140
"6043";"360850097002";49;4;25;8;20;106
"6044";"360850097003";5;8;19;12;8;52
"6045";"360850105001";8;3;20;12;10;53
"6046";"360850105002";6;104;14;8;11;143
"6047";"360850105003";3;7;16;15;11;52
"6048";"360850105004";21;5;32;17;50;125
"6049";"360850105005";76;30;37;25;24;192
"6050";"360850112011";8;4;28;18;27;85
"6051";"360850112012";13;12;52;20;47;144
"6052";"360850112021";14;11;34;14;17;90
"6053";"360850112022";4;14;34;15;39;106
"6054";"360850112023";27;113;38;22;34;234
"6055";"360850112024";0;0;1;1;0;2
"6056";"360850114011";17;2;14;16;12;61
"6057";"360850114012";147;17;20;13;19;216
"6058";"360850114021";2;0;11;10;13;36
"6059";"360850114022";8;2;16;14;18;58
"6060";"360850114023";6;1;8;17;25;57
"6061";"360850121001";2;0;8;5;4;19
"6062";"360850121002";4;1;14;25;20;64
"6063";"360850121003";6;21;28;24;7;86
"6064";"360850122001";9;2;8;5;7;31
"6065";"360850122002";9;6;21;6;23;65
"6066";"360850122003";0;1;11;16;18;46
"6067";"360850122004";7;7;28;25;29;96
"6068";"360850125001";40;8;42;16;28;134
"6069";"360850125002";13;2;5;12;15;47
"6070";"360850125003";11;2;16;2;4;35
"6071";"360850128041";50;7;41;39;54;191
"6072";"360850128042";17;5;33;29;90;174
"6073";"360850128051";10;7;38;17;65;137
"6074";"360850128061";6;0;10;6;19;41
"6075";"360850128062";7;1;2;5;3;18
"6076";"360850128063";42;33;12;3;12;102
"6077";"360850128064";9;10;28;22;17;86
"6078";"360850132011";4;10;4;4;5;27
"6079";"360850132012";2;0;15;14;15;46
"6080";"360850132031";5;4;15;10;14;48
"6081";"360850132032";18;5;45;28;6;102
"6082";"360850132033";9;4;26;11;21;71
"6083";"360850132041";5;3;20;16;14;58
"6084";"360850132042";6;2;19;15;12;54
"6085";"360850132043";12;2;18;9;14;55
"6086";"360850133011";210;19;1;4;7;241
"6087";"360850133021";33;5;6;19;24;87
"6088";"360850133022";26;9;32;14;41;122
"6089";"360850133023";34;161;37;23;25;280
"6090";"360850134001";13;2;32;19;25;91
"6091";"360850134002";3;4;15;8;9;39
"6092";"360850134003";25;9;27;17;6;84
"6093";"360850138001";9;1;18;3;7;38
"6094";"360850138002";20;4;25;10;12;71
"6095";"360850138003";5;3;18;5;8;39
"6096";"360850138004";6;4;16;10;3;39
"6097";"360850138005";3;1;20;18;15;57
"6098";"360850141001";16;8;30;8;17;79
"6099";"360850141002";15;3;15;29;20;82
"6100";"360850146041";3;3;20;14;24;64
"6101";"360850146042";3;2;22;25;23;75
"6102";"360850146043";20;15;33;10;18;96
"6103";"360850146044";10;0;17;9;9;45
"6104";"360850146051";10;4;11;18;30;73
"6105";"360850146052";4;9;13;15;13;54
"6106";"360850146061";6;5;42;16;5;74
"6107";"360850146062";14;2;95;12;31;154
"6108";"360850146063";6;2;41;22;24;95
"6109";"360850146064";7;0;43;13;33;96
"6110";"360850146071";12;21;51;50;36;170
"6111";"360850146072";4;1;10;20;20;55
"6112";"360850146081";5;1;20;19;12;57
"6113";"360850146082";10;7;24;9;13;63
"6114";"360850147001";4;2;4;10;4;24
"6115";"360850147002";6;7;22;12;11;58
"6116";"360850147003";20;8;16;20;14;78
"6117";"360850151001";38;60;25;15;44;182
"6118";"360850151002";4;2;5;5;7;23
"6119";"360850151003";5;1;1;16;2;25
"6120";"360850151004";4;1;23;13;7;48
"6121";"360850151005";8;5;18;20;28;79
"6122";"360850154001";0;0;4;4;2;10
"6123";"360850156011";14;7;21;6;33;81
"6124";"360850156012";5;1;7;7;8;28
"6125";"360850156013";12;2;14;5;27;60
"6126";"360850156014";2;2;9;5;8;26
"6127";"360850156015";3;0;6;4;4;17
"6128";"360850156016";6;2;18;12;6;44
"6129";"360850156021";1;4;20;0;11;36
"6130";"360850156022";0;3;7;5;31;46
"6131";"360850156023";2;3;12;2;6;25
"6132";"360850156024";9;4;0;4;4;21
"6133";"360850156031";1;3;18;6;17;45
"6134";"360850156032";13;2;31;24;23;93
"6135";"360850156033";7;43;36;13;21;120
"6136";"360850169011";6;3;21;21;21;72
"6137";"360850169012";4;2;29;23;21;79
"6138";"360850170051";11;28;30;18;85;172
"6139";"360850170052";4;6;14;5;30;59
"6140";"360850170071";13;5;79;18;18;133
"6141";"360850170072";54;5;46;11;15;131
"6142";"360850170081";5;0;132;24;43;204
"6143";"360850170082";24;4;67;16;27;138
"6144";"360850170083";9;0;35;32;38;114
"6145";"360850170091";1;0;19;4;19;43
"6146";"360850170092";9;9;14;10;10;52
"6147";"360850170093";5;4;8;11;24;52
"6148";"360850170101";17;27;56;62;40;202
"6149";"360850170102";15;2;84;29;11;141
"6150";"360850170103";54;8;86;17;20;185
"6151";"360850170104";4;4;43;13;36;100
"6152";"360850170111";11;1;22;20;33;87
"6153";"360850170112";7;0;28;9;23;67
"6154";"360850170121";4;3;32;27;203;269
"6155";"360850170122";3;1;14;9;31;58
"6156";"360850170123";7;7;36;5;12;67
"6157";"360850173001";5;2;28;12;13;60
"6158";"360850173002";60;3;1;2;1;67
"6159";"360850176001";10;1;20;13;21;65
"6160";"360850176002";3;0;2;5;12;22
"6161";"360850176003";3;0;9;16;18;46
"6162";"360850176004";7;5;12;7;15;46
"6163";"360850177001";2;0;10;6;4;22
"6164";"360850177002";8;0;12;9;10;39
"6165";"360850177003";6;2;7;12;28;55
"6166";"360850177004";9;5;25;15;16;70
"6167";"360850177005";1;0;9;8;5;23
"6168";"360850177006";0;2;1;3;3;9
"6169";"360850181001";1;0;5;5;4;15
"6170";"360850181002";8;4;8;8;21;49
"6171";"360850181003";6;6;4;2;25;43
"6172";"360850187011";8;2;20;6;47;83
"6173";"360850187012";3;1;21;22;12;59
"6174";"360850187021";6;3;24;26;15;74
"6175";"360850187022";6;3;12;23;14;58
"6176";"360850187023";14;7;26;19;14;80
"6177";"360850187024";17;16;24;12;37;106
"6178";"360850189011";42;17;41;53;30;183
"6179";"360850189012";26;6;26;21;32;111
"6180";"360850189021";5;1;19;13;6;44
"6181";"360850189022";1;2;35;21;21;80
"6182";"360850189023";10;4;36;12;22;84
"6183";"360850197001";7;3;4;14;8;36
"6184";"360850197002";9;2;14;7;12;44
"6185";"360850198001";1;0;0;0;3;4
"6186";"360850198002";10;5;33;9;38;95
"6187";"360850198003";3;2;38;10;9;62
"6188";"360850198004";13;4;40;6;32;95
"6189";"360850201001";29;19;14;30;23;115
"6190";"360850201002";16;12;17;13;20;78
"6191";"360850201003";9;15;13;3;7;47
"6192";"360850207001";36;16;35;34;73;194
"6193";"360850207002";35;36;15;13;43;142
"6194";"360850207003";17;3;25;25;31;101
"6195";"360850207004";31;6;20;18;53;128
"6196";"360850208011";10;1;65;17;22;115
"6197";"360850208012";11;2;41;13;21;88
"6198";"360850208013";11;2;79;24;34;150
"6199";"360850208014";12;7;43;16;23;101
"6200";"360850208031";8;3;56;14;10;91
"6201";"360850208032";8;6;24;4;31;73
"6202";"360850208033";2;1;21;4;12;40
"6203";"360850208041";10;2;15;15;27;69
"6204";"360850208042";5;1;27;18;15;66
"6205";"360850208043";4;3;14;4;20;45
"6206";"360850213001";51;31;23;17;31;153
"6207";"360850213002";10;7;7;9;3;36
"6208";"360850213003";23;8;50;44;28;153
"6209";"360850213004";26;5;18;18;18;85
"6210";"360850213005";8;2;20;16;15;61
"6211";"360850223001";59;4;44;71;36;214
"6212";"360850223002";14;13;48;45;18;138
"6213";"360850226001";3;9;16;22;26;76
"6214";"360850226002";9;3;26;8;36;82
"6215";"360850226003";9;2;40;21;11;83
"6216";"360850226004";7;27;33;13;42;122
"6217";"360850228001";2;1;23;11;16;53
"6218";"360850231001";62;12;69;42;54;239
"6219";"360850231002";27;9;14;12;23;85
"6220";"360850239001";56;33;41;35;38;203
"6221";"360850239002";21;3;12;15;45;96
"6222";"360850244011";24;1;5;4;13;47
"6223";"360850244012";19;8;13;9;24;73
"6224";"360850244013";33;6;28;16;15;98
"6225";"360850244021";4;3;18;8;18;51
"6226";"360850244022";3;1;12;10;10;36
"6227";"360850247001";58;7;24;15;13;117
"6228";"360850247002";16;4;28;31;51;130
"6229";"360850248001";10;8;50;18;37;123
"6230";"360850248002";3;5;5;30;20;63
"6231";"360850248003";8;86;44;29;36;203
"6232";"360850251001";28;8;20;28;35;119
"6233";"360850251002";0;5;7;4;10;26
"6234";"360850251003";19;0;10;33;25;87
"6235";"360850273011";4;0;12;7;2;25
"6236";"360850273012";12;7;43;41;35;138
"6237";"360850273021";8;1;64;31;32;136
"6238";"360850273022";0;0;31;12;9;52
"6239";"360850277021";7;3;21;10;10;51
"6240";"360850277022";11;3;9;5;14;42
"6241";"360850277023";27;2;42;7;25;103
"6242";"360850277041";5;2;35;21;11;74
"6243";"360850277042";14;6;53;10;26;109
"6244";"360850277051";38;6;91;23;46;204
"6245";"360850277052";16;2;34;16;13;81
"6246";"360850277053";8;9;36;14;45;112
"6247";"360850277061";13;5;26;7;26;77
"6248";"360850277062";6;0;17;3;10;36
"6249";"360850277063";10;3;37;18;9;77
"6250";"360850279001";7;2;28;12;8;57
"6251";"360850279002";8;1;13;11;13;46
"6252";"360850291021";7;0;33;38;15;93
"6253";"360850291022";23;7;34;41;36;141
"6254";"360850291031";5;7;24;19;28;83
"6255";"360850291032";1;0;8;2;3;14
"6256";"360850291033";15;7;17;25;6;70
"6257";"360850291034";8;1;14;17;26;66
"6258";"360850291035";6;3;43;22;52;126
"6259";"360850291041";8;2;74;21;43;148
"6260";"360850291042";7;0;30;24;18;79
"6261";"360850291043";1;4;31;9;21;66
"6262";"360850291044";19;5;46;52;58;180
"6263";"360850303011";121;1;96;37;30;285
"6264";"360850303012";11;6;15;17;13;62
"6265";"360850303021";34;16;51;27;18;146
"6266";"360850303022";18;3;59;13;21;114
"6267";"360850303023";21;1;15;21;10;68
"6268";"360850303024";3;1;22;6;37;69
"6269";"360850319011";74;16;9;5;9;113
"6270";"360850319012";10;7;10;10;16;53
"6271";"360850319021";4;2;6;3;3;18
"6272";"360850319022";39;9;13;31;38;130
"6273";"360850319023";33;12;31;45;17;138
"6274";"360850323001";139;11;9;18;20;197
"6275";"361190002031";0;1;0;1;0;2
"6276";"361190015021";0;0;0;1;0;1
"6277";"361190015031";0;0;5;0;2;7
"6278";"361190026001";0;0;1;0;1;2
"6279";"361190026003";1;1;0;1;0;3
"6280";"361190029002";0;0;0;1;0;1
